rpp30_F_1_ATGAGACTTG	AATGATACGGCGACCACCGAGATCTACACATGAGACTTGGAGCGGCTGTCTCCACAAGT
rpp30_F_2_GAGGCTATCT	AATGATACGGCGACCACCGAGATCTACACGAGGCTATCTGAGCGGCTGTCTCCACAAGT
rpp30_F_3_ACGTTGAAGA	AATGATACGGCGACCACCGAGATCTACACACGTTGAAGAGAGCGGCTGTCTCCACAAGT
rpp30_F_4_AGATTCTCTG	AATGATACGGCGACCACCGAGATCTACACAGATTCTCTGGAGCGGCTGTCTCCACAAGT
rpp30_F_5_AACGGCAAGA	AATGATACGGCGACCACCGAGATCTACACAACGGCAAGAGAGCGGCTGTCTCCACAAGT
rpp30_F_6_AGCGATCTAA	AATGATACGGCGACCACCGAGATCTACACAGCGATCTAAGAGCGGCTGTCTCCACAAGT
rpp30_F_7_ATCTGGAACG	AATGATACGGCGACCACCGAGATCTACACATCTGGAACGGAGCGGCTGTCTCCACAAGT
rpp30_F_8_CGATACAACG	AATGATACGGCGACCACCGAGATCTACACCGATACAACGGAGCGGCTGTCTCCACAAGT
rpp30_F_9_GAACTACACG	AATGATACGGCGACCACCGAGATCTACACGAACTACACGGAGCGGCTGTCTCCACAAGT
rpp30_F_10_TAAGGTAACG	AATGATACGGCGACCACCGAGATCTACACTAAGGTAACGGAGCGGCTGTCTCCACAAGT
rpp30_F_11_CAAGAACTAG	AATGATACGGCGACCACCGAGATCTACACCAAGAACTAGGAGCGGCTGTCTCCACAAGT
rpp30_F_12_CGAACTTGCG	AATGATACGGCGACCACCGAGATCTACACCGAACTTGCGGAGCGGCTGTCTCCACAAGT
rpp30_F_13_ACACATAGCG	AATGATACGGCGACCACCGAGATCTACACACACATAGCGGAGCGGCTGTCTCCACAAGT
rpp30_F_14_AGACTATGCG	AATGATACGGCGACCACCGAGATCTACACAGACTATGCGGAGCGGCTGTCTCCACAAGT
rpp30_F_15_CATTGGCTTG	AATGATACGGCGACCACCGAGATCTACACCATTGGCTTGGAGCGGCTGTCTCCACAAGT
rpp30_F_16_CGTTCATAGA	AATGATACGGCGACCACCGAGATCTACACCGTTCATAGAGAGCGGCTGTCTCCACAAGT
rpp30_F_17_CATCTCTGTA	AATGATACGGCGACCACCGAGATCTACACCATCTCTGTAGAGCGGCTGTCTCCACAAGT
rpp30_F_18_ATGGACCATA	AATGATACGGCGACCACCGAGATCTACACATGGACCATAGAGCGGCTGTCTCCACAAGT
rpp30_F_19_ATTGAGCGTA	AATGATACGGCGACCACCGAGATCTACACATTGAGCGTAGAGCGGCTGTCTCCACAAGT
rpp30_F_20_ACCTGATTCG	AATGATACGGCGACCACCGAGATCTACACACCTGATTCGGAGCGGCTGTCTCCACAAGT
rpp30_F_21_AACATAACGG	AATGATACGGCGACCACCGAGATCTACACAACATAACGGGAGCGGCTGTCTCCACAAGT
rpp30_F_22_ACCGATACGG	AATGATACGGCGACCACCGAGATCTACACACCGATACGGGAGCGGCTGTCTCCACAAGT
rpp30_F_23_ACTCTGTTGA	AATGATACGGCGACCACCGAGATCTACACACTCTGTTGAGAGCGGCTGTCTCCACAAGT
rpp30_F_24_TATTGTCACG	AATGATACGGCGACCACCGAGATCTACACTATTGTCACGGAGCGGCTGTCTCCACAAGT
rpp30_F_25_ACAAGATCGT	AATGATACGGCGACCACCGAGATCTACACACAAGATCGTGAGCGGCTGTCTCCACAAGT
rpp30_F_26_ATAGAAGACG	AATGATACGGCGACCACCGAGATCTACACATAGAAGACGGAGCGGCTGTCTCCACAAGT
rpp30_F_27_CACAGGATCG	AATGATACGGCGACCACCGAGATCTACACCACAGGATCGGAGCGGCTGTCTCCACAAGT
rpp30_F_28_CCACGAATCG	AATGATACGGCGACCACCGAGATCTACACCCACGAATCGGAGCGGCTGTCTCCACAAGT
rpp30_F_29_ACGAAGAACG	AATGATACGGCGACCACCGAGATCTACACACGAAGAACGGAGCGGCTGTCTCCACAAGT
rpp30_F_30_AAGTGAGTGA	AATGATACGGCGACCACCGAGATCTACACAAGTGAGTGAGAGCGGCTGTCTCCACAAGT
rpp30_F_31_ACCGCATAGA	AATGATACGGCGACCACCGAGATCTACACACCGCATAGAGAGCGGCTGTCTCCACAAGT
rpp30_F_32_CTATCCTTCG	AATGATACGGCGACCACCGAGATCTACACCTATCCTTCGGAGCGGCTGTCTCCACAAGT
rpp30_F_33_GTATAGAGAG	AATGATACGGCGACCACCGAGATCTACACGTATAGAGAGGAGCGGCTGTCTCCACAAGT
rpp30_F_34_CACACATGTT	AATGATACGGCGACCACCGAGATCTACACCACACATGTTGAGCGGCTGTCTCCACAAGT
rpp30_F_35_ACTCATCTGG	AATGATACGGCGACCACCGAGATCTACACACTCATCTGGGAGCGGCTGTCTCCACAAGT
rpp30_F_36_GATAACCGGA	AATGATACGGCGACCACCGAGATCTACACGATAACCGGAGAGCGGCTGTCTCCACAAGT
rpp30_F_37_ACCTTGGACG	AATGATACGGCGACCACCGAGATCTACACACCTTGGACGGAGCGGCTGTCTCCACAAGT
rpp30_F_38_AGATCCTCGT	AATGATACGGCGACCACCGAGATCTACACAGATCCTCGTGAGCGGCTGTCTCCACAAGT
rpp30_F_39_CTTGTCTACG	AATGATACGGCGACCACCGAGATCTACACCTTGTCTACGGAGCGGCTGTCTCCACAAGT
rpp30_F_40_ACAATGACCG	AATGATACGGCGACCACCGAGATCTACACACAATGACCGGAGCGGCTGTCTCCACAAGT
rpp30_F_41_ACCAATGGTA	AATGATACGGCGACCACCGAGATCTACACACCAATGGTAGAGCGGCTGTCTCCACAAGT
rpp30_F_42_CACTTAGCGG	AATGATACGGCGACCACCGAGATCTACACCACTTAGCGGGAGCGGCTGTCTCCACAAGT
rpp30_F_43_CATATGATGG	AATGATACGGCGACCACCGAGATCTACACCATATGATGGGAGCGGCTGTCTCCACAAGT
rpp30_F_44_CATGTCGTGA	AATGATACGGCGACCACCGAGATCTACACCATGTCGTGAGAGCGGCTGTCTCCACAAGT
rpp30_F_45_ATCTATACCG	AATGATACGGCGACCACCGAGATCTACACATCTATACCGGAGCGGCTGTCTCCACAAGT
rpp30_F_46_GTATCCTGTA	AATGATACGGCGACCACCGAGATCTACACGTATCCTGTAGAGCGGCTGTCTCCACAAGT
rpp30_F_47_CCATGGTGAA	AATGATACGGCGACCACCGAGATCTACACCCATGGTGAAGAGCGGCTGTCTCCACAAGT
rpp30_F_48_ACTGGTTGTA	AATGATACGGCGACCACCGAGATCTACACACTGGTTGTAGAGCGGCTGTCTCCACAAGT
rpp30_F_49_AAGTGATCAG	AATGATACGGCGACCACCGAGATCTACACAAGTGATCAGGAGCGGCTGTCTCCACAAGT
rpp30_F_50_GCGCCATCTT	AATGATACGGCGACCACCGAGATCTACACGCGCCATCTTGAGCGGCTGTCTCCACAAGT
rpp30_F_51_AGAATTGACG	AATGATACGGCGACCACCGAGATCTACACAGAATTGACGGAGCGGCTGTCTCCACAAGT
rpp30_F_52_ATGACAGTCG	AATGATACGGCGACCACCGAGATCTACACATGACAGTCGGAGCGGCTGTCTCCACAAGT
rpp30_F_53_ACTGATAACG	AATGATACGGCGACCACCGAGATCTACACACTGATAACGGAGCGGCTGTCTCCACAAGT
rpp30_F_54_CAGATCACAG	AATGATACGGCGACCACCGAGATCTACACCAGATCACAGGAGCGGCTGTCTCCACAAGT
rpp30_F_55_CATGTCTCTG	AATGATACGGCGACCACCGAGATCTACACCATGTCTCTGGAGCGGCTGTCTCCACAAGT
rpp30_F_56_AATCCTACCG	AATGATACGGCGACCACCGAGATCTACACAATCCTACCGGAGCGGCTGTCTCCACAAGT
rpp30_F_57_CGCAGAGGTT	AATGATACGGCGACCACCGAGATCTACACCGCAGAGGTTGAGCGGCTGTCTCCACAAGT
rpp30_F_58_GAGTATAGGT	AATGATACGGCGACCACCGAGATCTACACGAGTATAGGTGAGCGGCTGTCTCCACAAGT
rpp30_F_59_CTGGTCTCTA	AATGATACGGCGACCACCGAGATCTACACCTGGTCTCTAGAGCGGCTGTCTCCACAAGT
rpp30_F_60_CGCAATTGTA	AATGATACGGCGACCACCGAGATCTACACCGCAATTGTAGAGCGGCTGTCTCCACAAGT
rpp30_F_61_ACAGCGTTGG	AATGATACGGCGACCACCGAGATCTACACACAGCGTTGGGAGCGGCTGTCTCCACAAGT
rpp30_F_62_GATCAACGTA	AATGATACGGCGACCACCGAGATCTACACGATCAACGTAGAGCGGCTGTCTCCACAAGT
rpp30_F_63_AATGGAACGG	AATGATACGGCGACCACCGAGATCTACACAATGGAACGGGAGCGGCTGTCTCCACAAGT
rpp30_F_64_CTAATGAACG	AATGATACGGCGACCACCGAGATCTACACCTAATGAACGGAGCGGCTGTCTCCACAAGT
rpp30_F_65_AACCTTCACG	AATGATACGGCGACCACCGAGATCTACACAACCTTCACGGAGCGGCTGTCTCCACAAGT
rpp30_F_66_AATCTCCGAG	AATGATACGGCGACCACCGAGATCTACACAATCTCCGAGGAGCGGCTGTCTCCACAAGT
rpp30_F_67_CATGTTGTCG	AATGATACGGCGACCACCGAGATCTACACCATGTTGTCGGAGCGGCTGTCTCCACAAGT
rpp30_F_68_AGTGTCTATG	AATGATACGGCGACCACCGAGATCTACACAGTGTCTATGGAGCGGCTGTCTCCACAAGT
rpp30_F_69_GCAAGCTGTT	AATGATACGGCGACCACCGAGATCTACACGCAAGCTGTTGAGCGGCTGTCTCCACAAGT
rpp30_F_70_ACATGGTCTT	AATGATACGGCGACCACCGAGATCTACACACATGGTCTTGAGCGGCTGTCTCCACAAGT
rpp30_F_71_TAGTATACGG	AATGATACGGCGACCACCGAGATCTACACTAGTATACGGGAGCGGCTGTCTCCACAAGT
rpp30_F_72_AAGGCCTCTA	AATGATACGGCGACCACCGAGATCTACACAAGGCCTCTAGAGCGGCTGTCTCCACAAGT
rpp30_F_73_ACGACACACG	AATGATACGGCGACCACCGAGATCTACACACGACACACGGAGCGGCTGTCTCCACAAGT
rpp30_F_74_ATCGAGAAGA	AATGATACGGCGACCACCGAGATCTACACATCGAGAAGAGAGCGGCTGTCTCCACAAGT
rpp30_F_75_ACTAGGTCTA	AATGATACGGCGACCACCGAGATCTACACACTAGGTCTAGAGCGGCTGTCTCCACAAGT
rpp30_F_76_AACGGATCTA	AATGATACGGCGACCACCGAGATCTACACAACGGATCTAGAGCGGCTGTCTCCACAAGT
rpp30_F_77_ATTCTGTCCG	AATGATACGGCGACCACCGAGATCTACACATTCTGTCCGGAGCGGCTGTCTCCACAAGT
rpp30_F_78_ACTGTGGCCT	AATGATACGGCGACCACCGAGATCTACACACTGTGGCCTGAGCGGCTGTCTCCACAAGT
rpp30_F_79_CACACCTGGA	AATGATACGGCGACCACCGAGATCTACACCACACCTGGAGAGCGGCTGTCTCCACAAGT
rpp30_F_80_CACGGTATCA	AATGATACGGCGACCACCGAGATCTACACCACGGTATCAGAGCGGCTGTCTCCACAAGT
rpp30_F_81_TCAAGCAACG	AATGATACGGCGACCACCGAGATCTACACTCAAGCAACGGAGCGGCTGTCTCCACAAGT
rpp30_F_82_ACGAGTTGCG	AATGATACGGCGACCACCGAGATCTACACACGAGTTGCGGAGCGGCTGTCTCCACAAGT
rpp30_F_83_AGATCAGAGG	AATGATACGGCGACCACCGAGATCTACACAGATCAGAGGGAGCGGCTGTCTCCACAAGT
rpp30_F_84_CAATCTAGCG	AATGATACGGCGACCACCGAGATCTACACCAATCTAGCGGAGCGGCTGTCTCCACAAGT
rpp30_F_85_AACGGCCTAA	AATGATACGGCGACCACCGAGATCTACACAACGGCCTAAGAGCGGCTGTCTCCACAAGT
rpp30_F_86_ACGTTCATCG	AATGATACGGCGACCACCGAGATCTACACACGTTCATCGGAGCGGCTGTCTCCACAAGT
rpp30_F_87_AAGACCTTGG	AATGATACGGCGACCACCGAGATCTACACAAGACCTTGGGAGCGGCTGTCTCCACAAGT
rpp30_F_88_CCGATCAGTA	AATGATACGGCGACCACCGAGATCTACACCCGATCAGTAGAGCGGCTGTCTCCACAAGT
rpp30_F_89_AGGTGTCCAG	AATGATACGGCGACCACCGAGATCTACACAGGTGTCCAGGAGCGGCTGTCTCCACAAGT
rpp30_F_90_CTATGTACCG	AATGATACGGCGACCACCGAGATCTACACCTATGTACCGGAGCGGCTGTCTCCACAAGT
rpp30_F_91_ACAGATTCCG	AATGATACGGCGACCACCGAGATCTACACACAGATTCCGGAGCGGCTGTCTCCACAAGT
rpp30_F_92_AAGGAGATCA	AATGATACGGCGACCACCGAGATCTACACAAGGAGATCAGAGCGGCTGTCTCCACAAGT
rpp30_F_93_AATGCACGTA	AATGATACGGCGACCACCGAGATCTACACAATGCACGTAGAGCGGCTGTCTCCACAAGT
rpp30_F_94_GTTCTGGATG	AATGATACGGCGACCACCGAGATCTACACGTTCTGGATGGAGCGGCTGTCTCCACAAGT
rpp30_F_95_ATGGTAGTGG	AATGATACGGCGACCACCGAGATCTACACATGGTAGTGGGAGCGGCTGTCTCCACAAGT
rpp30_F_96_ATAGCTCTCT	AATGATACGGCGACCACCGAGATCTACACATAGCTCTCTGAGCGGCTGTCTCCACAAGT
rpp30_F_97_AAGGTGACGT	AATGATACGGCGACCACCGAGATCTACACAAGGTGACGTGAGCGGCTGTCTCCACAAGT
rpp30_F_98_ATTAGTACGG	AATGATACGGCGACCACCGAGATCTACACATTAGTACGGGAGCGGCTGTCTCCACAAGT
rpp30_F_99_AGACATTGGT	AATGATACGGCGACCACCGAGATCTACACAGACATTGGTGAGCGGCTGTCTCCACAAGT
rpp30_F_100_GATTGTCGTA	AATGATACGGCGACCACCGAGATCTACACGATTGTCGTAGAGCGGCTGTCTCCACAAGT
rpp30_F_101_AACTGTCCGG	AATGATACGGCGACCACCGAGATCTACACAACTGTCCGGGAGCGGCTGTCTCCACAAGT
rpp30_F_102_CGTGTAATTG	AATGATACGGCGACCACCGAGATCTACACCGTGTAATTGGAGCGGCTGTCTCCACAAGT
rpp30_F_103_ATGTCATACG	AATGATACGGCGACCACCGAGATCTACACATGTCATACGGAGCGGCTGTCTCCACAAGT
rpp30_F_104_CACTAGGATA	AATGATACGGCGACCACCGAGATCTACACCACTAGGATAGAGCGGCTGTCTCCACAAGT
rpp30_F_105_AATACGAGCG	AATGATACGGCGACCACCGAGATCTACACAATACGAGCGGAGCGGCTGTCTCCACAAGT
rpp30_F_106_ACACAATTCG	AATGATACGGCGACCACCGAGATCTACACACACAATTCGGAGCGGCTGTCTCCACAAGT
rpp30_F_107_CTGTGTTCAA	AATGATACGGCGACCACCGAGATCTACACCTGTGTTCAAGAGCGGCTGTCTCCACAAGT
rpp30_F_108_AGAAGGTCTG	AATGATACGGCGACCACCGAGATCTACACAGAAGGTCTGGAGCGGCTGTCTCCACAAGT
rpp30_F_109_AGTGCCAACG	AATGATACGGCGACCACCGAGATCTACACAGTGCCAACGGAGCGGCTGTCTCCACAAGT
rpp30_F_110_AGTGTTCTCT	AATGATACGGCGACCACCGAGATCTACACAGTGTTCTCTGAGCGGCTGTCTCCACAAGT
rpp30_F_111_CCGTGTTGTA	AATGATACGGCGACCACCGAGATCTACACCCGTGTTGTAGAGCGGCTGTCTCCACAAGT
rpp30_F_112_ACTGTGACGG	AATGATACGGCGACCACCGAGATCTACACACTGTGACGGGAGCGGCTGTCTCCACAAGT
rpp30_F_113_AACAGTGACG	AATGATACGGCGACCACCGAGATCTACACAACAGTGACGGAGCGGCTGTCTCCACAAGT
rpp30_F_114_CGTAACGTGG	AATGATACGGCGACCACCGAGATCTACACCGTAACGTGGGAGCGGCTGTCTCCACAAGT
rpp30_F_115_ATATGACGGA	AATGATACGGCGACCACCGAGATCTACACATATGACGGAGAGCGGCTGTCTCCACAAGT
rpp30_F_116_TTATCTTGCG	AATGATACGGCGACCACCGAGATCTACACTTATCTTGCGGAGCGGCTGTCTCCACAAGT
rpp30_F_117_CTAGTATTCG	AATGATACGGCGACCACCGAGATCTACACCTAGTATTCGGAGCGGCTGTCTCCACAAGT
rpp30_F_118_AATAGCTACG	AATGATACGGCGACCACCGAGATCTACACAATAGCTACGGAGCGGCTGTCTCCACAAGT
rpp30_F_119_AACGGAGAGG	AATGATACGGCGACCACCGAGATCTACACAACGGAGAGGGAGCGGCTGTCTCCACAAGT
rpp30_F_120_ATGTCGAGAG	AATGATACGGCGACCACCGAGATCTACACATGTCGAGAGGAGCGGCTGTCTCCACAAGT
rpp30_F_121_AGTGAGAGAG	AATGATACGGCGACCACCGAGATCTACACAGTGAGAGAGGAGCGGCTGTCTCCACAAGT
rpp30_F_122_CAACGTCTAA	AATGATACGGCGACCACCGAGATCTACACCAACGTCTAAGAGCGGCTGTCTCCACAAGT
rpp30_F_123_AAGCTTAGGA	AATGATACGGCGACCACCGAGATCTACACAAGCTTAGGAGAGCGGCTGTCTCCACAAGT
rpp30_F_124_GAACAAGTGG	AATGATACGGCGACCACCGAGATCTACACGAACAAGTGGGAGCGGCTGTCTCCACAAGT
rpp30_F_125_CTTGGAACCG	AATGATACGGCGACCACCGAGATCTACACCTTGGAACCGGAGCGGCTGTCTCCACAAGT
rpp30_F_126_ACCATATCGA	AATGATACGGCGACCACCGAGATCTACACACCATATCGAGAGCGGCTGTCTCCACAAGT
rpp30_F_127_ACAGGAAGCG	AATGATACGGCGACCACCGAGATCTACACACAGGAAGCGGAGCGGCTGTCTCCACAAGT
rpp30_F_128_ATGCTTATCG	AATGATACGGCGACCACCGAGATCTACACATGCTTATCGGAGCGGCTGTCTCCACAAGT
rpp30_F_129_ATGAACGGAA	AATGATACGGCGACCACCGAGATCTACACATGAACGGAAGAGCGGCTGTCTCCACAAGT
rpp30_F_130_ACTGTTCTTG	AATGATACGGCGACCACCGAGATCTACACACTGTTCTTGGAGCGGCTGTCTCCACAAGT
rpp30_F_131_CCTTGCTTCG	AATGATACGGCGACCACCGAGATCTACACCCTTGCTTCGGAGCGGCTGTCTCCACAAGT
rpp30_F_132_CGACATACCG	AATGATACGGCGACCACCGAGATCTACACCGACATACCGGAGCGGCTGTCTCCACAAGT
rpp30_F_133_ACTATTAGCG	AATGATACGGCGACCACCGAGATCTACACACTATTAGCGGAGCGGCTGTCTCCACAAGT
rpp30_F_134_AGTTAGATCG	AATGATACGGCGACCACCGAGATCTACACAGTTAGATCGGAGCGGCTGTCTCCACAAGT
rpp30_F_135_AGGAACATCG	AATGATACGGCGACCACCGAGATCTACACAGGAACATCGGAGCGGCTGTCTCCACAAGT
rpp30_F_136_CAGTGTATCT	AATGATACGGCGACCACCGAGATCTACACCAGTGTATCTGAGCGGCTGTCTCCACAAGT
rpp30_F_137_CTAATCGGTA	AATGATACGGCGACCACCGAGATCTACACCTAATCGGTAGAGCGGCTGTCTCCACAAGT
rpp30_F_138_ATCAGTGTTG	AATGATACGGCGACCACCGAGATCTACACATCAGTGTTGGAGCGGCTGTCTCCACAAGT
rpp30_F_139_TCTAGTCGGA	AATGATACGGCGACCACCGAGATCTACACTCTAGTCGGAGAGCGGCTGTCTCCACAAGT
rpp30_F_140_GCCTTCATCA	AATGATACGGCGACCACCGAGATCTACACGCCTTCATCAGAGCGGCTGTCTCCACAAGT
rpp30_F_141_CCAACTAACG	AATGATACGGCGACCACCGAGATCTACACCCAACTAACGGAGCGGCTGTCTCCACAAGT
rpp30_F_142_ACTATCTCTG	AATGATACGGCGACCACCGAGATCTACACACTATCTCTGGAGCGGCTGTCTCCACAAGT
rpp30_F_143_CCAGGTTGTT	AATGATACGGCGACCACCGAGATCTACACCCAGGTTGTTGAGCGGCTGTCTCCACAAGT
rpp30_F_144_ACACGGTTAA	AATGATACGGCGACCACCGAGATCTACACACACGGTTAAGAGCGGCTGTCTCCACAAGT
rpp30_F_145_GAAGTGTGTT	AATGATACGGCGACCACCGAGATCTACACGAAGTGTGTTGAGCGGCTGTCTCCACAAGT
rpp30_F_146_AGGAATTCGG	AATGATACGGCGACCACCGAGATCTACACAGGAATTCGGGAGCGGCTGTCTCCACAAGT
rpp30_F_147_AAGTTGAGCG	AATGATACGGCGACCACCGAGATCTACACAAGTTGAGCGGAGCGGCTGTCTCCACAAGT
rpp30_F_148_CTGGATCAGA	AATGATACGGCGACCACCGAGATCTACACCTGGATCAGAGAGCGGCTGTCTCCACAAGT
rpp30_F_149_ATGTTCTGAG	AATGATACGGCGACCACCGAGATCTACACATGTTCTGAGGAGCGGCTGTCTCCACAAGT
rpp30_F_150_CACATGGTCA	AATGATACGGCGACCACCGAGATCTACACCACATGGTCAGAGCGGCTGTCTCCACAAGT
rpp30_F_151_ACTTCGTGCG	AATGATACGGCGACCACCGAGATCTACACACTTCGTGCGGAGCGGCTGTCTCCACAAGT
rpp30_F_152_CAGTACGATG	AATGATACGGCGACCACCGAGATCTACACCAGTACGATGGAGCGGCTGTCTCCACAAGT
rpp30_F_153_ACTTAAGTCG	AATGATACGGCGACCACCGAGATCTACACACTTAAGTCGGAGCGGCTGTCTCCACAAGT
rpp30_F_154_AATGGTCTGA	AATGATACGGCGACCACCGAGATCTACACAATGGTCTGAGAGCGGCTGTCTCCACAAGT
rpp30_F_155_CCAACTGGTT	AATGATACGGCGACCACCGAGATCTACACCCAACTGGTTGAGCGGCTGTCTCCACAAGT
rpp30_F_156_TAGGATTACG	AATGATACGGCGACCACCGAGATCTACACTAGGATTACGGAGCGGCTGTCTCCACAAGT
rpp30_F_157_GTTCGGCTCT	AATGATACGGCGACCACCGAGATCTACACGTTCGGCTCTGAGCGGCTGTCTCCACAAGT
rpp30_F_158_ACATGAGTGG	AATGATACGGCGACCACCGAGATCTACACACATGAGTGGGAGCGGCTGTCTCCACAAGT
rpp30_F_159_ACGCATGGAA	AATGATACGGCGACCACCGAGATCTACACACGCATGGAAGAGCGGCTGTCTCCACAAGT
rpp30_F_160_ACAGCGTGAA	AATGATACGGCGACCACCGAGATCTACACACAGCGTGAAGAGCGGCTGTCTCCACAAGT
rpp30_F_161_CACGTATCGT	AATGATACGGCGACCACCGAGATCTACACCACGTATCGTGAGCGGCTGTCTCCACAAGT
rpp30_F_162_ATGTTGCGGA	AATGATACGGCGACCACCGAGATCTACACATGTTGCGGAGAGCGGCTGTCTCCACAAGT
rpp30_F_163_AATCGTGAGA	AATGATACGGCGACCACCGAGATCTACACAATCGTGAGAGAGCGGCTGTCTCCACAAGT
rpp30_F_164_CAGTGAACGG	AATGATACGGCGACCACCGAGATCTACACCAGTGAACGGGAGCGGCTGTCTCCACAAGT
rpp30_F_165_CGGATAATGG	AATGATACGGCGACCACCGAGATCTACACCGGATAATGGGAGCGGCTGTCTCCACAAGT
rpp30_F_166_CACCTTATCG	AATGATACGGCGACCACCGAGATCTACACCACCTTATCGGAGCGGCTGTCTCCACAAGT
rpp30_F_167_AAGCGTACGG	AATGATACGGCGACCACCGAGATCTACACAAGCGTACGGGAGCGGCTGTCTCCACAAGT
rpp30_F_168_AACGTCAACG	AATGATACGGCGACCACCGAGATCTACACAACGTCAACGGAGCGGCTGTCTCCACAAGT
rpp30_F_169_TACGAGGTAA	AATGATACGGCGACCACCGAGATCTACACTACGAGGTAAGAGCGGCTGTCTCCACAAGT
rpp30_F_170_CCGAGTGCAA	AATGATACGGCGACCACCGAGATCTACACCCGAGTGCAAGAGCGGCTGTCTCCACAAGT
rpp30_F_171_CCACTGATCT	AATGATACGGCGACCACCGAGATCTACACCCACTGATCTGAGCGGCTGTCTCCACAAGT
rpp30_F_172_ACATACCACG	AATGATACGGCGACCACCGAGATCTACACACATACCACGGAGCGGCTGTCTCCACAAGT
rpp30_F_173_GGATCATTGG	AATGATACGGCGACCACCGAGATCTACACGGATCATTGGGAGCGGCTGTCTCCACAAGT
rpp30_F_174_ATCGTTCGTA	AATGATACGGCGACCACCGAGATCTACACATCGTTCGTAGAGCGGCTGTCTCCACAAGT
rpp30_F_175_ATATGCGACG	AATGATACGGCGACCACCGAGATCTACACATATGCGACGGAGCGGCTGTCTCCACAAGT
rpp30_F_176_AGGAGAGGTA	AATGATACGGCGACCACCGAGATCTACACAGGAGAGGTAGAGCGGCTGTCTCCACAAGT
rpp30_F_177_GACATAATCG	AATGATACGGCGACCACCGAGATCTACACGACATAATCGGAGCGGCTGTCTCCACAAGT
rpp30_F_178_ATGGATCTCA	AATGATACGGCGACCACCGAGATCTACACATGGATCTCAGAGCGGCTGTCTCCACAAGT
rpp30_F_179_GATCTGAGGA	AATGATACGGCGACCACCGAGATCTACACGATCTGAGGAGAGCGGCTGTCTCCACAAGT
rpp30_F_180_ATGTTGTTGG	AATGATACGGCGACCACCGAGATCTACACATGTTGTTGGGAGCGGCTGTCTCCACAAGT
rpp30_F_181_GTTCTCATCG	AATGATACGGCGACCACCGAGATCTACACGTTCTCATCGGAGCGGCTGTCTCCACAAGT
rpp30_F_182_ACAGGTGTTA	AATGATACGGCGACCACCGAGATCTACACACAGGTGTTAGAGCGGCTGTCTCCACAAGT
rpp30_F_183_CATCGATCAA	AATGATACGGCGACCACCGAGATCTACACCATCGATCAAGAGCGGCTGTCTCCACAAGT
rpp30_F_184_AACATTCGGA	AATGATACGGCGACCACCGAGATCTACACAACATTCGGAGAGCGGCTGTCTCCACAAGT
rpp30_F_185_AACGGCTTGG	AATGATACGGCGACCACCGAGATCTACACAACGGCTTGGGAGCGGCTGTCTCCACAAGT
rpp30_F_186_TGGTCTATCG	AATGATACGGCGACCACCGAGATCTACACTGGTCTATCGGAGCGGCTGTCTCCACAAGT
rpp30_F_187_AATGCAATCG	AATGATACGGCGACCACCGAGATCTACACAATGCAATCGGAGCGGCTGTCTCCACAAGT
rpp30_F_188_CAACACTTCG	AATGATACGGCGACCACCGAGATCTACACCAACACTTCGGAGCGGCTGTCTCCACAAGT
rpp30_F_189_ATATCACCGT	AATGATACGGCGACCACCGAGATCTACACATATCACCGTGAGCGGCTGTCTCCACAAGT
rpp30_F_190_GAACCTGTCG	AATGATACGGCGACCACCGAGATCTACACGAACCTGTCGGAGCGGCTGTCTCCACAAGT
rpp30_F_191_ACACAGCGTA	AATGATACGGCGACCACCGAGATCTACACACACAGCGTAGAGCGGCTGTCTCCACAAGT
rpp30_F_192_TGAGGATAGA	AATGATACGGCGACCACCGAGATCTACACTGAGGATAGAGAGCGGCTGTCTCCACAAGT
rpp30_F_193_ATCGACTGTT	AATGATACGGCGACCACCGAGATCTACACATCGACTGTTGAGCGGCTGTCTCCACAAGT
rpp30_F_194_AGACTTACGG	AATGATACGGCGACCACCGAGATCTACACAGACTTACGGGAGCGGCTGTCTCCACAAGT
rpp30_F_195_ACATCATCCG	AATGATACGGCGACCACCGAGATCTACACACATCATCCGGAGCGGCTGTCTCCACAAGT
rpp30_F_196_AATCAGAACG	AATGATACGGCGACCACCGAGATCTACACAATCAGAACGGAGCGGCTGTCTCCACAAGT
rpp30_F_197_AGTAGTTGGT	AATGATACGGCGACCACCGAGATCTACACAGTAGTTGGTGAGCGGCTGTCTCCACAAGT
rpp30_F_198_GAGATTCCGG	AATGATACGGCGACCACCGAGATCTACACGAGATTCCGGGAGCGGCTGTCTCCACAAGT
rpp30_F_199_CAGTAGAGTT	AATGATACGGCGACCACCGAGATCTACACCAGTAGAGTTGAGCGGCTGTCTCCACAAGT
rpp30_F_200_GAGTTCTATC	AATGATACGGCGACCACCGAGATCTACACGAGTTCTATCGAGCGGCTGTCTCCACAAGT
rpp30_F_201_ATAGATGCGG	AATGATACGGCGACCACCGAGATCTACACATAGATGCGGGAGCGGCTGTCTCCACAAGT
rpp30_F_202_AGATCGGCCA	AATGATACGGCGACCACCGAGATCTACACAGATCGGCCAGAGCGGCTGTCTCCACAAGT
rpp30_F_203_AGCTAGTGAT	AATGATACGGCGACCACCGAGATCTACACAGCTAGTGATGAGCGGCTGTCTCCACAAGT
rpp30_F_204_ACTCACTACG	AATGATACGGCGACCACCGAGATCTACACACTCACTACGGAGCGGCTGTCTCCACAAGT
rpp30_F_205_AGGTGAGGAT	AATGATACGGCGACCACCGAGATCTACACAGGTGAGGATGAGCGGCTGTCTCCACAAGT
rpp30_F_206_AAGCTGTCTA	AATGATACGGCGACCACCGAGATCTACACAAGCTGTCTAGAGCGGCTGTCTCCACAAGT
rpp30_F_207_CCACGCATGA	AATGATACGGCGACCACCGAGATCTACACCCACGCATGAGAGCGGCTGTCTCCACAAGT
rpp30_F_208_AGACGGATAG	AATGATACGGCGACCACCGAGATCTACACAGACGGATAGGAGCGGCTGTCTCCACAAGT
rpp30_F_209_CTCCTATACG	AATGATACGGCGACCACCGAGATCTACACCTCCTATACGGAGCGGCTGTCTCCACAAGT
rpp30_F_210_GTAAGATTGG	AATGATACGGCGACCACCGAGATCTACACGTAAGATTGGGAGCGGCTGTCTCCACAAGT
rpp30_F_211_AAGCTATCCG	AATGATACGGCGACCACCGAGATCTACACAAGCTATCCGGAGCGGCTGTCTCCACAAGT
rpp30_F_212_CAACTGGTAA	AATGATACGGCGACCACCGAGATCTACACCAACTGGTAAGAGCGGCTGTCTCCACAAGT
rpp30_F_213_GTAATGGCCA	AATGATACGGCGACCACCGAGATCTACACGTAATGGCCAGAGCGGCTGTCTCCACAAGT
rpp30_F_214_GACTGTAGCG	AATGATACGGCGACCACCGAGATCTACACGACTGTAGCGGAGCGGCTGTCTCCACAAGT
rpp30_F_215_ACATGTCAGA	AATGATACGGCGACCACCGAGATCTACACACATGTCAGAGAGCGGCTGTCTCCACAAGT
rpp30_F_216_ACGGCTATAA	AATGATACGGCGACCACCGAGATCTACACACGGCTATAAGAGCGGCTGTCTCCACAAGT
rpp30_F_217_GGCTAATCCT	AATGATACGGCGACCACCGAGATCTACACGGCTAATCCTGAGCGGCTGTCTCCACAAGT
rpp30_F_218_GGCTACGAAG	AATGATACGGCGACCACCGAGATCTACACGGCTACGAAGGAGCGGCTGTCTCCACAAGT
rpp30_F_219_GGCTTCCTAT	AATGATACGGCGACCACCGAGATCTACACGGCTTCCTATGAGCGGCTGTCTCCACAAGT
rpp30_F_220_ACATTGTTCG	AATGATACGGCGACCACCGAGATCTACACACATTGTTCGGAGCGGCTGTCTCCACAAGT
rpp30_F_221_ACTCCGGTAA	AATGATACGGCGACCACCGAGATCTACACACTCCGGTAAGAGCGGCTGTCTCCACAAGT
rpp30_F_222_CCGTGGATCA	AATGATACGGCGACCACCGAGATCTACACCCGTGGATCAGAGCGGCTGTCTCCACAAGT
rpp30_F_223_AAGACCAACG	AATGATACGGCGACCACCGAGATCTACACAAGACCAACGGAGCGGCTGTCTCCACAAGT
rpp30_F_224_TCTAAGGACG	AATGATACGGCGACCACCGAGATCTACACTCTAAGGACGGAGCGGCTGTCTCCACAAGT
rpp30_F_225_CGAGATCTTA	AATGATACGGCGACCACCGAGATCTACACCGAGATCTTAGAGCGGCTGTCTCCACAAGT
rpp30_F_226_GAATGTTACG	AATGATACGGCGACCACCGAGATCTACACGAATGTTACGGAGCGGCTGTCTCCACAAGT
rpp30_F_227_GTATAGCTCT	AATGATACGGCGACCACCGAGATCTACACGTATAGCTCTGAGCGGCTGTCTCCACAAGT
rpp30_F_228_CGTAAGCGTA	AATGATACGGCGACCACCGAGATCTACACCGTAAGCGTAGAGCGGCTGTCTCCACAAGT
rpp30_F_229_TCCTTCCACG	AATGATACGGCGACCACCGAGATCTACACTCCTTCCACGGAGCGGCTGTCTCCACAAGT
rpp30_F_230_ACGAGGTTGA	AATGATACGGCGACCACCGAGATCTACACACGAGGTTGAGAGCGGCTGTCTCCACAAGT
rpp30_F_231_CGTATAGCGG	AATGATACGGCGACCACCGAGATCTACACCGTATAGCGGGAGCGGCTGTCTCCACAAGT
rpp30_F_232_TAACCGTTCG	AATGATACGGCGACCACCGAGATCTACACTAACCGTTCGGAGCGGCTGTCTCCACAAGT
rpp30_F_233_AAGTTCTACG	AATGATACGGCGACCACCGAGATCTACACAAGTTCTACGGAGCGGCTGTCTCCACAAGT
rpp30_F_234_AGAGCGATCG	AATGATACGGCGACCACCGAGATCTACACAGAGCGATCGGAGCGGCTGTCTCCACAAGT
rpp30_F_235_CAAGCTTCCT	AATGATACGGCGACCACCGAGATCTACACCAAGCTTCCTGAGCGGCTGTCTCCACAAGT
rpp30_F_236_CACGCATACG	AATGATACGGCGACCACCGAGATCTACACCACGCATACGGAGCGGCTGTCTCCACAAGT
rpp30_F_237_ACATTCACGG	AATGATACGGCGACCACCGAGATCTACACACATTCACGGGAGCGGCTGTCTCCACAAGT
rpp30_F_238_AACTCTCTGT	AATGATACGGCGACCACCGAGATCTACACAACTCTCTGTGAGCGGCTGTCTCCACAAGT
rpp30_F_239_AGCAGTAGAG	AATGATACGGCGACCACCGAGATCTACACAGCAGTAGAGGAGCGGCTGTCTCCACAAGT
rpp30_F_240_ATCGGACAAG	AATGATACGGCGACCACCGAGATCTACACATCGGACAAGGAGCGGCTGTCTCCACAAGT
rpp30_F_241_ATCACCGTAA	AATGATACGGCGACCACCGAGATCTACACATCACCGTAAGAGCGGCTGTCTCCACAAGT
rpp30_F_242_CCAGTATGTA	AATGATACGGCGACCACCGAGATCTACACCCAGTATGTAGAGCGGCTGTCTCCACAAGT
rpp30_F_243_CGGTTCCTAA	AATGATACGGCGACCACCGAGATCTACACCGGTTCCTAAGAGCGGCTGTCTCCACAAGT
rpp30_F_244_CATAACACCG	AATGATACGGCGACCACCGAGATCTACACCATAACACCGGAGCGGCTGTCTCCACAAGT
rpp30_F_245_AACCACGACG	AATGATACGGCGACCACCGAGATCTACACAACCACGACGGAGCGGCTGTCTCCACAAGT
rpp30_F_246_AGCTAATGGA	AATGATACGGCGACCACCGAGATCTACACAGCTAATGGAGAGCGGCTGTCTCCACAAGT
rpp30_F_247_CGAGGTAGAG	AATGATACGGCGACCACCGAGATCTACACCGAGGTAGAGGAGCGGCTGTCTCCACAAGT
rpp30_F_248_GGATCCAATG	AATGATACGGCGACCACCGAGATCTACACGGATCCAATGGAGCGGCTGTCTCCACAAGT
rpp30_F_249_GGCAATCTTG	AATGATACGGCGACCACCGAGATCTACACGGCAATCTTGGAGCGGCTGTCTCCACAAGT
rpp30_F_250_AATATGGCCA	AATGATACGGCGACCACCGAGATCTACACAATATGGCCAGAGCGGCTGTCTCCACAAGT
rpp30_F_251_TCAAGCGGTA	AATGATACGGCGACCACCGAGATCTACACTCAAGCGGTAGAGCGGCTGTCTCCACAAGT
rpp30_F_252_CTCAATTGGT	AATGATACGGCGACCACCGAGATCTACACCTCAATTGGTGAGCGGCTGTCTCCACAAGT
rpp30_F_253_CAACCGGACT	AATGATACGGCGACCACCGAGATCTACACCAACCGGACTGAGCGGCTGTCTCCACAAGT
rpp30_F_254_ACTTCGGCAT	AATGATACGGCGACCACCGAGATCTACACACTTCGGCATGAGCGGCTGTCTCCACAAGT
rpp30_F_255_CTGATGCAAG	AATGATACGGCGACCACCGAGATCTACACCTGATGCAAGGAGCGGCTGTCTCCACAAGT
rpp30_F_256_AGATAGTCCG	AATGATACGGCGACCACCGAGATCTACACAGATAGTCCGGAGCGGCTGTCTCCACAAGT
rpp30_F_257_ACCAGGCTTA	AATGATACGGCGACCACCGAGATCTACACACCAGGCTTAGAGCGGCTGTCTCCACAAGT
rpp30_F_258_GCATATTCGG	AATGATACGGCGACCACCGAGATCTACACGCATATTCGGGAGCGGCTGTCTCCACAAGT
rpp30_F_259_GACGCACAGA	AATGATACGGCGACCACCGAGATCTACACGACGCACAGAGAGCGGCTGTCTCCACAAGT
rpp30_F_260_GGCCTGCATT	AATGATACGGCGACCACCGAGATCTACACGGCCTGCATTGAGCGGCTGTCTCCACAAGT
rpp30_F_261_GTAGTGTGAA	AATGATACGGCGACCACCGAGATCTACACGTAGTGTGAAGAGCGGCTGTCTCCACAAGT
rpp30_F_262_TACATGGCGG	AATGATACGGCGACCACCGAGATCTACACTACATGGCGGGAGCGGCTGTCTCCACAAGT
rpp30_F_263_GATATGAACG	AATGATACGGCGACCACCGAGATCTACACGATATGAACGGAGCGGCTGTCTCCACAAGT
rpp30_F_264_GGCTCCATTA	AATGATACGGCGACCACCGAGATCTACACGGCTCCATTAGAGCGGCTGTCTCCACAAGT
rpp30_F_265_AGTCGTTACG	AATGATACGGCGACCACCGAGATCTACACAGTCGTTACGGAGCGGCTGTCTCCACAAGT
rpp30_F_266_CCATCGGATT	AATGATACGGCGACCACCGAGATCTACACCCATCGGATTGAGCGGCTGTCTCCACAAGT
rpp30_F_267_GTAAGGAGTA	AATGATACGGCGACCACCGAGATCTACACGTAAGGAGTAGAGCGGCTGTCTCCACAAGT
rpp30_F_268_GAAGATGCGT	AATGATACGGCGACCACCGAGATCTACACGAAGATGCGTGAGCGGCTGTCTCCACAAGT
rpp30_F_269_AGATCTTCAG	AATGATACGGCGACCACCGAGATCTACACAGATCTTCAGGAGCGGCTGTCTCCACAAGT
rpp30_F_270_CGATGAGGTA	AATGATACGGCGACCACCGAGATCTACACCGATGAGGTAGAGCGGCTGTCTCCACAAGT
rpp30_F_271_ATTGAATCGG	AATGATACGGCGACCACCGAGATCTACACATTGAATCGGGAGCGGCTGTCTCCACAAGT
rpp30_F_272_CAATCATCGG	AATGATACGGCGACCACCGAGATCTACACCAATCATCGGGAGCGGCTGTCTCCACAAGT
rpp30_F_273_GACCTATCGG	AATGATACGGCGACCACCGAGATCTACACGACCTATCGGGAGCGGCTGTCTCCACAAGT
rpp30_F_274_GAATCGGCAA	AATGATACGGCGACCACCGAGATCTACACGAATCGGCAAGAGCGGCTGTCTCCACAAGT
rpp30_F_275_AGACGTTAGA	AATGATACGGCGACCACCGAGATCTACACAGACGTTAGAGAGCGGCTGTCTCCACAAGT
rpp30_F_276_GGATACCTTG	AATGATACGGCGACCACCGAGATCTACACGGATACCTTGGAGCGGCTGTCTCCACAAGT
rpp30_F_277_TCTCATCACG	AATGATACGGCGACCACCGAGATCTACACTCTCATCACGGAGCGGCTGTCTCCACAAGT
rpp30_F_278_AAGCTTGCGT	AATGATACGGCGACCACCGAGATCTACACAAGCTTGCGTGAGCGGCTGTCTCCACAAGT
rpp30_F_279_CTACTTGTCG	AATGATACGGCGACCACCGAGATCTACACCTACTTGTCGGAGCGGCTGTCTCCACAAGT
rpp30_F_280_AGGAAGGCCT	AATGATACGGCGACCACCGAGATCTACACAGGAAGGCCTGAGCGGCTGTCTCCACAAGT
rpp30_F_281_AGTGATGTAG	AATGATACGGCGACCACCGAGATCTACACAGTGATGTAGGAGCGGCTGTCTCCACAAGT
rpp30_F_282_AGGCATGTCG	AATGATACGGCGACCACCGAGATCTACACAGGCATGTCGGAGCGGCTGTCTCCACAAGT
rpp30_F_283_ACAGACATCG	AATGATACGGCGACCACCGAGATCTACACACAGACATCGGAGCGGCTGTCTCCACAAGT
rpp30_F_284_AGGTAGGTAA	AATGATACGGCGACCACCGAGATCTACACAGGTAGGTAAGAGCGGCTGTCTCCACAAGT
rpp30_F_285_ATCGGCTACT	AATGATACGGCGACCACCGAGATCTACACATCGGCTACTGAGCGGCTGTCTCCACAAGT
rpp30_F_286_ACGGCCACTT	AATGATACGGCGACCACCGAGATCTACACACGGCCACTTGAGCGGCTGTCTCCACAAGT
rpp30_F_287_CAGAGCGGAA	AATGATACGGCGACCACCGAGATCTACACCAGAGCGGAAGAGCGGCTGTCTCCACAAGT
rpp30_F_288_CAAGTCCGTG	AATGATACGGCGACCACCGAGATCTACACCAAGTCCGTGGAGCGGCTGTCTCCACAAGT
rpp30_F_289_CGTCAATGCG	AATGATACGGCGACCACCGAGATCTACACCGTCAATGCGGAGCGGCTGTCTCCACAAGT
rpp30_F_290_GGATCATGCT	AATGATACGGCGACCACCGAGATCTACACGGATCATGCTGAGCGGCTGTCTCCACAAGT
rpp30_F_291_GTGTTAGAGT	AATGATACGGCGACCACCGAGATCTACACGTGTTAGAGTGAGCGGCTGTCTCCACAAGT
rpp30_F_292_ATCAAGCGTC	AATGATACGGCGACCACCGAGATCTACACATCAAGCGTCGAGCGGCTGTCTCCACAAGT
rpp30_F_293_AGGAATGTGA	AATGATACGGCGACCACCGAGATCTACACAGGAATGTGAGAGCGGCTGTCTCCACAAGT
rpp30_F_294_AACATGCGCG	AATGATACGGCGACCACCGAGATCTACACAACATGCGCGGAGCGGCTGTCTCCACAAGT
rpp30_F_295_AACTTAGGCG	AATGATACGGCGACCACCGAGATCTACACAACTTAGGCGGAGCGGCTGTCTCCACAAGT
rpp30_F_296_ATACGTACTG	AATGATACGGCGACCACCGAGATCTACACATACGTACTGGAGCGGCTGTCTCCACAAGT
rpp30_F_297_ATGGATGCCT	AATGATACGGCGACCACCGAGATCTACACATGGATGCCTGAGCGGCTGTCTCCACAAGT
rpp30_F_298_GCTAGATCGA	AATGATACGGCGACCACCGAGATCTACACGCTAGATCGAGAGCGGCTGTCTCCACAAGT
rpp30_F_299_AGTTACCGTA	AATGATACGGCGACCACCGAGATCTACACAGTTACCGTAGAGCGGCTGTCTCCACAAGT
rpp30_F_300_AGACTGCGTG	AATGATACGGCGACCACCGAGATCTACACAGACTGCGTGGAGCGGCTGTCTCCACAAGT
rpp30_F_301_GCATGAACGT	AATGATACGGCGACCACCGAGATCTACACGCATGAACGTGAGCGGCTGTCTCCACAAGT
rpp30_F_302_CGTGAGAACG	AATGATACGGCGACCACCGAGATCTACACCGTGAGAACGGAGCGGCTGTCTCCACAAGT
rpp30_F_303_CAGAGTAACG	AATGATACGGCGACCACCGAGATCTACACCAGAGTAACGGAGCGGCTGTCTCCACAAGT
rpp30_F_304_AGCGGTAAGG	AATGATACGGCGACCACCGAGATCTACACAGCGGTAAGGGAGCGGCTGTCTCCACAAGT
rpp30_F_305_ACATGGAGTA	AATGATACGGCGACCACCGAGATCTACACACATGGAGTAGAGCGGCTGTCTCCACAAGT
rpp30_F_306_GTGAGATTCA	AATGATACGGCGACCACCGAGATCTACACGTGAGATTCAGAGCGGCTGTCTCCACAAGT
rpp30_F_307_GGATAGAGCT	AATGATACGGCGACCACCGAGATCTACACGGATAGAGCTGAGCGGCTGTCTCCACAAGT
rpp30_F_308_ACTACTTCCG	AATGATACGGCGACCACCGAGATCTACACACTACTTCCGGAGCGGCTGTCTCCACAAGT
rpp30_F_309_ATGTATGTCC	AATGATACGGCGACCACCGAGATCTACACATGTATGTCCGAGCGGCTGTCTCCACAAGT
rpp30_F_310_AAGCGGATTG	AATGATACGGCGACCACCGAGATCTACACAAGCGGATTGGAGCGGCTGTCTCCACAAGT
rpp30_F_311_CACGGCTATG	AATGATACGGCGACCACCGAGATCTACACCACGGCTATGGAGCGGCTGTCTCCACAAGT
rpp30_F_312_CCTGCTTAAG	AATGATACGGCGACCACCGAGATCTACACCCTGCTTAAGGAGCGGCTGTCTCCACAAGT
rpp30_F_313_AAGACTTGTC	AATGATACGGCGACCACCGAGATCTACACAAGACTTGTCGAGCGGCTGTCTCCACAAGT
rpp30_F_314_GGCTGTCATA	AATGATACGGCGACCACCGAGATCTACACGGCTGTCATAGAGCGGCTGTCTCCACAAGT
rpp30_F_315_ACAGTATCGG	AATGATACGGCGACCACCGAGATCTACACACAGTATCGGGAGCGGCTGTCTCCACAAGT
rpp30_F_316_AAGCAGTGTT	AATGATACGGCGACCACCGAGATCTACACAAGCAGTGTTGAGCGGCTGTCTCCACAAGT
rpp30_F_317_CGATCTACGG	AATGATACGGCGACCACCGAGATCTACACCGATCTACGGGAGCGGCTGTCTCCACAAGT
rpp30_F_318_ACCTAACCGG	AATGATACGGCGACCACCGAGATCTACACACCTAACCGGGAGCGGCTGTCTCCACAAGT
rpp30_F_319_GGTACACAAG	AATGATACGGCGACCACCGAGATCTACACGGTACACAAGGAGCGGCTGTCTCCACAAGT
rpp30_F_320_ACGTTCGGAA	AATGATACGGCGACCACCGAGATCTACACACGTTCGGAAGAGCGGCTGTCTCCACAAGT
rpp30_F_321_AGGTACGTTG	AATGATACGGCGACCACCGAGATCTACACAGGTACGTTGGAGCGGCTGTCTCCACAAGT
rpp30_F_322_AGACCGGAGT	AATGATACGGCGACCACCGAGATCTACACAGACCGGAGTGAGCGGCTGTCTCCACAAGT
rpp30_F_323_CTGATCATTG	AATGATACGGCGACCACCGAGATCTACACCTGATCATTGGAGCGGCTGTCTCCACAAGT
rpp30_F_324_GGAGTGCCTA	AATGATACGGCGACCACCGAGATCTACACGGAGTGCCTAGAGCGGCTGTCTCCACAAGT
rpp30_F_325_CATCGGAACT	AATGATACGGCGACCACCGAGATCTACACCATCGGAACTGAGCGGCTGTCTCCACAAGT
rpp30_F_326_AGTTGTACCG	AATGATACGGCGACCACCGAGATCTACACAGTTGTACCGGAGCGGCTGTCTCCACAAGT
rpp30_F_327_ATTATCGCGA	AATGATACGGCGACCACCGAGATCTACACATTATCGCGAGAGCGGCTGTCTCCACAAGT
rpp30_F_328_TAATCCAACG	AATGATACGGCGACCACCGAGATCTACACTAATCCAACGGAGCGGCTGTCTCCACAAGT
rpp30_F_329_CTGGAACCAA	AATGATACGGCGACCACCGAGATCTACACCTGGAACCAAGAGCGGCTGTCTCCACAAGT
rpp30_F_330_ACCGAGCTTC	AATGATACGGCGACCACCGAGATCTACACACCGAGCTTCGAGCGGCTGTCTCCACAAGT
rpp30_F_331_AGCGTTGTTG	AATGATACGGCGACCACCGAGATCTACACAGCGTTGTTGGAGCGGCTGTCTCCACAAGT
rpp30_F_332_CACTCCGTTG	AATGATACGGCGACCACCGAGATCTACACCACTCCGTTGGAGCGGCTGTCTCCACAAGT
rpp30_F_333_ATCCTGATCT	AATGATACGGCGACCACCGAGATCTACACATCCTGATCTGAGCGGCTGTCTCCACAAGT
rpp30_F_334_AATTCCGTCG	AATGATACGGCGACCACCGAGATCTACACAATTCCGTCGGAGCGGCTGTCTCCACAAGT
rpp30_F_335_ATGCGATTCG	AATGATACGGCGACCACCGAGATCTACACATGCGATTCGGAGCGGCTGTCTCCACAAGT
rpp30_F_336_ACGGTACATG	AATGATACGGCGACCACCGAGATCTACACACGGTACATGGAGCGGCTGTCTCCACAAGT
rpp30_F_337_ACCAATCACG	AATGATACGGCGACCACCGAGATCTACACACCAATCACGGAGCGGCTGTCTCCACAAGT
rpp30_F_338_AGCATGGTAG	AATGATACGGCGACCACCGAGATCTACACAGCATGGTAGGAGCGGCTGTCTCCACAAGT
rpp30_F_339_CGGTAGACAT	AATGATACGGCGACCACCGAGATCTACACCGGTAGACATGAGCGGCTGTCTCCACAAGT
rpp30_F_340_TAGAATAGCG	AATGATACGGCGACCACCGAGATCTACACTAGAATAGCGGAGCGGCTGTCTCCACAAGT
rpp30_F_341_CTACTAACGG	AATGATACGGCGACCACCGAGATCTACACCTACTAACGGGAGCGGCTGTCTCCACAAGT
rpp30_F_342_GTCAGAATTG	AATGATACGGCGACCACCGAGATCTACACGTCAGAATTGGAGCGGCTGTCTCCACAAGT
rpp30_F_343_CTGCAACAGG	AATGATACGGCGACCACCGAGATCTACACCTGCAACAGGGAGCGGCTGTCTCCACAAGT
rpp30_F_344_TATCTTACGG	AATGATACGGCGACCACCGAGATCTACACTATCTTACGGGAGCGGCTGTCTCCACAAGT
rpp30_F_345_CCTATTCCGG	AATGATACGGCGACCACCGAGATCTACACCCTATTCCGGGAGCGGCTGTCTCCACAAGT
rpp30_F_346_AGAGCTCAGA	AATGATACGGCGACCACCGAGATCTACACAGAGCTCAGAGAGCGGCTGTCTCCACAAGT
rpp30_F_347_CCGTGATCTT	AATGATACGGCGACCACCGAGATCTACACCCGTGATCTTGAGCGGCTGTCTCCACAAGT
rpp30_F_348_CTGCATTCGG	AATGATACGGCGACCACCGAGATCTACACCTGCATTCGGGAGCGGCTGTCTCCACAAGT
rpp30_F_349_GGCTAGAACA	AATGATACGGCGACCACCGAGATCTACACGGCTAGAACAGAGCGGCTGTCTCCACAAGT
rpp30_F_350_CATTAGGTCT	AATGATACGGCGACCACCGAGATCTACACCATTAGGTCTGAGCGGCTGTCTCCACAAGT
rpp30_F_351_ACCAACGTCG	AATGATACGGCGACCACCGAGATCTACACACCAACGTCGGAGCGGCTGTCTCCACAAGT
rpp30_F_352_CGTTGTCGAG	AATGATACGGCGACCACCGAGATCTACACCGTTGTCGAGGAGCGGCTGTCTCCACAAGT
rpp30_F_353_AGGAAGCGGA	AATGATACGGCGACCACCGAGATCTACACAGGAAGCGGAGAGCGGCTGTCTCCACAAGT
rpp30_F_354_CAGATCTACC	AATGATACGGCGACCACCGAGATCTACACCAGATCTACCGAGCGGCTGTCTCCACAAGT
rpp30_F_355_GCTTATACGT	AATGATACGGCGACCACCGAGATCTACACGCTTATACGTGAGCGGCTGTCTCCACAAGT
rpp30_F_356_TCCATGTTCG	AATGATACGGCGACCACCGAGATCTACACTCCATGTTCGGAGCGGCTGTCTCCACAAGT
rpp30_F_357_TCCGATCTAG	AATGATACGGCGACCACCGAGATCTACACTCCGATCTAGGAGCGGCTGTCTCCACAAGT
rpp30_F_358_ATTGTCCGTG	AATGATACGGCGACCACCGAGATCTACACATTGTCCGTGGAGCGGCTGTCTCCACAAGT
rpp30_F_359_CGTGACTATA	AATGATACGGCGACCACCGAGATCTACACCGTGACTATAGAGCGGCTGTCTCCACAAGT
rpp30_F_360_CAGGTAAGAT	AATGATACGGCGACCACCGAGATCTACACCAGGTAAGATGAGCGGCTGTCTCCACAAGT
rpp30_F_361_CCAATCTTCG	AATGATACGGCGACCACCGAGATCTACACCCAATCTTCGGAGCGGCTGTCTCCACAAGT
rpp30_F_362_ATTACCGTGG	AATGATACGGCGACCACCGAGATCTACACATTACCGTGGGAGCGGCTGTCTCCACAAGT
rpp30_F_363_AGCATGTTGA	AATGATACGGCGACCACCGAGATCTACACAGCATGTTGAGAGCGGCTGTCTCCACAAGT
rpp30_F_364_AGTACTACGA	AATGATACGGCGACCACCGAGATCTACACAGTACTACGAGAGCGGCTGTCTCCACAAGT
rpp30_F_365_GTAGCACACG	AATGATACGGCGACCACCGAGATCTACACGTAGCACACGGAGCGGCTGTCTCCACAAGT
rpp30_F_366_CAGTCTTGGA	AATGATACGGCGACCACCGAGATCTACACCAGTCTTGGAGAGCGGCTGTCTCCACAAGT
rpp30_F_367_AAGAGAATCG	AATGATACGGCGACCACCGAGATCTACACAAGAGAATCGGAGCGGCTGTCTCCACAAGT
rpp30_F_368_AGACTGGTTA	AATGATACGGCGACCACCGAGATCTACACAGACTGGTTAGAGCGGCTGTCTCCACAAGT
rpp30_F_369_GCTTCGTTGA	AATGATACGGCGACCACCGAGATCTACACGCTTCGTTGAGAGCGGCTGTCTCCACAAGT
rpp30_F_370_AGTGTCGACT	AATGATACGGCGACCACCGAGATCTACACAGTGTCGACTGAGCGGCTGTCTCCACAAGT
rpp30_F_371_GAAGTGGCCT	AATGATACGGCGACCACCGAGATCTACACGAAGTGGCCTGAGCGGCTGTCTCCACAAGT
rpp30_F_372_ATGCATCGGA	AATGATACGGCGACCACCGAGATCTACACATGCATCGGAGAGCGGCTGTCTCCACAAGT
rpp30_F_373_ACCGGATGAA	AATGATACGGCGACCACCGAGATCTACACACCGGATGAAGAGCGGCTGTCTCCACAAGT
rpp30_F_374_GACGGAAGAA	AATGATACGGCGACCACCGAGATCTACACGACGGAAGAAGAGCGGCTGTCTCCACAAGT
rpp30_F_375_GACGGAGTGA	AATGATACGGCGACCACCGAGATCTACACGACGGAGTGAGAGCGGCTGTCTCCACAAGT
rpp30_F_376_CTGCAGAGAT	AATGATACGGCGACCACCGAGATCTACACCTGCAGAGATGAGCGGCTGTCTCCACAAGT
rpp30_F_377_CATGCATTCT	AATGATACGGCGACCACCGAGATCTACACCATGCATTCTGAGCGGCTGTCTCCACAAGT
rpp30_F_378_ATGTGCTAGG	AATGATACGGCGACCACCGAGATCTACACATGTGCTAGGGAGCGGCTGTCTCCACAAGT
rpp30_F_379_CCGTGGTAGA	AATGATACGGCGACCACCGAGATCTACACCCGTGGTAGAGAGCGGCTGTCTCCACAAGT
rpp30_F_380_CTGTACACCG	AATGATACGGCGACCACCGAGATCTACACCTGTACACCGGAGCGGCTGTCTCCACAAGT
rpp30_F_381_GTACGGCTGA	AATGATACGGCGACCACCGAGATCTACACGTACGGCTGAGAGCGGCTGTCTCCACAAGT
rpp30_F_382_CACGGTCTGT	AATGATACGGCGACCACCGAGATCTACACCACGGTCTGTGAGCGGCTGTCTCCACAAGT
rpp30_F_383_CTGGTCAACT	AATGATACGGCGACCACCGAGATCTACACCTGGTCAACTGAGCGGCTGTCTCCACAAGT
rpp30_F_384_CTCAAGTACG	AATGATACGGCGACCACCGAGATCTACACCTCAAGTACGGAGCGGCTGTCTCCACAAGT
rpp30_F_385_CTGGAATGTA	AATGATACGGCGACCACCGAGATCTACACCTGGAATGTAGAGCGGCTGTCTCCACAAGT
rpp30_F_386_AACTTGCTGG	AATGATACGGCGACCACCGAGATCTACACAACTTGCTGGGAGCGGCTGTCTCCACAAGT
rpp30_F_387_AAGATCGGAC	AATGATACGGCGACCACCGAGATCTACACAAGATCGGACGAGCGGCTGTCTCCACAAGT
rpp30_F_388_CCGGTAGATA	AATGATACGGCGACCACCGAGATCTACACCCGGTAGATAGAGCGGCTGTCTCCACAAGT
rpp30_F_389_CGTGTGTAAG	AATGATACGGCGACCACCGAGATCTACACCGTGTGTAAGGAGCGGCTGTCTCCACAAGT
rpp30_F_390_AGGATCGATG	AATGATACGGCGACCACCGAGATCTACACAGGATCGATGGAGCGGCTGTCTCCACAAGT
rpp30_F_391_GCGCAATTAA	AATGATACGGCGACCACCGAGATCTACACGCGCAATTAAGAGCGGCTGTCTCCACAAGT
rpp30_F_392_CACTTGTGTT	AATGATACGGCGACCACCGAGATCTACACCACTTGTGTTGAGCGGCTGTCTCCACAAGT
rpp30_F_393_CAATGAGATG	AATGATACGGCGACCACCGAGATCTACACCAATGAGATGGAGCGGCTGTCTCCACAAGT
rpp30_F_394_CTGACTATCG	AATGATACGGCGACCACCGAGATCTACACCTGACTATCGGAGCGGCTGTCTCCACAAGT
rpp30_F_395_GTCATTCACG	AATGATACGGCGACCACCGAGATCTACACGTCATTCACGGAGCGGCTGTCTCCACAAGT
rpp30_F_396_CATTGAAGCG	AATGATACGGCGACCACCGAGATCTACACCATTGAAGCGGAGCGGCTGTCTCCACAAGT
rpp30_F_397_CGGATCTTGC	AATGATACGGCGACCACCGAGATCTACACCGGATCTTGCGAGCGGCTGTCTCCACAAGT
rpp30_F_398_GTATCCGCCA	AATGATACGGCGACCACCGAGATCTACACGTATCCGCCAGAGCGGCTGTCTCCACAAGT
rpp30_F_399_CGGAGAAGGT	AATGATACGGCGACCACCGAGATCTACACCGGAGAAGGTGAGCGGCTGTCTCCACAAGT
rpp30_F_400_TGAACAATCG	AATGATACGGCGACCACCGAGATCTACACTGAACAATCGGAGCGGCTGTCTCCACAAGT
rpp30_F_401_GCGCAACCTA	AATGATACGGCGACCACCGAGATCTACACGCGCAACCTAGAGCGGCTGTCTCCACAAGT
rpp30_F_402_CGACGGCTTA	AATGATACGGCGACCACCGAGATCTACACCGACGGCTTAGAGCGGCTGTCTCCACAAGT
rpp30_F_403_ATGGCAAGAT	AATGATACGGCGACCACCGAGATCTACACATGGCAAGATGAGCGGCTGTCTCCACAAGT
rpp30_F_404_AACGGACGGA	AATGATACGGCGACCACCGAGATCTACACAACGGACGGAGAGCGGCTGTCTCCACAAGT
rpp30_F_405_GCTAATACCG	AATGATACGGCGACCACCGAGATCTACACGCTAATACCGGAGCGGCTGTCTCCACAAGT
rpp30_F_406_TGCGGACATT	AATGATACGGCGACCACCGAGATCTACACTGCGGACATTGAGCGGCTGTCTCCACAAGT
rpp30_F_407_ACCTAGATCA	AATGATACGGCGACCACCGAGATCTACACACCTAGATCAGAGCGGCTGTCTCCACAAGT
rpp30_F_408_GTAGGATGGT	AATGATACGGCGACCACCGAGATCTACACGTAGGATGGTGAGCGGCTGTCTCCACAAGT
rpp30_F_409_CAAGAGATCT	AATGATACGGCGACCACCGAGATCTACACCAAGAGATCTGAGCGGCTGTCTCCACAAGT
rpp30_F_410_ATCACTTGCG	AATGATACGGCGACCACCGAGATCTACACATCACTTGCGGAGCGGCTGTCTCCACAAGT
rpp30_F_411_GTTGGAGTAG	AATGATACGGCGACCACCGAGATCTACACGTTGGAGTAGGAGCGGCTGTCTCCACAAGT
rpp30_F_412_ACGTCGGATG	AATGATACGGCGACCACCGAGATCTACACACGTCGGATGGAGCGGCTGTCTCCACAAGT
rpp30_F_413_AGCGCTTCTT	AATGATACGGCGACCACCGAGATCTACACAGCGCTTCTTGAGCGGCTGTCTCCACAAGT
rpp30_F_414_AGCGCAGATA	AATGATACGGCGACCACCGAGATCTACACAGCGCAGATAGAGCGGCTGTCTCCACAAGT
rpp30_F_415_CATTCGGATG	AATGATACGGCGACCACCGAGATCTACACCATTCGGATGGAGCGGCTGTCTCCACAAGT
rpp30_F_416_CGAGAACGTG	AATGATACGGCGACCACCGAGATCTACACCGAGAACGTGGAGCGGCTGTCTCCACAAGT
rpp30_F_417_GTAGAGTAAG	AATGATACGGCGACCACCGAGATCTACACGTAGAGTAAGGAGCGGCTGTCTCCACAAGT
rpp30_F_418_GATCCATGGT	AATGATACGGCGACCACCGAGATCTACACGATCCATGGTGAGCGGCTGTCTCCACAAGT
rpp30_F_419_CGGAAGATAC	AATGATACGGCGACCACCGAGATCTACACCGGAAGATACGAGCGGCTGTCTCCACAAGT
rpp30_F_420_ATGGTGTCGA	AATGATACGGCGACCACCGAGATCTACACATGGTGTCGAGAGCGGCTGTCTCCACAAGT
rpp30_F_421_GCCTAATGCG	AATGATACGGCGACCACCGAGATCTACACGCCTAATGCGGAGCGGCTGTCTCCACAAGT
rpp30_F_422_GAGGTATGGA	AATGATACGGCGACCACCGAGATCTACACGAGGTATGGAGAGCGGCTGTCTCCACAAGT
rpp30_F_423_ATCGCGTACG	AATGATACGGCGACCACCGAGATCTACACATCGCGTACGGAGCGGCTGTCTCCACAAGT
rpp30_F_424_AACGGTCAAT	AATGATACGGCGACCACCGAGATCTACACAACGGTCAATGAGCGGCTGTCTCCACAAGT
rpp30_F_425_GGATCGAGTA	AATGATACGGCGACCACCGAGATCTACACGGATCGAGTAGAGCGGCTGTCTCCACAAGT
rpp30_F_426_AGGATCCGAA	AATGATACGGCGACCACCGAGATCTACACAGGATCCGAAGAGCGGCTGTCTCCACAAGT
rpp30_F_427_GATACTATCG	AATGATACGGCGACCACCGAGATCTACACGATACTATCGGAGCGGCTGTCTCCACAAGT
rpp30_F_428_GAGATCCGTC	AATGATACGGCGACCACCGAGATCTACACGAGATCCGTCGAGCGGCTGTCTCCACAAGT
rpp30_F_429_ACTCACAGGT	AATGATACGGCGACCACCGAGATCTACACACTCACAGGTGAGCGGCTGTCTCCACAAGT
rpp30_F_430_CTTCGGCACA	AATGATACGGCGACCACCGAGATCTACACCTTCGGCACAGAGCGGCTGTCTCCACAAGT
rpp30_F_431_ATCACGACCG	AATGATACGGCGACCACCGAGATCTACACATCACGACCGGAGCGGCTGTCTCCACAAGT
rpp30_F_432_TGAGCTTCCG	AATGATACGGCGACCACCGAGATCTACACTGAGCTTCCGGAGCGGCTGTCTCCACAAGT
rpp30_F_433_CTAGGTTCAT	AATGATACGGCGACCACCGAGATCTACACCTAGGTTCATGAGCGGCTGTCTCCACAAGT
rpp30_F_434_CAGTTCAGGT	AATGATACGGCGACCACCGAGATCTACACCAGTTCAGGTGAGCGGCTGTCTCCACAAGT
rpp30_F_435_GCGTATACAA	AATGATACGGCGACCACCGAGATCTACACGCGTATACAAGAGCGGCTGTCTCCACAAGT
rpp30_F_436_AGATGATCGG	AATGATACGGCGACCACCGAGATCTACACAGATGATCGGGAGCGGCTGTCTCCACAAGT
rpp30_F_437_GGCCTAAGAG	AATGATACGGCGACCACCGAGATCTACACGGCCTAAGAGGAGCGGCTGTCTCCACAAGT
rpp30_F_438_GGCAATTCCA	AATGATACGGCGACCACCGAGATCTACACGGCAATTCCAGAGCGGCTGTCTCCACAAGT
rpp30_F_439_CATTGAGTAG	AATGATACGGCGACCACCGAGATCTACACCATTGAGTAGGAGCGGCTGTCTCCACAAGT
rpp30_F_440_GAGCACTCTT	AATGATACGGCGACCACCGAGATCTACACGAGCACTCTTGAGCGGCTGTCTCCACAAGT
rpp30_F_441_CGACTATGGC	AATGATACGGCGACCACCGAGATCTACACCGACTATGGCGAGCGGCTGTCTCCACAAGT
rpp30_F_442_GGTAATGCGT	AATGATACGGCGACCACCGAGATCTACACGGTAATGCGTGAGCGGCTGTCTCCACAAGT
rpp30_F_443_ATCGTGATTC	AATGATACGGCGACCACCGAGATCTACACATCGTGATTCGAGCGGCTGTCTCCACAAGT
rpp30_F_444_CTGTGGCGAA	AATGATACGGCGACCACCGAGATCTACACCTGTGGCGAAGAGCGGCTGTCTCCACAAGT
rpp30_F_445_ACGGATTGGA	AATGATACGGCGACCACCGAGATCTACACACGGATTGGAGAGCGGCTGTCTCCACAAGT
rpp30_F_446_GGCAATACGG	AATGATACGGCGACCACCGAGATCTACACGGCAATACGGGAGCGGCTGTCTCCACAAGT
rpp30_F_447_CGTCAGTGGT	AATGATACGGCGACCACCGAGATCTACACCGTCAGTGGTGAGCGGCTGTCTCCACAAGT
rpp30_F_448_GCTGCTGGAT	AATGATACGGCGACCACCGAGATCTACACGCTGCTGGATGAGCGGCTGTCTCCACAAGT
rpp30_F_449_ACGGAACTAG	AATGATACGGCGACCACCGAGATCTACACACGGAACTAGGAGCGGCTGTCTCCACAAGT
rpp30_F_450_ACGGAGTATT	AATGATACGGCGACCACCGAGATCTACACACGGAGTATTGAGCGGCTGTCTCCACAAGT
rpp30_F_451_ACGGATAGAT	AATGATACGGCGACCACCGAGATCTACACACGGATAGATGAGCGGCTGTCTCCACAAGT
rpp30_F_452_CCGGAATCAT	AATGATACGGCGACCACCGAGATCTACACCCGGAATCATGAGCGGCTGTCTCCACAAGT
rpp30_F_453_CCGGATTCTA	AATGATACGGCGACCACCGAGATCTACACCCGGATTCTAGAGCGGCTGTCTCCACAAGT
rpp30_F_454_GCGGAACAGT	AATGATACGGCGACCACCGAGATCTACACGCGGAACAGTGAGCGGCTGTCTCCACAAGT
rpp30_F_455_CCTGCATCGA	AATGATACGGCGACCACCGAGATCTACACCCTGCATCGAGAGCGGCTGTCTCCACAAGT
rpp30_F_456_GGAACAGATT	AATGATACGGCGACCACCGAGATCTACACGGAACAGATTGAGCGGCTGTCTCCACAAGT
rpp30_F_457_GGAACTTCCT	AATGATACGGCGACCACCGAGATCTACACGGAACTTCCTGAGCGGCTGTCTCCACAAGT
rpp30_F_458_GGAAGAATGA	AATGATACGGCGACCACCGAGATCTACACGGAAGAATGAGAGCGGCTGTCTCCACAAGT
rpp30_F_459_GGAAGCCTTA	AATGATACGGCGACCACCGAGATCTACACGGAAGCCTTAGAGCGGCTGTCTCCACAAGT
rpp30_F_460_GGAAGTACAA	AATGATACGGCGACCACCGAGATCTACACGGAAGTACAAGAGCGGCTGTCTCCACAAGT
rpp30_F_461_GGAATGCAAG	AATGATACGGCGACCACCGAGATCTACACGGAATGCAAGGAGCGGCTGTCTCCACAAGT
rpp30_F_462_GGAGTTCTCA	AATGATACGGCGACCACCGAGATCTACACGGAGTTCTCAGAGCGGCTGTCTCCACAAGT
rpp30_F_463_GGATACCAGA	AATGATACGGCGACCACCGAGATCTACACGGATACCAGAGAGCGGCTGTCTCCACAAGT
rpp30_F_464_GGATGTGATT	AATGATACGGCGACCACCGAGATCTACACGGATGTGATTGAGCGGCTGTCTCCACAAGT
rpp30_F_465_ACTCGAGGTA	AATGATACGGCGACCACCGAGATCTACACACTCGAGGTAGAGCGGCTGTCTCCACAAGT
rpp30_F_466_CGGAACACGA	AATGATACGGCGACCACCGAGATCTACACCGGAACACGAGAGCGGCTGTCTCCACAAGT
rpp30_F_467_CGGAACTTAA	AATGATACGGCGACCACCGAGATCTACACCGGAACTTAAGAGCGGCTGTCTCCACAAGT
rpp30_F_468_CGGATACTCA	AATGATACGGCGACCACCGAGATCTACACCGGATACTCAGAGCGGCTGTCTCCACAAGT
rpp30_F_469_GACAACAACG	AATGATACGGCGACCACCGAGATCTACACGACAACAACGGAGCGGCTGTCTCCACAAGT
rpp30_F_470_AGGCCACATC	AATGATACGGCGACCACCGAGATCTACACAGGCCACATCGAGCGGCTGTCTCCACAAGT
rpp30_F_471_ACTATGTGAC	AATGATACGGCGACCACCGAGATCTACACACTATGTGACGAGCGGCTGTCTCCACAAGT
rpp30_F_472_AGGTAGGACG	AATGATACGGCGACCACCGAGATCTACACAGGTAGGACGGAGCGGCTGTCTCCACAAGT
rpp30_F_473_CAGTGGTTGT	AATGATACGGCGACCACCGAGATCTACACCAGTGGTTGTGAGCGGCTGTCTCCACAAGT
rpp30_F_474_GCGTTATCAG	AATGATACGGCGACCACCGAGATCTACACGCGTTATCAGGAGCGGCTGTCTCCACAAGT
rpp30_F_475_GATAGGCCTA	AATGATACGGCGACCACCGAGATCTACACGATAGGCCTAGAGCGGCTGTCTCCACAAGT
rpp30_F_476_CCGGTAACAA	AATGATACGGCGACCACCGAGATCTACACCCGGTAACAAGAGCGGCTGTCTCCACAAGT
rpp30_F_477_CGGAGTGTGT	AATGATACGGCGACCACCGAGATCTACACCGGAGTGTGTGAGCGGCTGTCTCCACAAGT
rpp30_F_478_AGACACCGGA	AATGATACGGCGACCACCGAGATCTACACAGACACCGGAGAGCGGCTGTCTCCACAAGT
rpp30_F_479_AAGATGTGAG	AATGATACGGCGACCACCGAGATCTACACAAGATGTGAGGAGCGGCTGTCTCCACAAGT
rpp30_F_480_CACGCGGATT	AATGATACGGCGACCACCGAGATCTACACCACGCGGATTGAGCGGCTGTCTCCACAAGT
rpp30_F_481_GGAACAACGG	AATGATACGGCGACCACCGAGATCTACACGGAACAACGGGAGCGGCTGTCTCCACAAGT
rpp30_F_482_CAGGCCATCA	AATGATACGGCGACCACCGAGATCTACACCAGGCCATCAGAGCGGCTGTCTCCACAAGT
rpp30_F_483_CTGCCTATAA	AATGATACGGCGACCACCGAGATCTACACCTGCCTATAAGAGCGGCTGTCTCCACAAGT
rpp30_F_484_AGCTATGTGG	AATGATACGGCGACCACCGAGATCTACACAGCTATGTGGGAGCGGCTGTCTCCACAAGT
rpp30_F_485_ACACTGTGGT	AATGATACGGCGACCACCGAGATCTACACACACTGTGGTGAGCGGCTGTCTCCACAAGT
rpp30_F_486_GTCACAAGCG	AATGATACGGCGACCACCGAGATCTACACGTCACAAGCGGAGCGGCTGTCTCCACAAGT
rpp30_F_487_CTACGACTTG	AATGATACGGCGACCACCGAGATCTACACCTACGACTTGGAGCGGCTGTCTCCACAAGT
rpp30_F_488_TGGTTGAGTA	AATGATACGGCGACCACCGAGATCTACACTGGTTGAGTAGAGCGGCTGTCTCCACAAGT
rpp30_F_489_TGGAGGATCG	AATGATACGGCGACCACCGAGATCTACACTGGAGGATCGGAGCGGCTGTCTCCACAAGT
rpp30_F_490_TCAGTTGCCA	AATGATACGGCGACCACCGAGATCTACACTCAGTTGCCAGAGCGGCTGTCTCCACAAGT
rpp30_F_491_CCAGGAGTGT	AATGATACGGCGACCACCGAGATCTACACCCAGGAGTGTGAGCGGCTGTCTCCACAAGT
rpp30_F_492_ACATGGCCAA	AATGATACGGCGACCACCGAGATCTACACACATGGCCAAGAGCGGCTGTCTCCACAAGT
rpp30_F_493_GCGTTGCGAA	AATGATACGGCGACCACCGAGATCTACACGCGTTGCGAAGAGCGGCTGTCTCCACAAGT
rpp30_F_494_AAGGTTACCG	AATGATACGGCGACCACCGAGATCTACACAAGGTTACCGGAGCGGCTGTCTCCACAAGT
rpp30_F_495_ATACGGACAT	AATGATACGGCGACCACCGAGATCTACACATACGGACATGAGCGGCTGTCTCCACAAGT
rpp30_F_496_AGTGGCGAAG	AATGATACGGCGACCACCGAGATCTACACAGTGGCGAAGGAGCGGCTGTCTCCACAAGT
rpp30_F_497_GCGGTAATCA	AATGATACGGCGACCACCGAGATCTACACGCGGTAATCAGAGCGGCTGTCTCCACAAGT
rpp30_F_498_CAGACTGAGA	AATGATACGGCGACCACCGAGATCTACACCAGACTGAGAGAGCGGCTGTCTCCACAAGT
rpp30_F_499_TCTTGTTCCG	AATGATACGGCGACCACCGAGATCTACACTCTTGTTCCGGAGCGGCTGTCTCCACAAGT
rpp30_F_500_ACCAAGCTGG	AATGATACGGCGACCACCGAGATCTACACACCAAGCTGGGAGCGGCTGTCTCCACAAGT
rpp30_F_501_GGTTAGGAAT	AATGATACGGCGACCACCGAGATCTACACGGTTAGGAATGAGCGGCTGTCTCCACAAGT
rpp30_F_502_AAGTCGGTAG	AATGATACGGCGACCACCGAGATCTACACAAGTCGGTAGGAGCGGCTGTCTCCACAAGT
rpp30_F_503_CACGACTGTA	AATGATACGGCGACCACCGAGATCTACACCACGACTGTAGAGCGGCTGTCTCCACAAGT
rpp30_F_504_TCGATCCAGT	AATGATACGGCGACCACCGAGATCTACACTCGATCCAGTGAGCGGCTGTCTCCACAAGT
rpp30_F_505_GGACGAATTG	AATGATACGGCGACCACCGAGATCTACACGGACGAATTGGAGCGGCTGTCTCCACAAGT
rpp30_F_506_CGGACTAGAA	AATGATACGGCGACCACCGAGATCTACACCGGACTAGAAGAGCGGCTGTCTCCACAAGT
rpp30_F_507_GAAGCTTGTA	AATGATACGGCGACCACCGAGATCTACACGAAGCTTGTAGAGCGGCTGTCTCCACAAGT
rpp30_F_508_CAATACGGAA	AATGATACGGCGACCACCGAGATCTACACCAATACGGAAGAGCGGCTGTCTCCACAAGT
rpp30_F_509_GAACGAGAGA	AATGATACGGCGACCACCGAGATCTACACGAACGAGAGAGAGCGGCTGTCTCCACAAGT
rpp30_F_510_GACTTCGACG	AATGATACGGCGACCACCGAGATCTACACGACTTCGACGGAGCGGCTGTCTCCACAAGT
rpp30_F_511_GTACACTGGA	AATGATACGGCGACCACCGAGATCTACACGTACACTGGAGAGCGGCTGTCTCCACAAGT
rpp30_F_512_GTCGAGGATG	AATGATACGGCGACCACCGAGATCTACACGTCGAGGATGGAGCGGCTGTCTCCACAAGT
rpp30_F_513_CTCATGCTAT	AATGATACGGCGACCACCGAGATCTACACCTCATGCTATGAGCGGCTGTCTCCACAAGT
rpp30_F_514_CCTTGCGGAA	AATGATACGGCGACCACCGAGATCTACACCCTTGCGGAAGAGCGGCTGTCTCCACAAGT
rpp30_F_515_TGGAAGCACG	AATGATACGGCGACCACCGAGATCTACACTGGAAGCACGGAGCGGCTGTCTCCACAAGT
rpp30_F_516_AGCGTCCAAG	AATGATACGGCGACCACCGAGATCTACACAGCGTCCAAGGAGCGGCTGTCTCCACAAGT
rpp30_F_517_GCCATCTACG	AATGATACGGCGACCACCGAGATCTACACGCCATCTACGGAGCGGCTGTCTCCACAAGT
rpp30_F_518_GGAAGCTACT	AATGATACGGCGACCACCGAGATCTACACGGAAGCTACTGAGCGGCTGTCTCCACAAGT
rpp30_F_519_GGTTGACTAA	AATGATACGGCGACCACCGAGATCTACACGGTTGACTAAGAGCGGCTGTCTCCACAAGT
rpp30_F_520_TGCCACCGTA	AATGATACGGCGACCACCGAGATCTACACTGCCACCGTAGAGCGGCTGTCTCCACAAGT
rpp30_F_521_GATTATGTCG	AATGATACGGCGACCACCGAGATCTACACGATTATGTCGGAGCGGCTGTCTCCACAAGT
rpp30_F_522_ACCACTGTGA	AATGATACGGCGACCACCGAGATCTACACACCACTGTGAGAGCGGCTGTCTCCACAAGT
rpp30_F_523_GTTGCCTGGA	AATGATACGGCGACCACCGAGATCTACACGTTGCCTGGAGAGCGGCTGTCTCCACAAGT
rpp30_F_524_CGGTTCAAGG	AATGATACGGCGACCACCGAGATCTACACCGGTTCAAGGGAGCGGCTGTCTCCACAAGT
rpp30_F_525_GACTACCGTC	AATGATACGGCGACCACCGAGATCTACACGACTACCGTCGAGCGGCTGTCTCCACAAGT
rpp30_F_526_ATCTCTAGGT	AATGATACGGCGACCACCGAGATCTACACATCTCTAGGTGAGCGGCTGTCTCCACAAGT
rpp30_F_527_GCGAGTCACT	AATGATACGGCGACCACCGAGATCTACACGCGAGTCACTGAGCGGCTGTCTCCACAAGT
rpp30_F_528_CGAGGAGATT	AATGATACGGCGACCACCGAGATCTACACCGAGGAGATTGAGCGGCTGTCTCCACAAGT
rpp30_F_529_GCGAAGACTT	AATGATACGGCGACCACCGAGATCTACACGCGAAGACTTGAGCGGCTGTCTCCACAAGT
rpp30_F_530_ACGTGGTGAT	AATGATACGGCGACCACCGAGATCTACACACGTGGTGATGAGCGGCTGTCTCCACAAGT
rpp30_F_531_GTGATCTGGA	AATGATACGGCGACCACCGAGATCTACACGTGATCTGGAGAGCGGCTGTCTCCACAAGT
rpp30_F_532_CACCTACGTC	AATGATACGGCGACCACCGAGATCTACACCACCTACGTCGAGCGGCTGTCTCCACAAGT
rpp30_F_533_CTGGTCCGAA	AATGATACGGCGACCACCGAGATCTACACCTGGTCCGAAGAGCGGCTGTCTCCACAAGT
rpp30_F_534_TCACGGTAGG	AATGATACGGCGACCACCGAGATCTACACTCACGGTAGGGAGCGGCTGTCTCCACAAGT
rpp30_F_535_AAGCCTTGAA	AATGATACGGCGACCACCGAGATCTACACAAGCCTTGAAGAGCGGCTGTCTCCACAAGT
rpp30_F_536_GACGCATCTG	AATGATACGGCGACCACCGAGATCTACACGACGCATCTGGAGCGGCTGTCTCCACAAGT
rpp30_F_537_CACGTAGACT	AATGATACGGCGACCACCGAGATCTACACCACGTAGACTGAGCGGCTGTCTCCACAAGT
rpp30_F_538_CACGCAACTT	AATGATACGGCGACCACCGAGATCTACACCACGCAACTTGAGCGGCTGTCTCCACAAGT
rpp30_F_539_ACGTCCTAGA	AATGATACGGCGACCACCGAGATCTACACACGTCCTAGAGAGCGGCTGTCTCCACAAGT
rpp30_F_540_ACGCCTTACG	AATGATACGGCGACCACCGAGATCTACACACGCCTTACGGAGCGGCTGTCTCCACAAGT
rpp30_F_541_ACAATCTGTC	AATGATACGGCGACCACCGAGATCTACACACAATCTGTCGAGCGGCTGTCTCCACAAGT
rpp30_F_542_TAAGAATCGG	AATGATACGGCGACCACCGAGATCTACACTAAGAATCGGGAGCGGCTGTCTCCACAAGT
rpp30_F_543_AATAAGGTGG	AATGATACGGCGACCACCGAGATCTACACAATAAGGTGGGAGCGGCTGTCTCCACAAGT
rpp30_F_544_CAACCTCAGT	AATGATACGGCGACCACCGAGATCTACACCAACCTCAGTGAGCGGCTGTCTCCACAAGT
rpp30_F_545_GAAGATCAGA	AATGATACGGCGACCACCGAGATCTACACGAAGATCAGAGAGCGGCTGTCTCCACAAGT
rpp30_F_546_ATCCAAGGCG	AATGATACGGCGACCACCGAGATCTACACATCCAAGGCGGAGCGGCTGTCTCCACAAGT
rpp30_F_547_CAGATACTTG	AATGATACGGCGACCACCGAGATCTACACCAGATACTTGGAGCGGCTGTCTCCACAAGT
rpp30_F_548_ACGTAAGGAC	AATGATACGGCGACCACCGAGATCTACACACGTAAGGACGAGCGGCTGTCTCCACAAGT
rpp30_F_549_CGTATACTGT	AATGATACGGCGACCACCGAGATCTACACCGTATACTGTGAGCGGCTGTCTCCACAAGT
rpp30_F_550_GGAACACTCT	AATGATACGGCGACCACCGAGATCTACACGGAACACTCTGAGCGGCTGTCTCCACAAGT
rpp30_F_551_GTACAAGGTA	AATGATACGGCGACCACCGAGATCTACACGTACAAGGTAGAGCGGCTGTCTCCACAAGT
rpp30_F_552_GAATTAGCCG	AATGATACGGCGACCACCGAGATCTACACGAATTAGCCGGAGCGGCTGTCTCCACAAGT
rpp30_F_553_GTATTCCGGA	AATGATACGGCGACCACCGAGATCTACACGTATTCCGGAGAGCGGCTGTCTCCACAAGT
rpp30_F_554_AACGAAGTCG	AATGATACGGCGACCACCGAGATCTACACAACGAAGTCGGAGCGGCTGTCTCCACAAGT
rpp30_F_555_GTTAGCTTCG	AATGATACGGCGACCACCGAGATCTACACGTTAGCTTCGGAGCGGCTGTCTCCACAAGT
rpp30_F_556_TACACTCACG	AATGATACGGCGACCACCGAGATCTACACTACACTCACGGAGCGGCTGTCTCCACAAGT
rpp30_F_557_TACCTGCGTG	AATGATACGGCGACCACCGAGATCTACACTACCTGCGTGGAGCGGCTGTCTCCACAAGT
rpp30_F_558_TGGAGTACGG	AATGATACGGCGACCACCGAGATCTACACTGGAGTACGGGAGCGGCTGTCTCCACAAGT
rpp30_F_559_ACGCACTCAT	AATGATACGGCGACCACCGAGATCTACACACGCACTCATGAGCGGCTGTCTCCACAAGT
rpp30_F_560_ATCGTACGCT	AATGATACGGCGACCACCGAGATCTACACATCGTACGCTGAGCGGCTGTCTCCACAAGT
rpp30_F_561_GCATAAGGTT	AATGATACGGCGACCACCGAGATCTACACGCATAAGGTTGAGCGGCTGTCTCCACAAGT
rpp30_F_562_CGTGAGATAA	AATGATACGGCGACCACCGAGATCTACACCGTGAGATAAGAGCGGCTGTCTCCACAAGT
rpp30_F_563_ACAGACCGTG	AATGATACGGCGACCACCGAGATCTACACACAGACCGTGGAGCGGCTGTCTCCACAAGT
rpp30_F_564_GACCGTTAGG	AATGATACGGCGACCACCGAGATCTACACGACCGTTAGGGAGCGGCTGTCTCCACAAGT
rpp30_F_565_GGTACATCCA	AATGATACGGCGACCACCGAGATCTACACGGTACATCCAGAGCGGCTGTCTCCACAAGT
rpp30_F_566_CGTCGTACAT	AATGATACGGCGACCACCGAGATCTACACCGTCGTACATGAGCGGCTGTCTCCACAAGT
rpp30_F_567_AGTAGCCTAT	AATGATACGGCGACCACCGAGATCTACACAGTAGCCTATGAGCGGCTGTCTCCACAAGT
rpp30_F_568_CTACCGGATG	AATGATACGGCGACCACCGAGATCTACACCTACCGGATGGAGCGGCTGTCTCCACAAGT
rpp30_F_569_CTAGGCGAGA	AATGATACGGCGACCACCGAGATCTACACCTAGGCGAGAGAGCGGCTGTCTCCACAAGT
rpp30_F_570_TTAAGTCACG	AATGATACGGCGACCACCGAGATCTACACTTAAGTCACGGAGCGGCTGTCTCCACAAGT
rpp30_F_571_CGGATAGTTC	AATGATACGGCGACCACCGAGATCTACACCGGATAGTTCGAGCGGCTGTCTCCACAAGT
rpp30_F_572_CCATCAGCTG	AATGATACGGCGACCACCGAGATCTACACCCATCAGCTGGAGCGGCTGTCTCCACAAGT
rpp30_F_573_AGGCGGAGAT	AATGATACGGCGACCACCGAGATCTACACAGGCGGAGATGAGCGGCTGTCTCCACAAGT
rpp30_F_574_CAGACATCCT	AATGATACGGCGACCACCGAGATCTACACCAGACATCCTGAGCGGCTGTCTCCACAAGT
rpp30_F_575_ACGTAGAATC	AATGATACGGCGACCACCGAGATCTACACACGTAGAATCGAGCGGCTGTCTCCACAAGT
rpp30_F_576_GGCTAGACTG	AATGATACGGCGACCACCGAGATCTACACGGCTAGACTGGAGCGGCTGTCTCCACAAGT
rpp30_F_577_CAAGAGTAGA	AATGATACGGCGACCACCGAGATCTACACCAAGAGTAGAGAGCGGCTGTCTCCACAAGT
rpp30_F_578_GACAGGTCAA	AATGATACGGCGACCACCGAGATCTACACGACAGGTCAAGAGCGGCTGTCTCCACAAGT
rpp30_F_579_AATCCGATGG	AATGATACGGCGACCACCGAGATCTACACAATCCGATGGGAGCGGCTGTCTCCACAAGT
rpp30_F_580_TTACCTATCG	AATGATACGGCGACCACCGAGATCTACACTTACCTATCGGAGCGGCTGTCTCCACAAGT
rpp30_F_581_GACGTGATCA	AATGATACGGCGACCACCGAGATCTACACGACGTGATCAGAGCGGCTGTCTCCACAAGT
rpp30_F_582_GGTAATGATG	AATGATACGGCGACCACCGAGATCTACACGGTAATGATGGAGCGGCTGTCTCCACAAGT
rpp30_F_583_GCTTCGAGAA	AATGATACGGCGACCACCGAGATCTACACGCTTCGAGAAGAGCGGCTGTCTCCACAAGT
rpp30_F_584_GGAACCAGGT	AATGATACGGCGACCACCGAGATCTACACGGAACCAGGTGAGCGGCTGTCTCCACAAGT
rpp30_F_585_ACGATTCGAC	AATGATACGGCGACCACCGAGATCTACACACGATTCGACGAGCGGCTGTCTCCACAAGT
rpp30_F_586_GACATTGTGG	AATGATACGGCGACCACCGAGATCTACACGACATTGTGGGAGCGGCTGTCTCCACAAGT
rpp30_F_587_AGCAACCTTA	AATGATACGGCGACCACCGAGATCTACACAGCAACCTTAGAGCGGCTGTCTCCACAAGT
rpp30_F_588_TGATAGGTCT	AATGATACGGCGACCACCGAGATCTACACTGATAGGTCTGAGCGGCTGTCTCCACAAGT
rpp30_F_589_AACGTCATGT	AATGATACGGCGACCACCGAGATCTACACAACGTCATGTGAGCGGCTGTCTCCACAAGT
rpp30_F_590_CGTTGGTAGG	AATGATACGGCGACCACCGAGATCTACACCGTTGGTAGGGAGCGGCTGTCTCCACAAGT
rpp30_F_591_GTGGAATAGG	AATGATACGGCGACCACCGAGATCTACACGTGGAATAGGGAGCGGCTGTCTCCACAAGT
rpp30_F_592_GTTGATGTTG	AATGATACGGCGACCACCGAGATCTACACGTTGATGTTGGAGCGGCTGTCTCCACAAGT
rpp30_F_593_TATGAGATCG	AATGATACGGCGACCACCGAGATCTACACTATGAGATCGGAGCGGCTGTCTCCACAAGT
rpp30_F_594_CTAACATACG	AATGATACGGCGACCACCGAGATCTACACCTAACATACGGAGCGGCTGTCTCCACAAGT
rpp30_F_595_AACATCGGTT	AATGATACGGCGACCACCGAGATCTACACAACATCGGTTGAGCGGCTGTCTCCACAAGT
rpp30_F_596_GCATGGTTAT	AATGATACGGCGACCACCGAGATCTACACGCATGGTTATGAGCGGCTGTCTCCACAAGT
rpp30_F_597_GATAAGTGCG	AATGATACGGCGACCACCGAGATCTACACGATAAGTGCGGAGCGGCTGTCTCCACAAGT
rpp30_F_598_AATCGCGTAA	AATGATACGGCGACCACCGAGATCTACACAATCGCGTAAGAGCGGCTGTCTCCACAAGT
rpp30_F_599_AATGTTCGTC	AATGATACGGCGACCACCGAGATCTACACAATGTTCGTCGAGCGGCTGTCTCCACAAGT
rpp30_F_600_GGTACTTCAG	AATGATACGGCGACCACCGAGATCTACACGGTACTTCAGGAGCGGCTGTCTCCACAAGT
rpp30_F_601_GGAGCTCAAG	AATGATACGGCGACCACCGAGATCTACACGGAGCTCAAGGAGCGGCTGTCTCCACAAGT
rpp30_F_602_TCCTCAGTCT	AATGATACGGCGACCACCGAGATCTACACTCCTCAGTCTGAGCGGCTGTCTCCACAAGT
rpp30_F_603_GAGAGTAGAA	AATGATACGGCGACCACCGAGATCTACACGAGAGTAGAAGAGCGGCTGTCTCCACAAGT
rpp30_F_604_GGAATATCCG	AATGATACGGCGACCACCGAGATCTACACGGAATATCCGGAGCGGCTGTCTCCACAAGT
rpp30_F_605_ACGCGCATCA	AATGATACGGCGACCACCGAGATCTACACACGCGCATCAGAGCGGCTGTCTCCACAAGT
rpp30_F_606_GGCTCTAAGT	AATGATACGGCGACCACCGAGATCTACACGGCTCTAAGTGAGCGGCTGTCTCCACAAGT
rpp30_F_607_ACCAACCGTT	AATGATACGGCGACCACCGAGATCTACACACCAACCGTTGAGCGGCTGTCTCCACAAGT
rpp30_F_608_ACATCACGTC	AATGATACGGCGACCACCGAGATCTACACACATCACGTCGAGCGGCTGTCTCCACAAGT
rpp30_F_609_AATCCTGGAC	AATGATACGGCGACCACCGAGATCTACACAATCCTGGACGAGCGGCTGTCTCCACAAGT
rpp30_F_610_AATGCGGCTA	AATGATACGGCGACCACCGAGATCTACACAATGCGGCTAGAGCGGCTGTCTCCACAAGT
rpp30_F_611_AATGTCTGGC	AATGATACGGCGACCACCGAGATCTACACAATGTCTGGCGAGCGGCTGTCTCCACAAGT
rpp30_F_612_ACACGTCATC	AATGATACGGCGACCACCGAGATCTACACACACGTCATCGAGCGGCTGTCTCCACAAGT
rpp30_F_613_ACACTCGCGT	AATGATACGGCGACCACCGAGATCTACACACACTCGCGTGAGCGGCTGTCTCCACAAGT
rpp30_F_614_ACCATGCATC	AATGATACGGCGACCACCGAGATCTACACACCATGCATCGAGCGGCTGTCTCCACAAGT
rpp30_F_615_ACCGTACAGT	AATGATACGGCGACCACCGAGATCTACACACCGTACAGTGAGCGGCTGTCTCCACAAGT
rpp30_F_616_ACGATCTAGC	AATGATACGGCGACCACCGAGATCTACACACGATCTAGCGAGCGGCTGTCTCCACAAGT
rpp30_F_617_ACGGTCCTAT	AATGATACGGCGACCACCGAGATCTACACACGGTCCTATGAGCGGCTGTCTCCACAAGT
rpp30_F_618_ACTTAGCGTC	AATGATACGGCGACCACCGAGATCTACACACTTAGCGTCGAGCGGCTGTCTCCACAAGT
rpp30_F_619_AGGTTCTAAC	AATGATACGGCGACCACCGAGATCTACACAGGTTCTAACGAGCGGCTGTCTCCACAAGT
rpp30_F_620_ATATAGGCCT	AATGATACGGCGACCACCGAGATCTACACATATAGGCCTGAGCGGCTGTCTCCACAAGT
rpp30_F_621_ATGATTCGCG	AATGATACGGCGACCACCGAGATCTACACATGATTCGCGGAGCGGCTGTCTCCACAAGT
rpp30_F_622_ATGCTAGAGA	AATGATACGGCGACCACCGAGATCTACACATGCTAGAGAGAGCGGCTGTCTCCACAAGT
rpp30_F_623_CACGACATGC	AATGATACGGCGACCACCGAGATCTACACCACGACATGCGAGCGGCTGTCTCCACAAGT
rpp30_F_624_CACGGTAATT	AATGATACGGCGACCACCGAGATCTACACCACGGTAATTGAGCGGCTGTCTCCACAAGT
rpp30_F_625_CAGAACCACG	AATGATACGGCGACCACCGAGATCTACACCAGAACCACGGAGCGGCTGTCTCCACAAGT
rpp30_F_626_CCACAACGTC	AATGATACGGCGACCACCGAGATCTACACCCACAACGTCGAGCGGCTGTCTCCACAAGT
rpp30_F_627_CCACAATAGA	AATGATACGGCGACCACCGAGATCTACACCCACAATAGAGAGCGGCTGTCTCCACAAGT
rpp30_F_628_CCGAGTCGAT	AATGATACGGCGACCACCGAGATCTACACCCGAGTCGATGAGCGGCTGTCTCCACAAGT
rpp30_F_629_CCGCGACTAA	AATGATACGGCGACCACCGAGATCTACACCCGCGACTAAGAGCGGCTGTCTCCACAAGT
rpp30_F_630_CCGGACCAAT	AATGATACGGCGACCACCGAGATCTACACCCGGACCAATGAGCGGCTGTCTCCACAAGT
rpp30_F_631_CCGTATAGAC	AATGATACGGCGACCACCGAGATCTACACCCGTATAGACGAGCGGCTGTCTCCACAAGT
rpp30_F_632_CCTAGCGTGA	AATGATACGGCGACCACCGAGATCTACACCCTAGCGTGAGAGCGGCTGTCTCCACAAGT
rpp30_F_633_CGATGTGAGA	AATGATACGGCGACCACCGAGATCTACACCGATGTGAGAGAGCGGCTGTCTCCACAAGT
rpp30_F_634_CGCAGTCAGT	AATGATACGGCGACCACCGAGATCTACACCGCAGTCAGTGAGCGGCTGTCTCCACAAGT
rpp30_F_635_CGGAAGTGAG	AATGATACGGCGACCACCGAGATCTACACCGGAAGTGAGGAGCGGCTGTCTCCACAAGT
rpp30_F_636_CGGACCATGT	AATGATACGGCGACCACCGAGATCTACACCGGACCATGTGAGCGGCTGTCTCCACAAGT
rpp30_F_637_CGTAACAGTT	AATGATACGGCGACCACCGAGATCTACACCGTAACAGTTGAGCGGCTGTCTCCACAAGT
rpp30_F_638_CGTAGAACTT	AATGATACGGCGACCACCGAGATCTACACCGTAGAACTTGAGCGGCTGTCTCCACAAGT
rpp30_F_639_CTCTGCGGTT	AATGATACGGCGACCACCGAGATCTACACCTCTGCGGTTGAGCGGCTGTCTCCACAAGT
rpp30_F_640_CTGTAGATGG	AATGATACGGCGACCACCGAGATCTACACCTGTAGATGGGAGCGGCTGTCTCCACAAGT
rpp30_F_641_CTGTTAAGCG	AATGATACGGCGACCACCGAGATCTACACCTGTTAAGCGGAGCGGCTGTCTCCACAAGT
rpp30_F_642_CTTACTGGCG	AATGATACGGCGACCACCGAGATCTACACCTTACTGGCGGAGCGGCTGTCTCCACAAGT
rpp30_F_643_GAACGTACGT	AATGATACGGCGACCACCGAGATCTACACGAACGTACGTGAGCGGCTGTCTCCACAAGT
rpp30_F_644_GAACTCGAGG	AATGATACGGCGACCACCGAGATCTACACGAACTCGAGGGAGCGGCTGTCTCCACAAGT
rpp30_F_645_GAAGATATCC	AATGATACGGCGACCACCGAGATCTACACGAAGATATCCGAGCGGCTGTCTCCACAAGT
rpp30_F_646_GAAGTTGATG	AATGATACGGCGACCACCGAGATCTACACGAAGTTGATGGAGCGGCTGTCTCCACAAGT
rpp30_F_647_GACGATGGAT	AATGATACGGCGACCACCGAGATCTACACGACGATGGATGAGCGGCTGTCTCCACAAGT
rpp30_F_648_GACTCGTCAG	AATGATACGGCGACCACCGAGATCTACACGACTCGTCAGGAGCGGCTGTCTCCACAAGT
rpp30_F_649_GACTGATAGA	AATGATACGGCGACCACCGAGATCTACACGACTGATAGAGAGCGGCTGTCTCCACAAGT
rpp30_F_650_GAGACCTCTG	AATGATACGGCGACCACCGAGATCTACACGAGACCTCTGGAGCGGCTGTCTCCACAAGT
rpp30_F_651_GAGGCGGTAA	AATGATACGGCGACCACCGAGATCTACACGAGGCGGTAAGAGCGGCTGTCTCCACAAGT
rpp30_F_652_GAGGTCAATG	AATGATACGGCGACCACCGAGATCTACACGAGGTCAATGGAGCGGCTGTCTCCACAAGT
rpp30_F_653_GATGAACACG	AATGATACGGCGACCACCGAGATCTACACGATGAACACGGAGCGGCTGTCTCCACAAGT
rpp30_F_654_GATGAAGCGG	AATGATACGGCGACCACCGAGATCTACACGATGAAGCGGGAGCGGCTGTCTCCACAAGT
rpp30_F_655_GCAAGACGGA	AATGATACGGCGACCACCGAGATCTACACGCAAGACGGAGAGCGGCTGTCTCCACAAGT
rpp30_F_656_GCATTGGTGT	AATGATACGGCGACCACCGAGATCTACACGCATTGGTGTGAGCGGCTGTCTCCACAAGT
rpp30_F_657_GCCAGATATG	AATGATACGGCGACCACCGAGATCTACACGCCAGATATGGAGCGGCTGTCTCCACAAGT
rpp30_F_658_GCGAAGAGAG	AATGATACGGCGACCACCGAGATCTACACGCGAAGAGAGGAGCGGCTGTCTCCACAAGT
rpp30_F_659_GCGGTTAACT	AATGATACGGCGACCACCGAGATCTACACGCGGTTAACTGAGCGGCTGTCTCCACAAGT
rpp30_F_660_GCGTCACCAA	AATGATACGGCGACCACCGAGATCTACACGCGTCACCAAGAGCGGCTGTCTCCACAAGT
rpp30_F_661_GCGTCACGTT	AATGATACGGCGACCACCGAGATCTACACGCGTCACGTTGAGCGGCTGTCTCCACAAGT
rpp30_F_662_GCTTGTCATG	AATGATACGGCGACCACCGAGATCTACACGCTTGTCATGGAGCGGCTGTCTCCACAAGT
rpp30_F_663_GGACACTACG	AATGATACGGCGACCACCGAGATCTACACGGACACTACGGAGCGGCTGTCTCCACAAGT
rpp30_F_664_GGACCATACA	AATGATACGGCGACCACCGAGATCTACACGGACCATACAGAGCGGCTGTCTCCACAAGT
rpp30_F_665_GGACCTTGAA	AATGATACGGCGACCACCGAGATCTACACGGACCTTGAAGAGCGGCTGTCTCCACAAGT
rpp30_F_666_GGACGTAGGA	AATGATACGGCGACCACCGAGATCTACACGGACGTAGGAGAGCGGCTGTCTCCACAAGT
rpp30_F_667_GGACTGACGT	AATGATACGGCGACCACCGAGATCTACACGGACTGACGTGAGCGGCTGTCTCCACAAGT
rpp30_F_668_GGAGAGTTAT	AATGATACGGCGACCACCGAGATCTACACGGAGAGTTATGAGCGGCTGTCTCCACAAGT
rpp30_F_669_GGAGCACGTA	AATGATACGGCGACCACCGAGATCTACACGGAGCACGTAGAGCGGCTGTCTCCACAAGT
rpp30_F_670_GGCAACAGTA	AATGATACGGCGACCACCGAGATCTACACGGCAACAGTAGAGCGGCTGTCTCCACAAGT
rpp30_F_671_GGCTTCTTGG	AATGATACGGCGACCACCGAGATCTACACGGCTTCTTGGGAGCGGCTGTCTCCACAAGT
rpp30_F_672_GGTAGTATTG	AATGATACGGCGACCACCGAGATCTACACGGTAGTATTGGAGCGGCTGTCTCCACAAGT
rpp30_F_673_GGTATTCACT	AATGATACGGCGACCACCGAGATCTACACGGTATTCACTGAGCGGCTGTCTCCACAAGT
rpp30_F_674_GTACTGCGTA	AATGATACGGCGACCACCGAGATCTACACGTACTGCGTAGAGCGGCTGTCTCCACAAGT
rpp30_F_675_GTCAGTTGGA	AATGATACGGCGACCACCGAGATCTACACGTCAGTTGGAGAGCGGCTGTCTCCACAAGT
rpp30_F_676_GTCATCTCTT	AATGATACGGCGACCACCGAGATCTACACGTCATCTCTTGAGCGGCTGTCTCCACAAGT
rpp30_F_677_GTCTTAACGG	AATGATACGGCGACCACCGAGATCTACACGTCTTAACGGGAGCGGCTGTCTCCACAAGT
rpp30_F_678_GTGCCTACCT	AATGATACGGCGACCACCGAGATCTACACGTGCCTACCTGAGCGGCTGTCTCCACAAGT
rpp30_F_679_GTGGCATCCA	AATGATACGGCGACCACCGAGATCTACACGTGGCATCCAGAGCGGCTGTCTCCACAAGT
rpp30_F_680_GTGGCCTTAG	AATGATACGGCGACCACCGAGATCTACACGTGGCCTTAGGAGCGGCTGTCTCCACAAGT
rpp30_F_681_GTTCTCAGTT	AATGATACGGCGACCACCGAGATCTACACGTTCTCAGTTGAGCGGCTGTCTCCACAAGT
rpp30_F_682_TATGGCCACA	AATGATACGGCGACCACCGAGATCTACACTATGGCCACAGAGCGGCTGTCTCCACAAGT
rpp30_F_683_TCCACAGTGG	AATGATACGGCGACCACCGAGATCTACACTCCACAGTGGGAGCGGCTGTCTCCACAAGT
rpp30_F_684_TCCATTAACG	AATGATACGGCGACCACCGAGATCTACACTCCATTAACGGAGCGGCTGTCTCCACAAGT
rpp30_F_685_TCCTGATAAG	AATGATACGGCGACCACCGAGATCTACACTCCTGATAAGGAGCGGCTGTCTCCACAAGT
rpp30_F_686_TGCAAGATTG	AATGATACGGCGACCACCGAGATCTACACTGCAAGATTGGAGCGGCTGTCTCCACAAGT
rpp30_F_687_TGCGAATCGA	AATGATACGGCGACCACCGAGATCTACACTGCGAATCGAGAGCGGCTGTCTCCACAAGT
rpp30_F_688_TGCTGTCCGA	AATGATACGGCGACCACCGAGATCTACACTGCTGTCCGAGAGCGGCTGTCTCCACAAGT
rpp30_F_689_GGCAACCTGT	AATGATACGGCGACCACCGAGATCTACACGGCAACCTGTGAGCGGCTGTCTCCACAAGT
rpp30_F_690_CTTGGAGTGA	AATGATACGGCGACCACCGAGATCTACACCTTGGAGTGAGAGCGGCTGTCTCCACAAGT
rpp30_F_691_CATGTGGTAT	AATGATACGGCGACCACCGAGATCTACACCATGTGGTATGAGCGGCTGTCTCCACAAGT
rpp30_F_692_TAGAGACACG	AATGATACGGCGACCACCGAGATCTACACTAGAGACACGGAGCGGCTGTCTCCACAAGT
rpp30_F_693_CTCACATAGT	AATGATACGGCGACCACCGAGATCTACACCTCACATAGTGAGCGGCTGTCTCCACAAGT
rpp30_F_694_ACAGTCGAGG	AATGATACGGCGACCACCGAGATCTACACACAGTCGAGGGAGCGGCTGTCTCCACAAGT
rpp30_F_695_TAGTGGCTGG	AATGATACGGCGACCACCGAGATCTACACTAGTGGCTGGGAGCGGCTGTCTCCACAAGT
rpp30_F_696_AAGCTACAGT	AATGATACGGCGACCACCGAGATCTACACAAGCTACAGTGAGCGGCTGTCTCCACAAGT
rpp30_F_697_AGAACGGCAT	AATGATACGGCGACCACCGAGATCTACACAGAACGGCATGAGCGGCTGTCTCCACAAGT
rpp30_F_698_GAACCTTGGC	AATGATACGGCGACCACCGAGATCTACACGAACCTTGGCGAGCGGCTGTCTCCACAAGT
rpp30_F_699_CGATAGAGTC	AATGATACGGCGACCACCGAGATCTACACCGATAGAGTCGAGCGGCTGTCTCCACAAGT
rpp30_F_700_GACGTTGTAA	AATGATACGGCGACCACCGAGATCTACACGACGTTGTAAGAGCGGCTGTCTCCACAAGT
rpp30_F_701_CCTTGACAAG	AATGATACGGCGACCACCGAGATCTACACCCTTGACAAGGAGCGGCTGTCTCCACAAGT
rpp30_F_702_GGCATAGTTG	AATGATACGGCGACCACCGAGATCTACACGGCATAGTTGGAGCGGCTGTCTCCACAAGT
rpp30_F_703_CACATCATGA	AATGATACGGCGACCACCGAGATCTACACCACATCATGAGAGCGGCTGTCTCCACAAGT
rpp30_F_704_CGTGGTAATA	AATGATACGGCGACCACCGAGATCTACACCGTGGTAATAGAGCGGCTGTCTCCACAAGT
rpp30_F_705_GAGCAATAGA	AATGATACGGCGACCACCGAGATCTACACGAGCAATAGAGAGCGGCTGTCTCCACAAGT
rpp30_F_706_GAGCTCCTCA	AATGATACGGCGACCACCGAGATCTACACGAGCTCCTCAGAGCGGCTGTCTCCACAAGT
rpp30_F_707_TCGCGATCCT	AATGATACGGCGACCACCGAGATCTACACTCGCGATCCTGAGCGGCTGTCTCCACAAGT
rpp30_F_708_ATGCTGACTT	AATGATACGGCGACCACCGAGATCTACACATGCTGACTTGAGCGGCTGTCTCCACAAGT
rpp30_F_709_TCAACGACTT	AATGATACGGCGACCACCGAGATCTACACTCAACGACTTGAGCGGCTGTCTCCACAAGT
rpp30_F_710_CCTCTGAACG	AATGATACGGCGACCACCGAGATCTACACCCTCTGAACGGAGCGGCTGTCTCCACAAGT
rpp30_F_711_CGTAGCATCG	AATGATACGGCGACCACCGAGATCTACACCGTAGCATCGGAGCGGCTGTCTCCACAAGT
rpp30_F_712_GCGGACTAAG	AATGATACGGCGACCACCGAGATCTACACGCGGACTAAGGAGCGGCTGTCTCCACAAGT
rpp30_F_713_CTGGAGTATG	AATGATACGGCGACCACCGAGATCTACACCTGGAGTATGGAGCGGCTGTCTCCACAAGT
rpp30_F_714_GGCCACACTT	AATGATACGGCGACCACCGAGATCTACACGGCCACACTTGAGCGGCTGTCTCCACAAGT
rpp30_F_715_GTACATGACG	AATGATACGGCGACCACCGAGATCTACACGTACATGACGGAGCGGCTGTCTCCACAAGT
rpp30_F_716_CCTGCGCATT	AATGATACGGCGACCACCGAGATCTACACCCTGCGCATTGAGCGGCTGTCTCCACAAGT
rpp30_F_717_GCGGCATGAA	AATGATACGGCGACCACCGAGATCTACACGCGGCATGAAGAGCGGCTGTCTCCACAAGT
rpp30_F_718_CTCTGCGACA	AATGATACGGCGACCACCGAGATCTACACCTCTGCGACAGAGCGGCTGTCTCCACAAGT
rpp30_F_719_GGATCAGCGA	AATGATACGGCGACCACCGAGATCTACACGGATCAGCGAGAGCGGCTGTCTCCACAAGT
rpp30_F_720_TCGCATTCGA	AATGATACGGCGACCACCGAGATCTACACTCGCATTCGAGAGCGGCTGTCTCCACAAGT
rpp30_F_721_GTCGTTGAGC	AATGATACGGCGACCACCGAGATCTACACGTCGTTGAGCGAGCGGCTGTCTCCACAAGT
rpp30_F_722_GTGACGTACC	AATGATACGGCGACCACCGAGATCTACACGTGACGTACCGAGCGGCTGTCTCCACAAGT
rpp30_F_723_ACTGATCTCC	AATGATACGGCGACCACCGAGATCTACACACTGATCTCCGAGCGGCTGTCTCCACAAGT
rpp30_F_724_CAGAATTCAG	AATGATACGGCGACCACCGAGATCTACACCAGAATTCAGGAGCGGCTGTCTCCACAAGT
rpp30_F_725_CCACGAAGGT	AATGATACGGCGACCACCGAGATCTACACCCACGAAGGTGAGCGGCTGTCTCCACAAGT
rpp30_F_726_CTTAGGTCAA	AATGATACGGCGACCACCGAGATCTACACCTTAGGTCAAGAGCGGCTGTCTCCACAAGT
rpp30_F_727_CGACGTCAAT	AATGATACGGCGACCACCGAGATCTACACCGACGTCAATGAGCGGCTGTCTCCACAAGT
rpp30_F_728_GACGCGACAT	AATGATACGGCGACCACCGAGATCTACACGACGCGACATGAGCGGCTGTCTCCACAAGT
rpp30_F_729_GTGCTATGTA	AATGATACGGCGACCACCGAGATCTACACGTGCTATGTAGAGCGGCTGTCTCCACAAGT
rpp30_F_730_GTATGATCAG	AATGATACGGCGACCACCGAGATCTACACGTATGATCAGGAGCGGCTGTCTCCACAAGT
rpp30_F_731_CGTTATGGTT	AATGATACGGCGACCACCGAGATCTACACCGTTATGGTTGAGCGGCTGTCTCCACAAGT
rpp30_F_732_TCCAGCTAGG	AATGATACGGCGACCACCGAGATCTACACTCCAGCTAGGGAGCGGCTGTCTCCACAAGT
rpp30_F_733_AGCGAACGTA	AATGATACGGCGACCACCGAGATCTACACAGCGAACGTAGAGCGGCTGTCTCCACAAGT
rpp30_F_734_CGGAATCCGT	AATGATACGGCGACCACCGAGATCTACACCGGAATCCGTGAGCGGCTGTCTCCACAAGT
rpp30_F_735_GCGGTTAGTA	AATGATACGGCGACCACCGAGATCTACACGCGGTTAGTAGAGCGGCTGTCTCCACAAGT
rpp30_F_736_GTAGGTTCGG	AATGATACGGCGACCACCGAGATCTACACGTAGGTTCGGGAGCGGCTGTCTCCACAAGT
rpp30_F_737_CGACTCCAGA	AATGATACGGCGACCACCGAGATCTACACCGACTCCAGAGAGCGGCTGTCTCCACAAGT
rpp30_F_738_CTGTCAAGGT	AATGATACGGCGACCACCGAGATCTACACCTGTCAAGGTGAGCGGCTGTCTCCACAAGT
rpp30_F_739_CTAGCTACTT	AATGATACGGCGACCACCGAGATCTACACCTAGCTACTTGAGCGGCTGTCTCCACAAGT
rpp30_F_740_CATAGCTAGA	AATGATACGGCGACCACCGAGATCTACACCATAGCTAGAGAGCGGCTGTCTCCACAAGT
rpp30_F_741_AGGTCATCGA	AATGATACGGCGACCACCGAGATCTACACAGGTCATCGAGAGCGGCTGTCTCCACAAGT
rpp30_F_742_AACATGTGTC	AATGATACGGCGACCACCGAGATCTACACAACATGTGTCGAGCGGCTGTCTCCACAAGT
rpp30_F_743_CGCATTACCT	AATGATACGGCGACCACCGAGATCTACACCGCATTACCTGAGCGGCTGTCTCCACAAGT
rpp30_F_744_TGGCGTTCGT	AATGATACGGCGACCACCGAGATCTACACTGGCGTTCGTGAGCGGCTGTCTCCACAAGT
rpp30_F_745_TGTAATCGAG	AATGATACGGCGACCACCGAGATCTACACTGTAATCGAGGAGCGGCTGTCTCCACAAGT
rpp30_F_746_AAGTAGTTCG	AATGATACGGCGACCACCGAGATCTACACAAGTAGTTCGGAGCGGCTGTCTCCACAAGT
rpp30_F_747_AGGCCATGAC	AATGATACGGCGACCACCGAGATCTACACAGGCCATGACGAGCGGCTGTCTCCACAAGT
rpp30_F_748_GTTGGTAACG	AATGATACGGCGACCACCGAGATCTACACGTTGGTAACGGAGCGGCTGTCTCCACAAGT
rpp30_F_749_GTAGACCATG	AATGATACGGCGACCACCGAGATCTACACGTAGACCATGGAGCGGCTGTCTCCACAAGT
rpp30_F_750_ATCATGACGT	AATGATACGGCGACCACCGAGATCTACACATCATGACGTGAGCGGCTGTCTCCACAAGT
rpp30_F_751_GGCACTCCAT	AATGATACGGCGACCACCGAGATCTACACGGCACTCCATGAGCGGCTGTCTCCACAAGT
rpp30_F_752_CGTGTCGGTA	AATGATACGGCGACCACCGAGATCTACACCGTGTCGGTAGAGCGGCTGTCTCCACAAGT
rpp30_F_753_GGCCATAGAT	AATGATACGGCGACCACCGAGATCTACACGGCCATAGATGAGCGGCTGTCTCCACAAGT
rpp30_F_754_GTTGCCAAGC	AATGATACGGCGACCACCGAGATCTACACGTTGCCAAGCGAGCGGCTGTCTCCACAAGT
rpp30_F_755_ACCGAAGTGT	AATGATACGGCGACCACCGAGATCTACACACCGAAGTGTGAGCGGCTGTCTCCACAAGT
rpp30_F_756_CGGTACCACA	AATGATACGGCGACCACCGAGATCTACACCGGTACCACAGAGCGGCTGTCTCCACAAGT
rpp30_F_757_CGGAAGACTG	AATGATACGGCGACCACCGAGATCTACACCGGAAGACTGGAGCGGCTGTCTCCACAAGT
rpp30_F_758_GATTCGAACA	AATGATACGGCGACCACCGAGATCTACACGATTCGAACAGAGCGGCTGTCTCCACAAGT
rpp30_F_759_ATTGTCGAAC	AATGATACGGCGACCACCGAGATCTACACATTGTCGAACGAGCGGCTGTCTCCACAAGT
rpp30_F_760_TAGACGTGGT	AATGATACGGCGACCACCGAGATCTACACTAGACGTGGTGAGCGGCTGTCTCCACAAGT
rpp30_F_761_CGTTCCAGAG	AATGATACGGCGACCACCGAGATCTACACCGTTCCAGAGGAGCGGCTGTCTCCACAAGT
rpp30_F_762_ATTGGCCATC	AATGATACGGCGACCACCGAGATCTACACATTGGCCATCGAGCGGCTGTCTCCACAAGT
rpp30_F_763_GGTCAACATG	AATGATACGGCGACCACCGAGATCTACACGGTCAACATGGAGCGGCTGTCTCCACAAGT
rpp30_F_764_AGACAGAACT	AATGATACGGCGACCACCGAGATCTACACAGACAGAACTGAGCGGCTGTCTCCACAAGT
rpp30_F_765_CTTACGCACG	AATGATACGGCGACCACCGAGATCTACACCTTACGCACGGAGCGGCTGTCTCCACAAGT
rpp30_F_766_AGTGTCCTTC	AATGATACGGCGACCACCGAGATCTACACAGTGTCCTTCGAGCGGCTGTCTCCACAAGT
rpp30_F_767_ACTGTTGTGT	AATGATACGGCGACCACCGAGATCTACACACTGTTGTGTGAGCGGCTGTCTCCACAAGT
rpp30_F_768_CGGAGCGATT	AATGATACGGCGACCACCGAGATCTACACCGGAGCGATTGAGCGGCTGTCTCCACAAGT
rpp30_F_769_CGCAACTACT	AATGATACGGCGACCACCGAGATCTACACCGCAACTACTGAGCGGCTGTCTCCACAAGT
rpp30_F_770_CTACTGAGAG	AATGATACGGCGACCACCGAGATCTACACCTACTGAGAGGAGCGGCTGTCTCCACAAGT
rpp30_F_771_AAGGTGTTCC	AATGATACGGCGACCACCGAGATCTACACAAGGTGTTCCGAGCGGCTGTCTCCACAAGT
rpp30_F_772_ACCGCGAAGT	AATGATACGGCGACCACCGAGATCTACACACCGCGAAGTGAGCGGCTGTCTCCACAAGT
rpp30_F_773_CGATAGATAG	AATGATACGGCGACCACCGAGATCTACACCGATAGATAGGAGCGGCTGTCTCCACAAGT
rpp30_F_774_CGTTATCCGG	AATGATACGGCGACCACCGAGATCTACACCGTTATCCGGGAGCGGCTGTCTCCACAAGT
rpp30_F_775_AAGCGCTAAT	AATGATACGGCGACCACCGAGATCTACACAAGCGCTAATGAGCGGCTGTCTCCACAAGT
rpp30_F_776_GCAAGAGTCG	AATGATACGGCGACCACCGAGATCTACACGCAAGAGTCGGAGCGGCTGTCTCCACAAGT
rpp30_F_777_TCTGGCCAAT	AATGATACGGCGACCACCGAGATCTACACTCTGGCCAATGAGCGGCTGTCTCCACAAGT
rpp30_F_778_TACGCTGCCT	AATGATACGGCGACCACCGAGATCTACACTACGCTGCCTGAGCGGCTGTCTCCACAAGT
rpp30_F_779_CGAGTGCTTC	AATGATACGGCGACCACCGAGATCTACACCGAGTGCTTCGAGCGGCTGTCTCCACAAGT
rpp30_F_780_TAACTAGCGG	AATGATACGGCGACCACCGAGATCTACACTAACTAGCGGGAGCGGCTGTCTCCACAAGT
rpp30_F_781_GGTTCACAGT	AATGATACGGCGACCACCGAGATCTACACGGTTCACAGTGAGCGGCTGTCTCCACAAGT
rpp30_F_782_CTCAGCTTCT	AATGATACGGCGACCACCGAGATCTACACCTCAGCTTCTGAGCGGCTGTCTCCACAAGT
rpp30_F_783_ACCGGTTCAT	AATGATACGGCGACCACCGAGATCTACACACCGGTTCATGAGCGGCTGTCTCCACAAGT
rpp30_F_784_GAGGTAACGG	AATGATACGGCGACCACCGAGATCTACACGAGGTAACGGGAGCGGCTGTCTCCACAAGT
rpp30_F_785_CGGTATGGAG	AATGATACGGCGACCACCGAGATCTACACCGGTATGGAGGAGCGGCTGTCTCCACAAGT
rpp30_F_786_GGTAAGTGAA	AATGATACGGCGACCACCGAGATCTACACGGTAAGTGAAGAGCGGCTGTCTCCACAAGT
rpp30_F_787_GGACTTAACG	AATGATACGGCGACCACCGAGATCTACACGGACTTAACGGAGCGGCTGTCTCCACAAGT
rpp30_F_788_TGTTAGTACG	AATGATACGGCGACCACCGAGATCTACACTGTTAGTACGGAGCGGCTGTCTCCACAAGT
rpp30_F_789_TACCGTAGGA	AATGATACGGCGACCACCGAGATCTACACTACCGTAGGAGAGCGGCTGTCTCCACAAGT
rpp30_F_790_CAACTCGTGC	AATGATACGGCGACCACCGAGATCTACACCAACTCGTGCGAGCGGCTGTCTCCACAAGT
rpp30_F_791_CGGAGTAAGA	AATGATACGGCGACCACCGAGATCTACACCGGAGTAAGAGAGCGGCTGTCTCCACAAGT
rpp30_F_792_GGTCCTATAT	AATGATACGGCGACCACCGAGATCTACACGGTCCTATATGAGCGGCTGTCTCCACAAGT
rpp30_F_793_AGAATCGTGT	AATGATACGGCGACCACCGAGATCTACACAGAATCGTGTGAGCGGCTGTCTCCACAAGT
rpp30_F_794_GGTTAGCGAG	AATGATACGGCGACCACCGAGATCTACACGGTTAGCGAGGAGCGGCTGTCTCCACAAGT
rpp30_F_795_CATGGTCTAG	AATGATACGGCGACCACCGAGATCTACACCATGGTCTAGGAGCGGCTGTCTCCACAAGT
rpp30_F_796_TCGCGTAGGT	AATGATACGGCGACCACCGAGATCTACACTCGCGTAGGTGAGCGGCTGTCTCCACAAGT
rpp30_F_797_CCGAGAGTAC	AATGATACGGCGACCACCGAGATCTACACCCGAGAGTACGAGCGGCTGTCTCCACAAGT
rpp30_F_798_GGCATATAAG	AATGATACGGCGACCACCGAGATCTACACGGCATATAAGGAGCGGCTGTCTCCACAAGT
rpp30_F_799_AAGCCTACTT	AATGATACGGCGACCACCGAGATCTACACAAGCCTACTTGAGCGGCTGTCTCCACAAGT
rpp30_F_800_CAAGCGCGAT	AATGATACGGCGACCACCGAGATCTACACCAAGCGCGATGAGCGGCTGTCTCCACAAGT
rpp30_F_801_GGACACCATT	AATGATACGGCGACCACCGAGATCTACACGGACACCATTGAGCGGCTGTCTCCACAAGT
rpp30_F_802_GAGCTCACAA	AATGATACGGCGACCACCGAGATCTACACGAGCTCACAAGAGCGGCTGTCTCCACAAGT
rpp30_F_803_GCGAACAATG	AATGATACGGCGACCACCGAGATCTACACGCGAACAATGGAGCGGCTGTCTCCACAAGT
rpp30_F_804_GCGATTGCTG	AATGATACGGCGACCACCGAGATCTACACGCGATTGCTGGAGCGGCTGTCTCCACAAGT
rpp30_F_805_GTCGACTCAA	AATGATACGGCGACCACCGAGATCTACACGTCGACTCAAGAGCGGCTGTCTCCACAAGT
rpp30_F_806_ACTCGTATCG	AATGATACGGCGACCACCGAGATCTACACACTCGTATCGGAGCGGCTGTCTCCACAAGT
rpp30_F_807_GCAGAGTGGT	AATGATACGGCGACCACCGAGATCTACACGCAGAGTGGTGAGCGGCTGTCTCCACAAGT
rpp30_F_808_GTCCTTAGCG	AATGATACGGCGACCACCGAGATCTACACGTCCTTAGCGGAGCGGCTGTCTCCACAAGT
rpp30_F_809_TAGTAAGCCA	AATGATACGGCGACCACCGAGATCTACACTAGTAAGCCAGAGCGGCTGTCTCCACAAGT
rpp30_F_810_TGAACGTTGG	AATGATACGGCGACCACCGAGATCTACACTGAACGTTGGGAGCGGCTGTCTCCACAAGT
rpp30_F_811_GGCTCATAGC	AATGATACGGCGACCACCGAGATCTACACGGCTCATAGCGAGCGGCTGTCTCCACAAGT
rpp30_F_812_CGTACGCAGA	AATGATACGGCGACCACCGAGATCTACACCGTACGCAGAGAGCGGCTGTCTCCACAAGT
rpp30_F_813_GCAAGCAAGC	AATGATACGGCGACCACCGAGATCTACACGCAAGCAAGCGAGCGGCTGTCTCCACAAGT
rpp30_F_814_CATGGAAGGA	AATGATACGGCGACCACCGAGATCTACACCATGGAAGGAGAGCGGCTGTCTCCACAAGT
rpp30_F_815_ATAGTGCGTC	AATGATACGGCGACCACCGAGATCTACACATAGTGCGTCGAGCGGCTGTCTCCACAAGT
rpp30_F_816_AGCAGATCTT	AATGATACGGCGACCACCGAGATCTACACAGCAGATCTTGAGCGGCTGTCTCCACAAGT
rpp30_F_817_GCTGGACACT	AATGATACGGCGACCACCGAGATCTACACGCTGGACACTGAGCGGCTGTCTCCACAAGT
rpp30_F_818_TAGGAAGGCG	AATGATACGGCGACCACCGAGATCTACACTAGGAAGGCGGAGCGGCTGTCTCCACAAGT
rpp30_F_819_GGACACACAA	AATGATACGGCGACCACCGAGATCTACACGGACACACAAGAGCGGCTGTCTCCACAAGT
rpp30_F_820_TCCGCAACCA	AATGATACGGCGACCACCGAGATCTACACTCCGCAACCAGAGCGGCTGTCTCCACAAGT
rpp30_F_821_GCTTCATGTA	AATGATACGGCGACCACCGAGATCTACACGCTTCATGTAGAGCGGCTGTCTCCACAAGT
rpp30_F_822_CGCATGATGT	AATGATACGGCGACCACCGAGATCTACACCGCATGATGTGAGCGGCTGTCTCCACAAGT
rpp30_F_823_GCGGAAGTAT	AATGATACGGCGACCACCGAGATCTACACGCGGAAGTATGAGCGGCTGTCTCCACAAGT
rpp30_F_824_GTGCTACTAT	AATGATACGGCGACCACCGAGATCTACACGTGCTACTATGAGCGGCTGTCTCCACAAGT
rpp30_F_825_TCAGTGTCAA	AATGATACGGCGACCACCGAGATCTACACTCAGTGTCAAGAGCGGCTGTCTCCACAAGT
rpp30_F_826_AACGCGTATC	AATGATACGGCGACCACCGAGATCTACACAACGCGTATCGAGCGGCTGTCTCCACAAGT
rpp30_F_827_ACCAACGCAT	AATGATACGGCGACCACCGAGATCTACACACCAACGCATGAGCGGCTGTCTCCACAAGT
rpp30_F_828_TCTCAGCGTG	AATGATACGGCGACCACCGAGATCTACACTCTCAGCGTGGAGCGGCTGTCTCCACAAGT
rpp30_F_829_CTTAAGAGCG	AATGATACGGCGACCACCGAGATCTACACCTTAAGAGCGGAGCGGCTGTCTCCACAAGT
rpp30_F_830_GGCTTGATCC	AATGATACGGCGACCACCGAGATCTACACGGCTTGATCCGAGCGGCTGTCTCCACAAGT
rpp30_F_831_GCGTAGGTTG	AATGATACGGCGACCACCGAGATCTACACGCGTAGGTTGGAGCGGCTGTCTCCACAAGT
rpp30_F_832_AACGTTGTCT	AATGATACGGCGACCACCGAGATCTACACAACGTTGTCTGAGCGGCTGTCTCCACAAGT
rpp30_F_833_CCGGTGTGAT	AATGATACGGCGACCACCGAGATCTACACCCGGTGTGATGAGCGGCTGTCTCCACAAGT
rpp30_F_834_ACGAGGAGTC	AATGATACGGCGACCACCGAGATCTACACACGAGGAGTCGAGCGGCTGTCTCCACAAGT
rpp30_F_835_TGGCCTGTTG	AATGATACGGCGACCACCGAGATCTACACTGGCCTGTTGGAGCGGCTGTCTCCACAAGT
rpp30_F_836_CGTCCTGAAG	AATGATACGGCGACCACCGAGATCTACACCGTCCTGAAGGAGCGGCTGTCTCCACAAGT
rpp30_F_837_GTACGTCCAT	AATGATACGGCGACCACCGAGATCTACACGTACGTCCATGAGCGGCTGTCTCCACAAGT
rpp30_F_838_AATTGCGGAT	AATGATACGGCGACCACCGAGATCTACACAATTGCGGATGAGCGGCTGTCTCCACAAGT
rpp30_F_839_ACACACGTGG	AATGATACGGCGACCACCGAGATCTACACACACACGTGGGAGCGGCTGTCTCCACAAGT
rpp30_F_840_CCAGCTGTAT	AATGATACGGCGACCACCGAGATCTACACCCAGCTGTATGAGCGGCTGTCTCCACAAGT
rpp30_F_841_AGCCAGAATC	AATGATACGGCGACCACCGAGATCTACACAGCCAGAATCGAGCGGCTGTCTCCACAAGT
rpp30_F_842_GTCGGACCTA	AATGATACGGCGACCACCGAGATCTACACGTCGGACCTAGAGCGGCTGTCTCCACAAGT
rpp30_F_843_TGCTAAGCGG	AATGATACGGCGACCACCGAGATCTACACTGCTAAGCGGGAGCGGCTGTCTCCACAAGT
rpp30_F_844_GTACAGACTT	AATGATACGGCGACCACCGAGATCTACACGTACAGACTTGAGCGGCTGTCTCCACAAGT
rpp30_F_845_AACCTGCTCA	AATGATACGGCGACCACCGAGATCTACACAACCTGCTCAGAGCGGCTGTCTCCACAAGT
rpp30_F_846_AGATTGTGGC	AATGATACGGCGACCACCGAGATCTACACAGATTGTGGCGAGCGGCTGTCTCCACAAGT
rpp30_F_847_GAGAATGGCT	AATGATACGGCGACCACCGAGATCTACACGAGAATGGCTGAGCGGCTGTCTCCACAAGT
rpp30_F_848_CGGAGGAGTA	AATGATACGGCGACCACCGAGATCTACACCGGAGGAGTAGAGCGGCTGTCTCCACAAGT
rpp30_F_849_ACATCGATGC	AATGATACGGCGACCACCGAGATCTACACACATCGATGCGAGCGGCTGTCTCCACAAGT
rpp30_F_850_GAATATTGCC	AATGATACGGCGACCACCGAGATCTACACGAATATTGCCGAGCGGCTGTCTCCACAAGT
rpp30_F_851_GCGGACGATA	AATGATACGGCGACCACCGAGATCTACACGCGGACGATAGAGCGGCTGTCTCCACAAGT
rpp30_F_852_AGCTATCGTC	AATGATACGGCGACCACCGAGATCTACACAGCTATCGTCGAGCGGCTGTCTCCACAAGT
rpp30_F_853_AATTCGGAGC	AATGATACGGCGACCACCGAGATCTACACAATTCGGAGCGAGCGGCTGTCTCCACAAGT
rpp30_F_854_AGCTGTTCAA	AATGATACGGCGACCACCGAGATCTACACAGCTGTTCAAGAGCGGCTGTCTCCACAAGT
rpp30_F_855_AGGCAACACA	AATGATACGGCGACCACCGAGATCTACACAGGCAACACAGAGCGGCTGTCTCCACAAGT
rpp30_F_856_AGTAACCGCT	AATGATACGGCGACCACCGAGATCTACACAGTAACCGCTGAGCGGCTGTCTCCACAAGT
rpp30_F_857_ACTGGCATGC	AATGATACGGCGACCACCGAGATCTACACACTGGCATGCGAGCGGCTGTCTCCACAAGT
rpp30_F_858_TGATTGAGCG	AATGATACGGCGACCACCGAGATCTACACTGATTGAGCGGAGCGGCTGTCTCCACAAGT
rpp30_F_859_GGCATGATTA	AATGATACGGCGACCACCGAGATCTACACGGCATGATTAGAGCGGCTGTCTCCACAAGT
rpp30_F_860_AGCCTCAGTT	AATGATACGGCGACCACCGAGATCTACACAGCCTCAGTTGAGCGGCTGTCTCCACAAGT
rpp30_F_861_GGCAATAACT	AATGATACGGCGACCACCGAGATCTACACGGCAATAACTGAGCGGCTGTCTCCACAAGT
rpp30_F_862_TAATGATGCG	AATGATACGGCGACCACCGAGATCTACACTAATGATGCGGAGCGGCTGTCTCCACAAGT
rpp30_F_863_CTGTACGTAG	AATGATACGGCGACCACCGAGATCTACACCTGTACGTAGGAGCGGCTGTCTCCACAAGT
rpp30_F_864_AAGGACCGTC	AATGATACGGCGACCACCGAGATCTACACAAGGACCGTCGAGCGGCTGTCTCCACAAGT
rpp30_F_865_AGCCTCCTAA	AATGATACGGCGACCACCGAGATCTACACAGCCTCCTAAGAGCGGCTGTCTCCACAAGT
rpp30_F_866_GACTAGTCTT	AATGATACGGCGACCACCGAGATCTACACGACTAGTCTTGAGCGGCTGTCTCCACAAGT
rpp30_F_867_AAGGCCGGTT	AATGATACGGCGACCACCGAGATCTACACAAGGCCGGTTGAGCGGCTGTCTCCACAAGT
rpp30_F_868_GGTTACTCGA	AATGATACGGCGACCACCGAGATCTACACGGTTACTCGAGAGCGGCTGTCTCCACAAGT
rpp30_F_869_TCTGATCCGG	AATGATACGGCGACCACCGAGATCTACACTCTGATCCGGGAGCGGCTGTCTCCACAAGT
rpp30_F_870_CCATAAGCCA	AATGATACGGCGACCACCGAGATCTACACCCATAAGCCAGAGCGGCTGTCTCCACAAGT
rpp30_F_871_CCGTATAAGG	AATGATACGGCGACCACCGAGATCTACACCCGTATAAGGGAGCGGCTGTCTCCACAAGT
rpp30_F_872_GGTTCCTACG	AATGATACGGCGACCACCGAGATCTACACGGTTCCTACGGAGCGGCTGTCTCCACAAGT
rpp30_F_873_ATAGAGTGGC	AATGATACGGCGACCACCGAGATCTACACATAGAGTGGCGAGCGGCTGTCTCCACAAGT
rpp30_F_874_GCGATACTTA	AATGATACGGCGACCACCGAGATCTACACGCGATACTTAGAGCGGCTGTCTCCACAAGT
rpp30_F_875_ATGCGGAACA	AATGATACGGCGACCACCGAGATCTACACATGCGGAACAGAGCGGCTGTCTCCACAAGT
rpp30_F_876_ATTCGAACGT	AATGATACGGCGACCACCGAGATCTACACATTCGAACGTGAGCGGCTGTCTCCACAAGT
rpp30_F_877_AGGTACCATC	AATGATACGGCGACCACCGAGATCTACACAGGTACCATCGAGCGGCTGTCTCCACAAGT
rpp30_F_878_CGCTGATGAC	AATGATACGGCGACCACCGAGATCTACACCGCTGATGACGAGCGGCTGTCTCCACAAGT
rpp30_F_879_TCCGGTCCTT	AATGATACGGCGACCACCGAGATCTACACTCCGGTCCTTGAGCGGCTGTCTCCACAAGT
rpp30_F_880_GGAGTTAGTT	AATGATACGGCGACCACCGAGATCTACACGGAGTTAGTTGAGCGGCTGTCTCCACAAGT
rpp30_F_881_GGATGAAGTT	AATGATACGGCGACCACCGAGATCTACACGGATGAAGTTGAGCGGCTGTCTCCACAAGT
rpp30_F_882_CGTACTCGAC	AATGATACGGCGACCACCGAGATCTACACCGTACTCGACGAGCGGCTGTCTCCACAAGT
rpp30_F_883_CTCAGACAGA	AATGATACGGCGACCACCGAGATCTACACCTCAGACAGAGAGCGGCTGTCTCCACAAGT
rpp30_F_884_TGCGTTCACG	AATGATACGGCGACCACCGAGATCTACACTGCGTTCACGGAGCGGCTGTCTCCACAAGT
rpp30_F_885_AATGAGGCCG	AATGATACGGCGACCACCGAGATCTACACAATGAGGCCGGAGCGGCTGTCTCCACAAGT
rpp30_F_886_GACGAACGTT	AATGATACGGCGACCACCGAGATCTACACGACGAACGTTGAGCGGCTGTCTCCACAAGT
rpp30_F_887_GACGAATAAG	AATGATACGGCGACCACCGAGATCTACACGACGAATAAGGAGCGGCTGTCTCCACAAGT
rpp30_F_888_GACGAGCCAA	AATGATACGGCGACCACCGAGATCTACACGACGAGCCAAGAGCGGCTGTCTCCACAAGT
rpp30_F_889_GACGAGTTCT	AATGATACGGCGACCACCGAGATCTACACGACGAGTTCTGAGCGGCTGTCTCCACAAGT
rpp30_F_890_GACGATATGG	AATGATACGGCGACCACCGAGATCTACACGACGATATGGGAGCGGCTGTCTCCACAAGT
rpp30_F_891_ACGTGAATGT	AATGATACGGCGACCACCGAGATCTACACACGTGAATGTGAGCGGCTGTCTCCACAAGT
rpp30_F_892_GTTAGAGGTA	AATGATACGGCGACCACCGAGATCTACACGTTAGAGGTAGAGCGGCTGTCTCCACAAGT
rpp30_F_893_AGAGACTGTA	AATGATACGGCGACCACCGAGATCTACACAGAGACTGTAGAGCGGCTGTCTCCACAAGT
rpp30_F_894_CGGTTGTATG	AATGATACGGCGACCACCGAGATCTACACCGGTTGTATGGAGCGGCTGTCTCCACAAGT
rpp30_F_895_GACGAGCAGT	AATGATACGGCGACCACCGAGATCTACACGACGAGCAGTGAGCGGCTGTCTCCACAAGT
rpp30_F_896_CTCTGGTGAT	AATGATACGGCGACCACCGAGATCTACACCTCTGGTGATGAGCGGCTGTCTCCACAAGT
rpp30_F_897_CTTATGCATC	AATGATACGGCGACCACCGAGATCTACACCTTATGCATCGAGCGGCTGTCTCCACAAGT
rpp30_F_898_CGTGGACGTA	AATGATACGGCGACCACCGAGATCTACACCGTGGACGTAGAGCGGCTGTCTCCACAAGT
rpp30_F_899_ACGACACTTC	AATGATACGGCGACCACCGAGATCTACACACGACACTTCGAGCGGCTGTCTCCACAAGT
rpp30_F_900_GCGTCCATTG	AATGATACGGCGACCACCGAGATCTACACGCGTCCATTGGAGCGGCTGTCTCCACAAGT
rpp30_F_901_GAAGGACTCG	AATGATACGGCGACCACCGAGATCTACACGAAGGACTCGGAGCGGCTGTCTCCACAAGT
rpp30_F_902_GCGCCTGTTA	AATGATACGGCGACCACCGAGATCTACACGCGCCTGTTAGAGCGGCTGTCTCCACAAGT
rpp30_F_903_ACCGCATCCT	AATGATACGGCGACCACCGAGATCTACACACCGCATCCTGAGCGGCTGTCTCCACAAGT
rpp30_F_904_GTCGATACCT	AATGATACGGCGACCACCGAGATCTACACGTCGATACCTGAGCGGCTGTCTCCACAAGT
rpp30_F_905_AGCTCAACGT	AATGATACGGCGACCACCGAGATCTACACAGCTCAACGTGAGCGGCTGTCTCCACAAGT
rpp30_F_906_CGAACGTCGA	AATGATACGGCGACCACCGAGATCTACACCGAACGTCGAGAGCGGCTGTCTCCACAAGT
rpp30_F_907_GTACCTTAGA	AATGATACGGCGACCACCGAGATCTACACGTACCTTAGAGAGCGGCTGTCTCCACAAGT
rpp30_F_908_ACGTCGATAT	AATGATACGGCGACCACCGAGATCTACACACGTCGATATGAGCGGCTGTCTCCACAAGT
rpp30_F_909_CGACCGTAAG	AATGATACGGCGACCACCGAGATCTACACCGACCGTAAGGAGCGGCTGTCTCCACAAGT
rpp30_F_910_ATGGCCTGTC	AATGATACGGCGACCACCGAGATCTACACATGGCCTGTCGAGCGGCTGTCTCCACAAGT
rpp30_F_911_GGTTGTTACT	AATGATACGGCGACCACCGAGATCTACACGGTTGTTACTGAGCGGCTGTCTCCACAAGT
rpp30_F_912_CTTGTCCGCT	AATGATACGGCGACCACCGAGATCTACACCTTGTCCGCTGAGCGGCTGTCTCCACAAGT
rpp30_F_913_GACGTACTCT	AATGATACGGCGACCACCGAGATCTACACGACGTACTCTGAGCGGCTGTCTCCACAAGT
rpp30_F_914_AGCTGTATGT	AATGATACGGCGACCACCGAGATCTACACAGCTGTATGTGAGCGGCTGTCTCCACAAGT
rpp30_F_915_AATCACGCCT	AATGATACGGCGACCACCGAGATCTACACAATCACGCCTGAGCGGCTGTCTCCACAAGT
rpp30_F_916_ACGGACAGTA	AATGATACGGCGACCACCGAGATCTACACACGGACAGTAGAGCGGCTGTCTCCACAAGT
rpp30_F_917_CGACAACGCT	AATGATACGGCGACCACCGAGATCTACACCGACAACGCTGAGCGGCTGTCTCCACAAGT
rpp30_F_918_GTGGAGCTAA	AATGATACGGCGACCACCGAGATCTACACGTGGAGCTAAGAGCGGCTGTCTCCACAAGT
rpp30_F_919_AGTGGACATG	AATGATACGGCGACCACCGAGATCTACACAGTGGACATGGAGCGGCTGTCTCCACAAGT
rpp30_F_920_AGTGGATTGG	AATGATACGGCGACCACCGAGATCTACACAGTGGATTGGGAGCGGCTGTCTCCACAAGT
rpp30_F_921_ATTCCTTGGT	AATGATACGGCGACCACCGAGATCTACACATTCCTTGGTGAGCGGCTGTCTCCACAAGT
rpp30_F_922_AGTCGTGTCA	AATGATACGGCGACCACCGAGATCTACACAGTCGTGTCAGAGCGGCTGTCTCCACAAGT
rpp30_F_923_GAAGACGTCT	AATGATACGGCGACCACCGAGATCTACACGAAGACGTCTGAGCGGCTGTCTCCACAAGT
rpp30_F_924_AGTACAGTTC	AATGATACGGCGACCACCGAGATCTACACAGTACAGTTCGAGCGGCTGTCTCCACAAGT
rpp30_F_925_AGAACGCACA	AATGATACGGCGACCACCGAGATCTACACAGAACGCACAGAGCGGCTGTCTCCACAAGT
rpp30_F_926_GACGACAATC	AATGATACGGCGACCACCGAGATCTACACGACGACAATCGAGCGGCTGTCTCCACAAGT
rpp30_F_927_ACAGACTCAC	AATGATACGGCGACCACCGAGATCTACACACAGACTCACGAGCGGCTGTCTCCACAAGT
rpp30_F_928_GCTTGTACTA	AATGATACGGCGACCACCGAGATCTACACGCTTGTACTAGAGCGGCTGTCTCCACAAGT
rpp30_F_929_GCGATAACCG	AATGATACGGCGACCACCGAGATCTACACGCGATAACCGGAGCGGCTGTCTCCACAAGT
rpp30_F_930_TAAGATCGCT	AATGATACGGCGACCACCGAGATCTACACTAAGATCGCTGAGCGGCTGTCTCCACAAGT
rpp30_F_931_CGACCTCTGA	AATGATACGGCGACCACCGAGATCTACACCGACCTCTGAGAGCGGCTGTCTCCACAAGT
rpp30_F_932_ACGAGTGATG	AATGATACGGCGACCACCGAGATCTACACACGAGTGATGGAGCGGCTGTCTCCACAAGT
rpp30_F_933_GCTGAAGATG	AATGATACGGCGACCACCGAGATCTACACGCTGAAGATGGAGCGGCTGTCTCCACAAGT
rpp30_F_934_GCTGAATGCT	AATGATACGGCGACCACCGAGATCTACACGCTGAATGCTGAGCGGCTGTCTCCACAAGT
rpp30_F_935_GGTATGGCTG	AATGATACGGCGACCACCGAGATCTACACGGTATGGCTGGAGCGGCTGTCTCCACAAGT
rpp30_F_936_CAATGGCGAG	AATGATACGGCGACCACCGAGATCTACACCAATGGCGAGGAGCGGCTGTCTCCACAAGT
rpp30_F_937_CCGCCTAAGA	AATGATACGGCGACCACCGAGATCTACACCCGCCTAAGAGAGCGGCTGTCTCCACAAGT
rpp30_F_938_AGGTAATCAC	AATGATACGGCGACCACCGAGATCTACACAGGTAATCACGAGCGGCTGTCTCCACAAGT
rpp30_F_939_TCAACCTCCG	AATGATACGGCGACCACCGAGATCTACACTCAACCTCCGGAGCGGCTGTCTCCACAAGT
rpp30_F_940_GAACCACGCT	AATGATACGGCGACCACCGAGATCTACACGAACCACGCTGAGCGGCTGTCTCCACAAGT
rpp30_F_941_GCCTACCACT	AATGATACGGCGACCACCGAGATCTACACGCCTACCACTGAGCGGCTGTCTCCACAAGT
rpp30_F_942_GCCTCCACAA	AATGATACGGCGACCACCGAGATCTACACGCCTCCACAAGAGCGGCTGTCTCCACAAGT
rpp30_F_943_GCCTCTGATG	AATGATACGGCGACCACCGAGATCTACACGCCTCTGATGGAGCGGCTGTCTCCACAAGT
rpp30_F_944_GCCTGATGAT	AATGATACGGCGACCACCGAGATCTACACGCCTGATGATGAGCGGCTGTCTCCACAAGT
rpp30_F_945_GCCTGTTATT	AATGATACGGCGACCACCGAGATCTACACGCCTGTTATTGAGCGGCTGTCTCCACAAGT
rpp30_F_946_GCCTTGGAAT	AATGATACGGCGACCACCGAGATCTACACGCCTTGGAATGAGCGGCTGTCTCCACAAGT
rpp30_F_947_GCCTTGTTAA	AATGATACGGCGACCACCGAGATCTACACGCCTTGTTAAGAGCGGCTGTCTCCACAAGT
rpp30_F_948_GCCTCTACTT	AATGATACGGCGACCACCGAGATCTACACGCCTCTACTTGAGCGGCTGTCTCCACAAGT
rpp30_F_949_AAGCCATACA	AATGATACGGCGACCACCGAGATCTACACAAGCCATACAGAGCGGCTGTCTCCACAAGT
rpp30_F_950_GCGACCAGTT	AATGATACGGCGACCACCGAGATCTACACGCGACCAGTTGAGCGGCTGTCTCCACAAGT
rpp30_F_951_ATGAGCTCTA	AATGATACGGCGACCACCGAGATCTACACATGAGCTCTAGAGCGGCTGTCTCCACAAGT
rpp30_F_952_AAGGTTCGCT	AATGATACGGCGACCACCGAGATCTACACAAGGTTCGCTGAGCGGCTGTCTCCACAAGT
rpp30_F_953_CATGGCATTA	AATGATACGGCGACCACCGAGATCTACACCATGGCATTAGAGCGGCTGTCTCCACAAGT
rpp30_F_954_TCCTGGATCG	AATGATACGGCGACCACCGAGATCTACACTCCTGGATCGGAGCGGCTGTCTCCACAAGT
rpp30_F_955_ACATCGCACT	AATGATACGGCGACCACCGAGATCTACACACATCGCACTGAGCGGCTGTCTCCACAAGT
rpp30_F_956_GTTGTTCAGA	AATGATACGGCGACCACCGAGATCTACACGTTGTTCAGAGAGCGGCTGTCTCCACAAGT
rpp30_F_957_ATCGAGCCAC	AATGATACGGCGACCACCGAGATCTACACATCGAGCCACGAGCGGCTGTCTCCACAAGT
rpp30_F_958_ATCCGTTGTC	AATGATACGGCGACCACCGAGATCTACACATCCGTTGTCGAGCGGCTGTCTCCACAAGT
rpp30_F_959_ACGTCGTCCT	AATGATACGGCGACCACCGAGATCTACACACGTCGTCCTGAGCGGCTGTCTCCACAAGT
rpp30_F_960_GTCGATTAGA	AATGATACGGCGACCACCGAGATCTACACGTCGATTAGAGAGCGGCTGTCTCCACAAGT
rpp30_F_961_AGGTGTCACC	AATGATACGGCGACCACCGAGATCTACACAGGTGTCACCGAGCGGCTGTCTCCACAAGT
rpp30_F_962_GGTCTCGTTA	AATGATACGGCGACCACCGAGATCTACACGGTCTCGTTAGAGCGGCTGTCTCCACAAGT
rpp30_F_963_GAGTGGAACG	AATGATACGGCGACCACCGAGATCTACACGAGTGGAACGGAGCGGCTGTCTCCACAAGT
rpp30_F_964_GGACACTGAT	AATGATACGGCGACCACCGAGATCTACACGGACACTGATGAGCGGCTGTCTCCACAAGT
rpp30_F_965_CGTTGGATAT	AATGATACGGCGACCACCGAGATCTACACCGTTGGATATGAGCGGCTGTCTCCACAAGT
rpp30_F_966_TTCGATGACG	AATGATACGGCGACCACCGAGATCTACACTTCGATGACGGAGCGGCTGTCTCCACAAGT
rpp30_F_967_GTATCACTGC	AATGATACGGCGACCACCGAGATCTACACGTATCACTGCGAGCGGCTGTCTCCACAAGT
rpp30_F_968_ACTTCAGCGA	AATGATACGGCGACCACCGAGATCTACACACTTCAGCGAGAGCGGCTGTCTCCACAAGT
rpp30_F_969_ACCGCACGAT	AATGATACGGCGACCACCGAGATCTACACACCGCACGATGAGCGGCTGTCTCCACAAGT
rpp30_F_970_ACTCTTGCTG	AATGATACGGCGACCACCGAGATCTACACACTCTTGCTGGAGCGGCTGTCTCCACAAGT
rpp30_F_971_CTGGAGACCT	AATGATACGGCGACCACCGAGATCTACACCTGGAGACCTGAGCGGCTGTCTCCACAAGT
rpp30_F_972_GGCCTTATGC	AATGATACGGCGACCACCGAGATCTACACGGCCTTATGCGAGCGGCTGTCTCCACAAGT
rpp30_F_973_CTAGCTGTTA	AATGATACGGCGACCACCGAGATCTACACCTAGCTGTTAGAGCGGCTGTCTCCACAAGT
rpp30_F_974_ATCCAGCTAA	AATGATACGGCGACCACCGAGATCTACACATCCAGCTAAGAGCGGCTGTCTCCACAAGT
rpp30_F_975_CCGCACAATA	AATGATACGGCGACCACCGAGATCTACACCCGCACAATAGAGCGGCTGTCTCCACAAGT
rpp30_F_976_AGTGGCCTCA	AATGATACGGCGACCACCGAGATCTACACAGTGGCCTCAGAGCGGCTGTCTCCACAAGT
rpp30_F_977_CACGTTCAAC	AATGATACGGCGACCACCGAGATCTACACCACGTTCAACGAGCGGCTGTCTCCACAAGT
rpp30_F_978_CATTCCATGG	AATGATACGGCGACCACCGAGATCTACACCATTCCATGGGAGCGGCTGTCTCCACAAGT
rpp30_F_979_ACGTGTCGTT	AATGATACGGCGACCACCGAGATCTACACACGTGTCGTTGAGCGGCTGTCTCCACAAGT
rpp30_F_980_CGAACTTATC	AATGATACGGCGACCACCGAGATCTACACCGAACTTATCGAGCGGCTGTCTCCACAAGT
rpp30_F_981_CACGCCTTAT	AATGATACGGCGACCACCGAGATCTACACCACGCCTTATGAGCGGCTGTCTCCACAAGT
rpp30_F_982_CAATATCGAC	AATGATACGGCGACCACCGAGATCTACACCAATATCGACGAGCGGCTGTCTCCACAAGT
rpp30_F_983_GAGACGATCA	AATGATACGGCGACCACCGAGATCTACACGAGACGATCAGAGCGGCTGTCTCCACAAGT
rpp30_F_984_ACCGTTGCTA	AATGATACGGCGACCACCGAGATCTACACACCGTTGCTAGAGCGGCTGTCTCCACAAGT
rpp30_F_985_CGTCACTAGG	AATGATACGGCGACCACCGAGATCTACACCGTCACTAGGGAGCGGCTGTCTCCACAAGT
rpp30_F_986_AAGTCGAACT	AATGATACGGCGACCACCGAGATCTACACAAGTCGAACTGAGCGGCTGTCTCCACAAGT
rpp30_F_987_GCCTAGAATT	AATGATACGGCGACCACCGAGATCTACACGCCTAGAATTGAGCGGCTGTCTCCACAAGT
rpp30_F_988_AACACTCGAT	AATGATACGGCGACCACCGAGATCTACACAACACTCGATGAGCGGCTGTCTCCACAAGT
rpp30_F_989_GCCTTCGGTT	AATGATACGGCGACCACCGAGATCTACACGCCTTCGGTTGAGCGGCTGTCTCCACAAGT
rpp30_F_990_GGCTAGCTTA	AATGATACGGCGACCACCGAGATCTACACGGCTAGCTTAGAGCGGCTGTCTCCACAAGT
rpp30_F_991_ACTCTAGAGG	AATGATACGGCGACCACCGAGATCTACACACTCTAGAGGGAGCGGCTGTCTCCACAAGT
rpp30_F_992_ATACATCGCT	AATGATACGGCGACCACCGAGATCTACACATACATCGCTGAGCGGCTGTCTCCACAAGT
rpp30_F_993_TCGAATAGGA	AATGATACGGCGACCACCGAGATCTACACTCGAATAGGAGAGCGGCTGTCTCCACAAGT
rpp30_F_994_ACCACTCGTC	AATGATACGGCGACCACCGAGATCTACACACCACTCGTCGAGCGGCTGTCTCCACAAGT
rpp30_F_995_CGCCAACTAA	AATGATACGGCGACCACCGAGATCTACACCGCCAACTAAGAGCGGCTGTCTCCACAAGT
rpp30_F_996_GTCGTGCGAT	AATGATACGGCGACCACCGAGATCTACACGTCGTGCGATGAGCGGCTGTCTCCACAAGT
rpp30_F_997_AGTGTGCATT	AATGATACGGCGACCACCGAGATCTACACAGTGTGCATTGAGCGGCTGTCTCCACAAGT
rpp30_F_998_ACTAACGTGT	AATGATACGGCGACCACCGAGATCTACACACTAACGTGTGAGCGGCTGTCTCCACAAGT
rpp30_F_999_CGAGACATTG	AATGATACGGCGACCACCGAGATCTACACCGAGACATTGGAGCGGCTGTCTCCACAAGT
rpp30_F_1000_CTAGCCAACA	AATGATACGGCGACCACCGAGATCTACACCTAGCCAACAGAGCGGCTGTCTCCACAAGT
rpp30_F_1001_CGTGAGGTTC	AATGATACGGCGACCACCGAGATCTACACCGTGAGGTTCGAGCGGCTGTCTCCACAAGT
rpp30_F_1002_TGGCAACAAC	AATGATACGGCGACCACCGAGATCTACACTGGCAACAACGAGCGGCTGTCTCCACAAGT
rpp30_F_1003_GCTGAGCAGA	AATGATACGGCGACCACCGAGATCTACACGCTGAGCAGAGAGCGGCTGTCTCCACAAGT
rpp30_F_1004_GATTCGCAAG	AATGATACGGCGACCACCGAGATCTACACGATTCGCAAGGAGCGGCTGTCTCCACAAGT
rpp30_F_1005_ACCTTCTCCG	AATGATACGGCGACCACCGAGATCTACACACCTTCTCCGGAGCGGCTGTCTCCACAAGT
rpp30_F_1006_CTATCTCAGC	AATGATACGGCGACCACCGAGATCTACACCTATCTCAGCGAGCGGCTGTCTCCACAAGT
rpp30_F_1007_ACCAGATGTC	AATGATACGGCGACCACCGAGATCTACACACCAGATGTCGAGCGGCTGTCTCCACAAGT
rpp30_F_1008_AATTGGATCC	AATGATACGGCGACCACCGAGATCTACACAATTGGATCCGAGCGGCTGTCTCCACAAGT
rpp30_F_1009_ATACAGATCC	AATGATACGGCGACCACCGAGATCTACACATACAGATCCGAGCGGCTGTCTCCACAAGT
rpp30_F_1010_AGCCACACGA	AATGATACGGCGACCACCGAGATCTACACAGCCACACGAGAGCGGCTGTCTCCACAAGT
rpp30_F_1011_CGACACAAGT	AATGATACGGCGACCACCGAGATCTACACCGACACAAGTGAGCGGCTGTCTCCACAAGT
rpp30_F_1012_AAGGCGTGAT	AATGATACGGCGACCACCGAGATCTACACAAGGCGTGATGAGCGGCTGTCTCCACAAGT
rpp30_F_1013_GAAGCGCCTT	AATGATACGGCGACCACCGAGATCTACACGAAGCGCCTTGAGCGGCTGTCTCCACAAGT
rpp30_F_1014_ATGGCCTTGA	AATGATACGGCGACCACCGAGATCTACACATGGCCTTGAGAGCGGCTGTCTCCACAAGT
rpp30_F_1015_GTTAAGACGT	AATGATACGGCGACCACCGAGATCTACACGTTAAGACGTGAGCGGCTGTCTCCACAAGT
rpp30_F_1016_GAGCTTAACA	AATGATACGGCGACCACCGAGATCTACACGAGCTTAACAGAGCGGCTGTCTCCACAAGT
rpp30_F_1017_AACAAGGCGT	AATGATACGGCGACCACCGAGATCTACACAACAAGGCGTGAGCGGCTGTCTCCACAAGT
rpp30_F_1018_AGGTTGCTAT	AATGATACGGCGACCACCGAGATCTACACAGGTTGCTATGAGCGGCTGTCTCCACAAGT
rpp30_F_1019_GCAAGCGATG	AATGATACGGCGACCACCGAGATCTACACGCAAGCGATGGAGCGGCTGTCTCCACAAGT
rpp30_F_1020_AGATGTGTCG	AATGATACGGCGACCACCGAGATCTACACAGATGTGTCGGAGCGGCTGTCTCCACAAGT
rpp30_F_1021_CAAGTCTGAC	AATGATACGGCGACCACCGAGATCTACACCAAGTCTGACGAGCGGCTGTCTCCACAAGT
rpp30_F_1022_AAGTACCTAG	AATGATACGGCGACCACCGAGATCTACACAAGTACCTAGGAGCGGCTGTCTCCACAAGT
rpp30_F_1023_CCGTATCTAA	AATGATACGGCGACCACCGAGATCTACACCCGTATCTAAGAGCGGCTGTCTCCACAAGT
rpp30_F_1024_AGGACTCGCT	AATGATACGGCGACCACCGAGATCTACACAGGACTCGCTGAGCGGCTGTCTCCACAAGT
rpp30_F_1025_CGAGCATCAT	AATGATACGGCGACCACCGAGATCTACACCGAGCATCATGAGCGGCTGTCTCCACAAGT
rpp30_F_1026_CGCAAGAGCT	AATGATACGGCGACCACCGAGATCTACACCGCAAGAGCTGAGCGGCTGTCTCCACAAGT
rpp30_F_1027_TCGAGGCTAT	AATGATACGGCGACCACCGAGATCTACACTCGAGGCTATGAGCGGCTGTCTCCACAAGT
rpp30_F_1028_GTCGAAGACC	AATGATACGGCGACCACCGAGATCTACACGTCGAAGACCGAGCGGCTGTCTCCACAAGT
rpp30_F_1029_CACGATAGTC	AATGATACGGCGACCACCGAGATCTACACCACGATAGTCGAGCGGCTGTCTCCACAAGT
rpp30_F_1030_AGATAACTCG	AATGATACGGCGACCACCGAGATCTACACAGATAACTCGGAGCGGCTGTCTCCACAAGT
rpp30_F_1031_AACTCACGGC	AATGATACGGCGACCACCGAGATCTACACAACTCACGGCGAGCGGCTGTCTCCACAAGT
rpp30_F_1032_CCAGCCAGTT	AATGATACGGCGACCACCGAGATCTACACCCAGCCAGTTGAGCGGCTGTCTCCACAAGT
rpp30_F_1033_AGGAAGTATC	AATGATACGGCGACCACCGAGATCTACACAGGAAGTATCGAGCGGCTGTCTCCACAAGT
rpp30_F_1034_TCACTCCGTC	AATGATACGGCGACCACCGAGATCTACACTCACTCCGTCGAGCGGCTGTCTCCACAAGT
rpp30_F_1035_GCTGTTGTTA	AATGATACGGCGACCACCGAGATCTACACGCTGTTGTTAGAGCGGCTGTCTCCACAAGT
rpp30_F_1036_TGGCTGTTCA	AATGATACGGCGACCACCGAGATCTACACTGGCTGTTCAGAGCGGCTGTCTCCACAAGT
rpp30_F_1037_ATGAGGCGAG	AATGATACGGCGACCACCGAGATCTACACATGAGGCGAGGAGCGGCTGTCTCCACAAGT
rpp30_F_1038_TATAGGCGAA	AATGATACGGCGACCACCGAGATCTACACTATAGGCGAAGAGCGGCTGTCTCCACAAGT
rpp30_F_1039_ATTCGCAACC	AATGATACGGCGACCACCGAGATCTACACATTCGCAACCGAGCGGCTGTCTCCACAAGT
rpp30_F_1040_CGACACATCC	AATGATACGGCGACCACCGAGATCTACACCGACACATCCGAGCGGCTGTCTCCACAAGT
rpp30_F_1041_CGCGTAGTAA	AATGATACGGCGACCACCGAGATCTACACCGCGTAGTAAGAGCGGCTGTCTCCACAAGT
rpp30_F_1042_ATGGCTTCAG	AATGATACGGCGACCACCGAGATCTACACATGGCTTCAGGAGCGGCTGTCTCCACAAGT
rpp30_F_1043_CCGCTGGAAT	AATGATACGGCGACCACCGAGATCTACACCCGCTGGAATGAGCGGCTGTCTCCACAAGT
rpp30_F_1044_CGTCGAATAC	AATGATACGGCGACCACCGAGATCTACACCGTCGAATACGAGCGGCTGTCTCCACAAGT
rpp30_F_1045_CGTCGAGAGT	AATGATACGGCGACCACCGAGATCTACACCGTCGAGAGTGAGCGGCTGTCTCCACAAGT
rpp30_F_1046_AACCTCGGAA	AATGATACGGCGACCACCGAGATCTACACAACCTCGGAAGAGCGGCTGTCTCCACAAGT
rpp30_F_1047_GGTATACCTA	AATGATACGGCGACCACCGAGATCTACACGGTATACCTAGAGCGGCTGTCTCCACAAGT
rpp30_F_1048_AGTCTACGGC	AATGATACGGCGACCACCGAGATCTACACAGTCTACGGCGAGCGGCTGTCTCCACAAGT
rpp30_F_1049_TCTAACCGTC	AATGATACGGCGACCACCGAGATCTACACTCTAACCGTCGAGCGGCTGTCTCCACAAGT
rpp30_F_1050_AAGGTCACAC	AATGATACGGCGACCACCGAGATCTACACAAGGTCACACGAGCGGCTGTCTCCACAAGT
rpp30_F_1051_AACTACGGTA	AATGATACGGCGACCACCGAGATCTACACAACTACGGTAGAGCGGCTGTCTCCACAAGT
rpp30_F_1052_ACAATAAGGC	AATGATACGGCGACCACCGAGATCTACACACAATAAGGCGAGCGGCTGTCTCCACAAGT
rpp30_F_1053_AGCTATATCC	AATGATACGGCGACCACCGAGATCTACACAGCTATATCCGAGCGGCTGTCTCCACAAGT
rpp30_F_1054_CCATCGCTAA	AATGATACGGCGACCACCGAGATCTACACCCATCGCTAAGAGCGGCTGTCTCCACAAGT
rpp30_F_1055_CTGGAGATTC	AATGATACGGCGACCACCGAGATCTACACCTGGAGATTCGAGCGGCTGTCTCCACAAGT
rpp30_F_1056_GAGTGTACTG	AATGATACGGCGACCACCGAGATCTACACGAGTGTACTGGAGCGGCTGTCTCCACAAGT
rpp30_F_1057_GCATAGATCC	AATGATACGGCGACCACCGAGATCTACACGCATAGATCCGAGCGGCTGTCTCCACAAGT
rpp30_F_1058_GCTTGCAATC	AATGATACGGCGACCACCGAGATCTACACGCTTGCAATCGAGCGGCTGTCTCCACAAGT
rpp30_F_1059_GGAGAAGTAA	AATGATACGGCGACCACCGAGATCTACACGGAGAAGTAAGAGCGGCTGTCTCCACAAGT
rpp30_F_1060_GGAGCTATTA	AATGATACGGCGACCACCGAGATCTACACGGAGCTATTAGAGCGGCTGTCTCCACAAGT
rpp30_F_1061_GTAAGAGCAT	AATGATACGGCGACCACCGAGATCTACACGTAAGAGCATGAGCGGCTGTCTCCACAAGT
rpp30_F_1062_GTCAGTGACT	AATGATACGGCGACCACCGAGATCTACACGTCAGTGACTGAGCGGCTGTCTCCACAAGT
rpp30_F_1063_GTGACAGTAA	AATGATACGGCGACCACCGAGATCTACACGTGACAGTAAGAGCGGCTGTCTCCACAAGT
rpp30_F_1064_GTGACCAGAG	AATGATACGGCGACCACCGAGATCTACACGTGACCAGAGGAGCGGCTGTCTCCACAAGT
rpp30_F_1065_TAATACCGGA	AATGATACGGCGACCACCGAGATCTACACTAATACCGGAGAGCGGCTGTCTCCACAAGT
rpp30_F_1066_TAGAGGTCTA	AATGATACGGCGACCACCGAGATCTACACTAGAGGTCTAGAGCGGCTGTCTCCACAAGT
rpp30_F_1067_TCATTGAGGA	AATGATACGGCGACCACCGAGATCTACACTCATTGAGGAGAGCGGCTGTCTCCACAAGT
rpp30_F_1068_TCCAGGAGTA	AATGATACGGCGACCACCGAGATCTACACTCCAGGAGTAGAGCGGCTGTCTCCACAAGT
rpp30_F_1069_TCTTCGGAGG	AATGATACGGCGACCACCGAGATCTACACTCTTCGGAGGGAGCGGCTGTCTCCACAAGT
rpp30_F_1070_TGCGTACGTG	AATGATACGGCGACCACCGAGATCTACACTGCGTACGTGGAGCGGCTGTCTCCACAAGT
rpp30_F_1071_TGGAGGTAAT	AATGATACGGCGACCACCGAGATCTACACTGGAGGTAATGAGCGGCTGTCTCCACAAGT
rpp30_F_1072_TGGCCATATA	AATGATACGGCGACCACCGAGATCTACACTGGCCATATAGAGCGGCTGTCTCCACAAGT
rpp30_F_1073_ATTAGCGGTT	AATGATACGGCGACCACCGAGATCTACACATTAGCGGTTGAGCGGCTGTCTCCACAAGT
rpp30_F_1074_ATCAGTGAAC	AATGATACGGCGACCACCGAGATCTACACATCAGTGAACGAGCGGCTGTCTCCACAAGT
rpp30_F_1075_AAGTACTCTC	AATGATACGGCGACCACCGAGATCTACACAAGTACTCTCGAGCGGCTGTCTCCACAAGT
rpp30_F_1076_AAGAGCTATC	AATGATACGGCGACCACCGAGATCTACACAAGAGCTATCGAGCGGCTGTCTCCACAAGT
rpp30_F_1077_GATGTAGCTT	AATGATACGGCGACCACCGAGATCTACACGATGTAGCTTGAGCGGCTGTCTCCACAAGT
rpp30_F_1078_TCTACGACGA	AATGATACGGCGACCACCGAGATCTACACTCTACGACGAGAGCGGCTGTCTCCACAAGT
rpp30_F_1079_GAACTGATCC	AATGATACGGCGACCACCGAGATCTACACGAACTGATCCGAGCGGCTGTCTCCACAAGT
rpp30_F_1080_GCAACCTGAG	AATGATACGGCGACCACCGAGATCTACACGCAACCTGAGGAGCGGCTGTCTCCACAAGT
rpp30_F_1081_TAGCCTCTCA	AATGATACGGCGACCACCGAGATCTACACTAGCCTCTCAGAGCGGCTGTCTCCACAAGT
rpp30_F_1082_GACTACGTGA	AATGATACGGCGACCACCGAGATCTACACGACTACGTGAGAGCGGCTGTCTCCACAAGT
rpp30_F_1083_AGGCTTGGAG	AATGATACGGCGACCACCGAGATCTACACAGGCTTGGAGGAGCGGCTGTCTCCACAAGT
rpp30_F_1084_TGGCGACACT	AATGATACGGCGACCACCGAGATCTACACTGGCGACACTGAGCGGCTGTCTCCACAAGT
rpp30_F_1085_GCGAATATCA	AATGATACGGCGACCACCGAGATCTACACGCGAATATCAGAGCGGCTGTCTCCACAAGT
rpp30_F_1086_GCGATGATAT	AATGATACGGCGACCACCGAGATCTACACGCGATGATATGAGCGGCTGTCTCCACAAGT
rpp30_F_1087_ATATCCGGAT	AATGATACGGCGACCACCGAGATCTACACATATCCGGATGAGCGGCTGTCTCCACAAGT
rpp30_F_1088_GCCTATGCTA	AATGATACGGCGACCACCGAGATCTACACGCCTATGCTAGAGCGGCTGTCTCCACAAGT
rpp30_F_1089_AGTCATTGTC	AATGATACGGCGACCACCGAGATCTACACAGTCATTGTCGAGCGGCTGTCTCCACAAGT
rpp30_F_1090_GACAGCGTTA	AATGATACGGCGACCACCGAGATCTACACGACAGCGTTAGAGCGGCTGTCTCCACAAGT
rpp30_F_1091_GTACCAAGTC	AATGATACGGCGACCACCGAGATCTACACGTACCAAGTCGAGCGGCTGTCTCCACAAGT
rpp30_F_1092_GCCAACTCAG	AATGATACGGCGACCACCGAGATCTACACGCCAACTCAGGAGCGGCTGTCTCCACAAGT
rpp30_F_1093_GCCAAGTAAT	AATGATACGGCGACCACCGAGATCTACACGCCAAGTAATGAGCGGCTGTCTCCACAAGT
rpp30_F_1094_GCCAATCCTT	AATGATACGGCGACCACCGAGATCTACACGCCAATCCTTGAGCGGCTGTCTCCACAAGT
rpp30_F_1095_GCCACCAATA	AATGATACGGCGACCACCGAGATCTACACGCCACCAATAGAGCGGCTGTCTCCACAAGT
rpp30_F_1096_GCCACGAGAT	AATGATACGGCGACCACCGAGATCTACACGCCACGAGATGAGCGGCTGTCTCCACAAGT
rpp30_F_1097_GCCACGTACA	AATGATACGGCGACCACCGAGATCTACACGCCACGTACAGAGCGGCTGTCTCCACAAGT
rpp30_F_1098_GCCACTCTCA	AATGATACGGCGACCACCGAGATCTACACGCCACTCTCAGAGCGGCTGTCTCCACAAGT
rpp30_F_1099_GCCAGTAACC	AATGATACGGCGACCACCGAGATCTACACGCCAGTAACCGAGCGGCTGTCTCCACAAGT
rpp30_F_1100_GCCAGTAGGT	AATGATACGGCGACCACCGAGATCTACACGCCAGTAGGTGAGCGGCTGTCTCCACAAGT
rpp30_F_1101_GCCAGTGAAG	AATGATACGGCGACCACCGAGATCTACACGCCAGTGAAGGAGCGGCTGTCTCCACAAGT
rpp30_F_1102_GCCATACCTG	AATGATACGGCGACCACCGAGATCTACACGCCATACCTGGAGCGGCTGTCTCCACAAGT
rpp30_F_1103_GCCATAGAGG	AATGATACGGCGACCACCGAGATCTACACGCCATAGAGGGAGCGGCTGTCTCCACAAGT
rpp30_F_1104_GCCATCCGAA	AATGATACGGCGACCACCGAGATCTACACGCCATCCGAAGAGCGGCTGTCTCCACAAGT
rpp30_F_1105_GCCATTCAAT	AATGATACGGCGACCACCGAGATCTACACGCCATTCAATGAGCGGCTGTCTCCACAAGT
rpp30_F_1106_TAGCAGCTAG	AATGATACGGCGACCACCGAGATCTACACTAGCAGCTAGGAGCGGCTGTCTCCACAAGT
rpp30_F_1107_ACAGTGATCC	AATGATACGGCGACCACCGAGATCTACACACAGTGATCCGAGCGGCTGTCTCCACAAGT
rpp30_F_1108_GTTGACGTGC	AATGATACGGCGACCACCGAGATCTACACGTTGACGTGCGAGCGGCTGTCTCCACAAGT
rpp30_F_1109_ACGTGTCTGG	AATGATACGGCGACCACCGAGATCTACACACGTGTCTGGGAGCGGCTGTCTCCACAAGT
rpp30_F_1110_AAGTTGCAAG	AATGATACGGCGACCACCGAGATCTACACAAGTTGCAAGGAGCGGCTGTCTCCACAAGT
rpp30_F_1111_ATCCGGAAGC	AATGATACGGCGACCACCGAGATCTACACATCCGGAAGCGAGCGGCTGTCTCCACAAGT
rpp30_F_1112_CAACTTGGAC	AATGATACGGCGACCACCGAGATCTACACCAACTTGGACGAGCGGCTGTCTCCACAAGT
rpp30_F_1113_AGTCGGACAC	AATGATACGGCGACCACCGAGATCTACACAGTCGGACACGAGCGGCTGTCTCCACAAGT
rpp30_F_1114_GTGAGCACTG	AATGATACGGCGACCACCGAGATCTACACGTGAGCACTGGAGCGGCTGTCTCCACAAGT
rpp30_F_1115_AACCGCACAG	AATGATACGGCGACCACCGAGATCTACACAACCGCACAGGAGCGGCTGTCTCCACAAGT
rpp30_F_1116_TGAACTGTGA	AATGATACGGCGACCACCGAGATCTACACTGAACTGTGAGAGCGGCTGTCTCCACAAGT
rpp30_F_1117_ATGTAACGGC	AATGATACGGCGACCACCGAGATCTACACATGTAACGGCGAGCGGCTGTCTCCACAAGT
rpp30_F_1118_CGGCATGATC	AATGATACGGCGACCACCGAGATCTACACCGGCATGATCGAGCGGCTGTCTCCACAAGT
rpp30_F_1119_TGTCCGACGT	AATGATACGGCGACCACCGAGATCTACACTGTCCGACGTGAGCGGCTGTCTCCACAAGT
rpp30_F_1120_GCCTACAGGA	AATGATACGGCGACCACCGAGATCTACACGCCTACAGGAGAGCGGCTGTCTCCACAAGT
rpp30_F_1121_AGGCTGCCAA	AATGATACGGCGACCACCGAGATCTACACAGGCTGCCAAGAGCGGCTGTCTCCACAAGT
rpp30_F_1122_GAGTGGTTAA	AATGATACGGCGACCACCGAGATCTACACGAGTGGTTAAGAGCGGCTGTCTCCACAAGT
rpp30_F_1123_AGTCCACCGT	AATGATACGGCGACCACCGAGATCTACACAGTCCACCGTGAGCGGCTGTCTCCACAAGT
rpp30_F_1124_ATCGCTAACA	AATGATACGGCGACCACCGAGATCTACACATCGCTAACAGAGCGGCTGTCTCCACAAGT
rpp30_F_1125_CATGAGACGA	AATGATACGGCGACCACCGAGATCTACACCATGAGACGAGAGCGGCTGTCTCCACAAGT
rpp30_F_1126_CTAAGAGCTA	AATGATACGGCGACCACCGAGATCTACACCTAAGAGCTAGAGCGGCTGTCTCCACAAGT
rpp30_F_1127_CAGTAGGCGA	AATGATACGGCGACCACCGAGATCTACACCAGTAGGCGAGAGCGGCTGTCTCCACAAGT
rpp30_F_1128_AGCTTCCTCC	AATGATACGGCGACCACCGAGATCTACACAGCTTCCTCCGAGCGGCTGTCTCCACAAGT
rpp30_F_1129_ACCGACGTTA	AATGATACGGCGACCACCGAGATCTACACACCGACGTTAGAGCGGCTGTCTCCACAAGT
rpp30_F_1130_ACAGGAGATG	AATGATACGGCGACCACCGAGATCTACACACAGGAGATGGAGCGGCTGTCTCCACAAGT
rpp30_F_1131_AGGCTCTGTA	AATGATACGGCGACCACCGAGATCTACACAGGCTCTGTAGAGCGGCTGTCTCCACAAGT
rpp30_F_1132_AACTGGCGTA	AATGATACGGCGACCACCGAGATCTACACAACTGGCGTAGAGCGGCTGTCTCCACAAGT
rpp30_F_1133_ACCACCATCC	AATGATACGGCGACCACCGAGATCTACACACCACCATCCGAGCGGCTGTCTCCACAAGT
rpp30_F_1134_ATCGCATTAG	AATGATACGGCGACCACCGAGATCTACACATCGCATTAGGAGCGGCTGTCTCCACAAGT
rpp30_F_1135_AACACGCTGA	AATGATACGGCGACCACCGAGATCTACACAACACGCTGAGAGCGGCTGTCTCCACAAGT
rpp30_F_1136_ATCCATGATG	AATGATACGGCGACCACCGAGATCTACACATCCATGATGGAGCGGCTGTCTCCACAAGT
rpp30_F_1137_AAGTAGATGC	AATGATACGGCGACCACCGAGATCTACACAAGTAGATGCGAGCGGCTGTCTCCACAAGT
rpp30_F_1138_ACGACGCCTA	AATGATACGGCGACCACCGAGATCTACACACGACGCCTAGAGCGGCTGTCTCCACAAGT
rpp30_F_1139_GAGTTGCACA	AATGATACGGCGACCACCGAGATCTACACGAGTTGCACAGAGCGGCTGTCTCCACAAGT
rpp30_F_1140_AATCTGCATG	AATGATACGGCGACCACCGAGATCTACACAATCTGCATGGAGCGGCTGTCTCCACAAGT
rpp30_F_1141_AACCGTCAGC	AATGATACGGCGACCACCGAGATCTACACAACCGTCAGCGAGCGGCTGTCTCCACAAGT
rpp30_F_1142_ACTGCATGAG	AATGATACGGCGACCACCGAGATCTACACACTGCATGAGGAGCGGCTGTCTCCACAAGT
rpp30_F_1143_GGTACAAGTT	AATGATACGGCGACCACCGAGATCTACACGGTACAAGTTGAGCGGCTGTCTCCACAAGT
rpp30_F_1144_ATCCGACGAA	AATGATACGGCGACCACCGAGATCTACACATCCGACGAAGAGCGGCTGTCTCCACAAGT
rpp30_F_1145_AGCTGGACTA	AATGATACGGCGACCACCGAGATCTACACAGCTGGACTAGAGCGGCTGTCTCCACAAGT
rpp30_F_1146_AACTGCCAAG	AATGATACGGCGACCACCGAGATCTACACAACTGCCAAGGAGCGGCTGTCTCCACAAGT
rpp30_F_1147_TGCGCCTGAA	AATGATACGGCGACCACCGAGATCTACACTGCGCCTGAAGAGCGGCTGTCTCCACAAGT
rpp30_F_1148_CTGAAGGTGT	AATGATACGGCGACCACCGAGATCTACACCTGAAGGTGTGAGCGGCTGTCTCCACAAGT
rpp30_F_1149_AAGACACTGT	AATGATACGGCGACCACCGAGATCTACACAAGACACTGTGAGCGGCTGTCTCCACAAGT
rpp30_F_1150_CGAAGCGCAA	AATGATACGGCGACCACCGAGATCTACACCGAAGCGCAAGAGCGGCTGTCTCCACAAGT
rpp30_F_1151_AGAGATGTTC	AATGATACGGCGACCACCGAGATCTACACAGAGATGTTCGAGCGGCTGTCTCCACAAGT
rpp30_F_1152_TTAAGGTCGG	AATGATACGGCGACCACCGAGATCTACACTTAAGGTCGGGAGCGGCTGTCTCCACAAGT
rpp30_F_1153_AAGCTAGCAA	AATGATACGGCGACCACCGAGATCTACACAAGCTAGCAAGAGCGGCTGTCTCCACAAGT
rpp30_F_1154_GGCAGACATC	AATGATACGGCGACCACCGAGATCTACACGGCAGACATCGAGCGGCTGTCTCCACAAGT
rpp30_F_1155_TCTCGACATG	AATGATACGGCGACCACCGAGATCTACACTCTCGACATGGAGCGGCTGTCTCCACAAGT
rpp30_F_1156_GCAGTGATGA	AATGATACGGCGACCACCGAGATCTACACGCAGTGATGAGAGCGGCTGTCTCCACAAGT
rpp30_F_1157_AGAGGAGCTA	AATGATACGGCGACCACCGAGATCTACACAGAGGAGCTAGAGCGGCTGTCTCCACAAGT
rpp30_F_1158_CTGGAGGCTA	AATGATACGGCGACCACCGAGATCTACACCTGGAGGCTAGAGCGGCTGTCTCCACAAGT
rpp30_F_1159_AGGAGATTAG	AATGATACGGCGACCACCGAGATCTACACAGGAGATTAGGAGCGGCTGTCTCCACAAGT
rpp30_F_1160_GCTGTGAATT	AATGATACGGCGACCACCGAGATCTACACGCTGTGAATTGAGCGGCTGTCTCCACAAGT
rpp30_F_1161_CATTCGTTAC	AATGATACGGCGACCACCGAGATCTACACCATTCGTTACGAGCGGCTGTCTCCACAAGT
rpp30_F_1162_CCACAGCTCA	AATGATACGGCGACCACCGAGATCTACACCCACAGCTCAGAGCGGCTGTCTCCACAAGT
rpp30_F_1163_GCACTCAATT	AATGATACGGCGACCACCGAGATCTACACGCACTCAATTGAGCGGCTGTCTCCACAAGT
rpp30_F_1164_AGCTAAGACT	AATGATACGGCGACCACCGAGATCTACACAGCTAAGACTGAGCGGCTGTCTCCACAAGT
rpp30_F_1165_AGTCAGACTG	AATGATACGGCGACCACCGAGATCTACACAGTCAGACTGGAGCGGCTGTCTCCACAAGT
rpp30_F_1166_ACATGCTTGT	AATGATACGGCGACCACCGAGATCTACACACATGCTTGTGAGCGGCTGTCTCCACAAGT
rpp30_F_1167_AGATGGAACA	AATGATACGGCGACCACCGAGATCTACACAGATGGAACAGAGCGGCTGTCTCCACAAGT
rpp30_F_1168_AATGTAGACG	AATGATACGGCGACCACCGAGATCTACACAATGTAGACGGAGCGGCTGTCTCCACAAGT
rpp30_F_1169_CCTCGCCTTA	AATGATACGGCGACCACCGAGATCTACACCCTCGCCTTAGAGCGGCTGTCTCCACAAGT
rpp30_F_1170_CAGACTCGTT	AATGATACGGCGACCACCGAGATCTACACCAGACTCGTTGAGCGGCTGTCTCCACAAGT
rpp30_F_1171_GTATCGCTTG	AATGATACGGCGACCACCGAGATCTACACGTATCGCTTGGAGCGGCTGTCTCCACAAGT
rpp30_F_1172_GAATGGACTT	AATGATACGGCGACCACCGAGATCTACACGAATGGACTTGAGCGGCTGTCTCCACAAGT
rpp30_F_1173_TATACAACCG	AATGATACGGCGACCACCGAGATCTACACTATACAACCGGAGCGGCTGTCTCCACAAGT
rpp30_F_1174_CGGTTGGTGT	AATGATACGGCGACCACCGAGATCTACACCGGTTGGTGTGAGCGGCTGTCTCCACAAGT
rpp30_F_1175_CACGGACACA	AATGATACGGCGACCACCGAGATCTACACCACGGACACAGAGCGGCTGTCTCCACAAGT
rpp30_F_1176_ACACAAGGAG	AATGATACGGCGACCACCGAGATCTACACACACAAGGAGGAGCGGCTGTCTCCACAAGT
rpp30_F_1177_AGATTAGGAG	AATGATACGGCGACCACCGAGATCTACACAGATTAGGAGGAGCGGCTGTCTCCACAAGT
rpp30_F_1178_ATCAGAGGAG	AATGATACGGCGACCACCGAGATCTACACATCAGAGGAGGAGCGGCTGTCTCCACAAGT
rpp30_F_1179_CCGATAGGAG	AATGATACGGCGACCACCGAGATCTACACCCGATAGGAGGAGCGGCTGTCTCCACAAGT
rpp30_F_1180_CTAGAAGGAG	AATGATACGGCGACCACCGAGATCTACACCTAGAAGGAGGAGCGGCTGTCTCCACAAGT
rpp30_F_1181_ATAGATCTGC	AATGATACGGCGACCACCGAGATCTACACATAGATCTGCGAGCGGCTGTCTCCACAAGT
rpp30_F_1182_CCACGGATAC	AATGATACGGCGACCACCGAGATCTACACCCACGGATACGAGCGGCTGTCTCCACAAGT
rpp30_F_1183_TCGAGAACAG	AATGATACGGCGACCACCGAGATCTACACTCGAGAACAGGAGCGGCTGTCTCCACAAGT
rpp30_F_1184_CCAGACTACA	AATGATACGGCGACCACCGAGATCTACACCCAGACTACAGAGCGGCTGTCTCCACAAGT
rpp30_F_1185_CGAACCTACA	AATGATACGGCGACCACCGAGATCTACACCGAACCTACAGAGCGGCTGTCTCCACAAGT
rpp30_F_1186_CGACAGTACA	AATGATACGGCGACCACCGAGATCTACACCGACAGTACAGAGCGGCTGTCTCCACAAGT
rpp30_F_1187_GAGAGTTACA	AATGATACGGCGACCACCGAGATCTACACGAGAGTTACAGAGCGGCTGTCTCCACAAGT
rpp30_F_1188_ATGCGTGGAC	AATGATACGGCGACCACCGAGATCTACACATGCGTGGACGAGCGGCTGTCTCCACAAGT
rpp30_F_1189_AGATGCCTAG	AATGATACGGCGACCACCGAGATCTACACAGATGCCTAGGAGCGGCTGTCTCCACAAGT
rpp30_F_1190_GTGACACACT	AATGATACGGCGACCACCGAGATCTACACGTGACACACTGAGCGGCTGTCTCCACAAGT
rpp30_F_1191_CGCCTCTATA	AATGATACGGCGACCACCGAGATCTACACCGCCTCTATAGAGCGGCTGTCTCCACAAGT
rpp30_F_1192_TACTTCACAG	AATGATACGGCGACCACCGAGATCTACACTACTTCACAGGAGCGGCTGTCTCCACAAGT
rpp30_F_1193_TTCCACACAG	AATGATACGGCGACCACCGAGATCTACACTTCCACACAGGAGCGGCTGTCTCCACAAGT
rpp30_F_1194_GGACGGCTAT	AATGATACGGCGACCACCGAGATCTACACGGACGGCTATGAGCGGCTGTCTCCACAAGT
rpp30_F_1195_GGAATTGTCC	AATGATACGGCGACCACCGAGATCTACACGGAATTGTCCGAGCGGCTGTCTCCACAAGT
rpp30_F_1196_CAGAGCTTCG	AATGATACGGCGACCACCGAGATCTACACCAGAGCTTCGGAGCGGCTGTCTCCACAAGT
rpp30_F_1197_TCAAGCTTAG	AATGATACGGCGACCACCGAGATCTACACTCAAGCTTAGGAGCGGCTGTCTCCACAAGT
rpp30_F_1198_ATAGCAGTCA	AATGATACGGCGACCACCGAGATCTACACATAGCAGTCAGAGCGGCTGTCTCCACAAGT
rpp30_F_1199_AATCGGTTAC	AATGATACGGCGACCACCGAGATCTACACAATCGGTTACGAGCGGCTGTCTCCACAAGT
rpp30_F_1200_AGAACCTCAC	AATGATACGGCGACCACCGAGATCTACACAGAACCTCACGAGCGGCTGTCTCCACAAGT
rpp30_F_1201_CACCAAGATC	AATGATACGGCGACCACCGAGATCTACACCACCAAGATCGAGCGGCTGTCTCCACAAGT
rpp30_F_1202_CGAGCAGTTC	AATGATACGGCGACCACCGAGATCTACACCGAGCAGTTCGAGCGGCTGTCTCCACAAGT
rpp30_F_1203_CATAGACTCG	AATGATACGGCGACCACCGAGATCTACACCATAGACTCGGAGCGGCTGTCTCCACAAGT
rpp30_F_1204_CGTCAGAGAC	AATGATACGGCGACCACCGAGATCTACACCGTCAGAGACGAGCGGCTGTCTCCACAAGT
rpp30_F_1205_AGTGAAGCTG	AATGATACGGCGACCACCGAGATCTACACAGTGAAGCTGGAGCGGCTGTCTCCACAAGT
rpp30_F_1206_GCAACTGCCA	AATGATACGGCGACCACCGAGATCTACACGCAACTGCCAGAGCGGCTGTCTCCACAAGT
rpp30_F_1207_GGACGTCATG	AATGATACGGCGACCACCGAGATCTACACGGACGTCATGGAGCGGCTGTCTCCACAAGT
rpp30_F_1208_AACGAGAACC	AATGATACGGCGACCACCGAGATCTACACAACGAGAACCGAGCGGCTGTCTCCACAAGT
rpp30_F_1209_CTGATTGTGG	AATGATACGGCGACCACCGAGATCTACACCTGATTGTGGGAGCGGCTGTCTCCACAAGT
rpp30_F_1210_TTGAAGCTGA	AATGATACGGCGACCACCGAGATCTACACTTGAAGCTGAGAGCGGCTGTCTCCACAAGT
rpp30_F_1211_TGCACTCGAA	AATGATACGGCGACCACCGAGATCTACACTGCACTCGAAGAGCGGCTGTCTCCACAAGT
rpp30_F_1212_CAGAGGCTCA	AATGATACGGCGACCACCGAGATCTACACCAGAGGCTCAGAGCGGCTGTCTCCACAAGT
rpp30_F_1213_ACTACGGATC	AATGATACGGCGACCACCGAGATCTACACACTACGGATCGAGCGGCTGTCTCCACAAGT
rpp30_F_1214_GATAACGCCA	AATGATACGGCGACCACCGAGATCTACACGATAACGCCAGAGCGGCTGTCTCCACAAGT
rpp30_F_1215_GACTGAAGTC	AATGATACGGCGACCACCGAGATCTACACGACTGAAGTCGAGCGGCTGTCTCCACAAGT
rpp30_F_1216_AGGAGTCTCG	AATGATACGGCGACCACCGAGATCTACACAGGAGTCTCGGAGCGGCTGTCTCCACAAGT
rpp30_F_1217_CACAGTACTG	AATGATACGGCGACCACCGAGATCTACACCACAGTACTGGAGCGGCTGTCTCCACAAGT
rpp30_F_1218_ACCTGTAGTC	AATGATACGGCGACCACCGAGATCTACACACCTGTAGTCGAGCGGCTGTCTCCACAAGT
rpp30_F_1219_ACTCGTCGAA	AATGATACGGCGACCACCGAGATCTACACACTCGTCGAAGAGCGGCTGTCTCCACAAGT
rpp30_F_1220_CGATTCCTCG	AATGATACGGCGACCACCGAGATCTACACCGATTCCTCGGAGCGGCTGTCTCCACAAGT
rpp30_F_1221_ACACCACCAT	AATGATACGGCGACCACCGAGATCTACACACACCACCATGAGCGGCTGTCTCCACAAGT
rpp30_F_1222_CGAGACAGAT	AATGATACGGCGACCACCGAGATCTACACCGAGACAGATGAGCGGCTGTCTCCACAAGT
rpp30_F_1223_ATTGACACAG	AATGATACGGCGACCACCGAGATCTACACATTGACACAGGAGCGGCTGTCTCCACAAGT
rpp30_F_1224_AGGATGATCC	AATGATACGGCGACCACCGAGATCTACACAGGATGATCCGAGCGGCTGTCTCCACAAGT
rpp30_F_1225_CGTCAACGGA	AATGATACGGCGACCACCGAGATCTACACCGTCAACGGAGAGCGGCTGTCTCCACAAGT
rpp30_F_1226_CACACACCGT	AATGATACGGCGACCACCGAGATCTACACCACACACCGTGAGCGGCTGTCTCCACAAGT
rpp30_F_1227_TACACTGCAA	AATGATACGGCGACCACCGAGATCTACACTACACTGCAAGAGCGGCTGTCTCCACAAGT
rpp30_F_1228_AACAGACGAC	AATGATACGGCGACCACCGAGATCTACACAACAGACGACGAGCGGCTGTCTCCACAAGT
rpp30_F_1229_GCTATCCTAG	AATGATACGGCGACCACCGAGATCTACACGCTATCCTAGGAGCGGCTGTCTCCACAAGT
rpp30_F_1230_ATATCCAGTC	AATGATACGGCGACCACCGAGATCTACACATATCCAGTCGAGCGGCTGTCTCCACAAGT
rpp30_F_1231_CATTGTGACA	AATGATACGGCGACCACCGAGATCTACACCATTGTGACAGAGCGGCTGTCTCCACAAGT
rpp30_F_1232_GGATCTAACC	AATGATACGGCGACCACCGAGATCTACACGGATCTAACCGAGCGGCTGTCTCCACAAGT
rpp30_F_1233_AGGATCACGG	AATGATACGGCGACCACCGAGATCTACACAGGATCACGGGAGCGGCTGTCTCCACAAGT
rpp30_F_1234_GTAATAGAGC	AATGATACGGCGACCACCGAGATCTACACGTAATAGAGCGAGCGGCTGTCTCCACAAGT
rpp30_F_1235_ATAGGACCAC	AATGATACGGCGACCACCGAGATCTACACATAGGACCACGAGCGGCTGTCTCCACAAGT
rpp30_F_1236_GCCTATATAG	AATGATACGGCGACCACCGAGATCTACACGCCTATATAGGAGCGGCTGTCTCCACAAGT
rpp30_F_1237_AACGCGGACA	AATGATACGGCGACCACCGAGATCTACACAACGCGGACAGAGCGGCTGTCTCCACAAGT
rpp30_F_1238_ACGGAATAAC	AATGATACGGCGACCACCGAGATCTACACACGGAATAACGAGCGGCTGTCTCCACAAGT
rpp30_F_1239_AGAGAACGGC	AATGATACGGCGACCACCGAGATCTACACAGAGAACGGCGAGCGGCTGTCTCCACAAGT
rpp30_F_1240_CAACGAGTCA	AATGATACGGCGACCACCGAGATCTACACCAACGAGTCAGAGCGGCTGTCTCCACAAGT
rpp30_F_1241_ACGGCTTATC	AATGATACGGCGACCACCGAGATCTACACACGGCTTATCGAGCGGCTGTCTCCACAAGT
rpp30_F_1242_AGCCAAGTTA	AATGATACGGCGACCACCGAGATCTACACAGCCAAGTTAGAGCGGCTGTCTCCACAAGT
rpp30_F_1243_AGCTCCTTCG	AATGATACGGCGACCACCGAGATCTACACAGCTCCTTCGGAGCGGCTGTCTCCACAAGT
rpp30_F_1244_CCATGAACAG	AATGATACGGCGACCACCGAGATCTACACCCATGAACAGGAGCGGCTGTCTCCACAAGT
rpp30_F_1245_GATGGTGCTA	AATGATACGGCGACCACCGAGATCTACACGATGGTGCTAGAGCGGCTGTCTCCACAAGT
rpp30_F_1246_GAATTGCGGC	AATGATACGGCGACCACCGAGATCTACACGAATTGCGGCGAGCGGCTGTCTCCACAAGT
rpp30_F_1247_AAGAAGCCAC	AATGATACGGCGACCACCGAGATCTACACAAGAAGCCACGAGCGGCTGTCTCCACAAGT
rpp30_F_1248_GAGAGACTTC	AATGATACGGCGACCACCGAGATCTACACGAGAGACTTCGAGCGGCTGTCTCCACAAGT
rpp30_F_1249_AGTAAGAACC	AATGATACGGCGACCACCGAGATCTACACAGTAAGAACCGAGCGGCTGTCTCCACAAGT
rpp30_F_1250_AGTCGAAGTT	AATGATACGGCGACCACCGAGATCTACACAGTCGAAGTTGAGCGGCTGTCTCCACAAGT
rpp30_F_1251_AGGTGTAGCT	AATGATACGGCGACCACCGAGATCTACACAGGTGTAGCTGAGCGGCTGTCTCCACAAGT
rpp30_F_1252_AGCTTAAGGC	AATGATACGGCGACCACCGAGATCTACACAGCTTAAGGCGAGCGGCTGTCTCCACAAGT
rpp30_F_1253_GAAGGTACAG	AATGATACGGCGACCACCGAGATCTACACGAAGGTACAGGAGCGGCTGTCTCCACAAGT
rpp30_F_1254_CTAGAGGTCG	AATGATACGGCGACCACCGAGATCTACACCTAGAGGTCGGAGCGGCTGTCTCCACAAGT
rpp30_F_1255_AGCACGTATA	AATGATACGGCGACCACCGAGATCTACACAGCACGTATAGAGCGGCTGTCTCCACAAGT
rpp30_F_1256_AAGGCTCGGA	AATGATACGGCGACCACCGAGATCTACACAAGGCTCGGAGAGCGGCTGTCTCCACAAGT
rpp30_F_1257_ACAACGCCAG	AATGATACGGCGACCACCGAGATCTACACACAACGCCAGGAGCGGCTGTCTCCACAAGT
rpp30_F_1258_AAGCGCCTGA	AATGATACGGCGACCACCGAGATCTACACAAGCGCCTGAGAGCGGCTGTCTCCACAAGT
rpp30_F_1259_ACGCCAACAG	AATGATACGGCGACCACCGAGATCTACACACGCCAACAGGAGCGGCTGTCTCCACAAGT
rpp30_F_1260_ACGCCACGTA	AATGATACGGCGACCACCGAGATCTACACACGCCACGTAGAGCGGCTGTCTCCACAAGT
rpp30_F_1261_CAAGGACGAC	AATGATACGGCGACCACCGAGATCTACACCAAGGACGACGAGCGGCTGTCTCCACAAGT
rpp30_F_1262_ATGCTCACAG	AATGATACGGCGACCACCGAGATCTACACATGCTCACAGGAGCGGCTGTCTCCACAAGT
rpp30_F_1263_AATTGACTGC	AATGATACGGCGACCACCGAGATCTACACAATTGACTGCGAGCGGCTGTCTCCACAAGT
rpp30_F_1264_AGTGAACACC	AATGATACGGCGACCACCGAGATCTACACAGTGAACACCGAGCGGCTGTCTCCACAAGT
rpp30_F_1265_AGTGAGGAAC	AATGATACGGCGACCACCGAGATCTACACAGTGAGGAACGAGCGGCTGTCTCCACAAGT
rpp30_F_1266_ACTGCTTACA	AATGATACGGCGACCACCGAGATCTACACACTGCTTACAGAGCGGCTGTCTCCACAAGT
rpp30_F_1267_ATGCACATGG	AATGATACGGCGACCACCGAGATCTACACATGCACATGGGAGCGGCTGTCTCCACAAGT
rpp30_F_1268_GAACACTCGG	AATGATACGGCGACCACCGAGATCTACACGAACACTCGGGAGCGGCTGTCTCCACAAGT
rpp30_F_1269_TACTACTCGG	AATGATACGGCGACCACCGAGATCTACACTACTACTCGGGAGCGGCTGTCTCCACAAGT
rpp30_F_1270_ACGGATATGC	AATGATACGGCGACCACCGAGATCTACACACGGATATGCGAGCGGCTGTCTCCACAAGT
rpp30_F_1271_GGACAGGTTG	AATGATACGGCGACCACCGAGATCTACACGGACAGGTTGGAGCGGCTGTCTCCACAAGT
rpp30_F_1272_CAGAAGCAGA	AATGATACGGCGACCACCGAGATCTACACCAGAAGCAGAGAGCGGCTGTCTCCACAAGT
rpp30_F_1273_AACCGAGGTT	AATGATACGGCGACCACCGAGATCTACACAACCGAGGTTGAGCGGCTGTCTCCACAAGT
rpp30_F_1274_CCATGGTACC	AATGATACGGCGACCACCGAGATCTACACCCATGGTACCGAGCGGCTGTCTCCACAAGT
rpp30_F_1275_ATAACGGCGG	AATGATACGGCGACCACCGAGATCTACACATAACGGCGGGAGCGGCTGTCTCCACAAGT
rpp30_F_1276_CATTAGCCAG	AATGATACGGCGACCACCGAGATCTACACCATTAGCCAGGAGCGGCTGTCTCCACAAGT
rpp30_F_1277_CTCTAATGGC	AATGATACGGCGACCACCGAGATCTACACCTCTAATGGCGAGCGGCTGTCTCCACAAGT
rpp30_F_1278_ACGATGAGCT	AATGATACGGCGACCACCGAGATCTACACACGATGAGCTGAGCGGCTGTCTCCACAAGT
rpp30_F_1279_AAGACCGAGC	AATGATACGGCGACCACCGAGATCTACACAAGACCGAGCGAGCGGCTGTCTCCACAAGT
rpp30_F_1280_TGCACTGTAT	AATGATACGGCGACCACCGAGATCTACACTGCACTGTATGAGCGGCTGTCTCCACAAGT
rpp30_F_1281_AGCACATCAA	AATGATACGGCGACCACCGAGATCTACACAGCACATCAAGAGCGGCTGTCTCCACAAGT
rpp30_F_1282_ACTAGGCTCG	AATGATACGGCGACCACCGAGATCTACACACTAGGCTCGGAGCGGCTGTCTCCACAAGT
rpp30_F_1283_GCGCAGTGAT	AATGATACGGCGACCACCGAGATCTACACGCGCAGTGATGAGCGGCTGTCTCCACAAGT
rpp30_F_1284_CGGATATACG	AATGATACGGCGACCACCGAGATCTACACCGGATATACGGAGCGGCTGTCTCCACAAGT
rpp30_F_1285_GACAAGGTTC	AATGATACGGCGACCACCGAGATCTACACGACAAGGTTCGAGCGGCTGTCTCCACAAGT
rpp30_F_1286_GATCACATGA	AATGATACGGCGACCACCGAGATCTACACGATCACATGAGAGCGGCTGTCTCCACAAGT
rpp30_F_1287_GTCAAGCTCG	AATGATACGGCGACCACCGAGATCTACACGTCAAGCTCGGAGCGGCTGTCTCCACAAGT
rpp30_F_1288_CCTTCGAAGA	AATGATACGGCGACCACCGAGATCTACACCCTTCGAAGAGAGCGGCTGTCTCCACAAGT
rpp30_F_1289_CAAGCGTACC	AATGATACGGCGACCACCGAGATCTACACCAAGCGTACCGAGCGGCTGTCTCCACAAGT
rpp30_F_1290_CCTTCAGGCT	AATGATACGGCGACCACCGAGATCTACACCCTTCAGGCTGAGCGGCTGTCTCCACAAGT
rpp30_F_1291_ACGCCTGGTT	AATGATACGGCGACCACCGAGATCTACACACGCCTGGTTGAGCGGCTGTCTCCACAAGT
rpp30_F_1292_ATATCGGTCG	AATGATACGGCGACCACCGAGATCTACACATATCGGTCGGAGCGGCTGTCTCCACAAGT
rpp30_F_1293_CATCACGCTA	AATGATACGGCGACCACCGAGATCTACACCATCACGCTAGAGCGGCTGTCTCCACAAGT
rpp30_F_1294_GAAGTCTTCG	AATGATACGGCGACCACCGAGATCTACACGAAGTCTTCGGAGCGGCTGTCTCCACAAGT
rpp30_F_1295_AGAGTGGCTG	AATGATACGGCGACCACCGAGATCTACACAGAGTGGCTGGAGCGGCTGTCTCCACAAGT
rpp30_F_1296_CAGGAGCATC	AATGATACGGCGACCACCGAGATCTACACCAGGAGCATCGAGCGGCTGTCTCCACAAGT
rpp30_F_1297_GCCAGACGTT	AATGATACGGCGACCACCGAGATCTACACGCCAGACGTTGAGCGGCTGTCTCCACAAGT
rpp30_F_1298_CATGGCAACC	AATGATACGGCGACCACCGAGATCTACACCATGGCAACCGAGCGGCTGTCTCCACAAGT
rpp30_F_1299_ACCAGGTTCC	AATGATACGGCGACCACCGAGATCTACACACCAGGTTCCGAGCGGCTGTCTCCACAAGT
rpp30_F_1300_AGCCTGAGAC	AATGATACGGCGACCACCGAGATCTACACAGCCTGAGACGAGCGGCTGTCTCCACAAGT
rpp30_F_1301_ACAGCCAGAG	AATGATACGGCGACCACCGAGATCTACACACAGCCAGAGGAGCGGCTGTCTCCACAAGT
rpp30_F_1302_AGCATGTACC	AATGATACGGCGACCACCGAGATCTACACAGCATGTACCGAGCGGCTGTCTCCACAAGT
rpp30_F_1303_CTAGACAAGC	AATGATACGGCGACCACCGAGATCTACACCTAGACAAGCGAGCGGCTGTCTCCACAAGT
rpp30_F_1304_AGAGATGACA	AATGATACGGCGACCACCGAGATCTACACAGAGATGACAGAGCGGCTGTCTCCACAAGT
rpp30_F_1305_ATGGTTAGTC	AATGATACGGCGACCACCGAGATCTACACATGGTTAGTCGAGCGGCTGTCTCCACAAGT
rpp30_F_1306_AGTACTGAAC	AATGATACGGCGACCACCGAGATCTACACAGTACTGAACGAGCGGCTGTCTCCACAAGT
rpp30_F_1307_CTCAGAGTCA	AATGATACGGCGACCACCGAGATCTACACCTCAGAGTCAGAGCGGCTGTCTCCACAAGT
rpp30_F_1308_AACAAGACTG	AATGATACGGCGACCACCGAGATCTACACAACAAGACTGGAGCGGCTGTCTCCACAAGT
rpp30_F_1309_GTTATGCTCC	AATGATACGGCGACCACCGAGATCTACACGTTATGCTCCGAGCGGCTGTCTCCACAAGT
rpp30_F_1310_TACGTGCTCG	AATGATACGGCGACCACCGAGATCTACACTACGTGCTCGGAGCGGCTGTCTCCACAAGT
rpp30_F_1311_TCGATAGACT	AATGATACGGCGACCACCGAGATCTACACTCGATAGACTGAGCGGCTGTCTCCACAAGT
rpp30_F_1312_CATAATCAGC	AATGATACGGCGACCACCGAGATCTACACCATAATCAGCGAGCGGCTGTCTCCACAAGT
rpp30_F_1313_ATCTATGGAG	AATGATACGGCGACCACCGAGATCTACACATCTATGGAGGAGCGGCTGTCTCCACAAGT
rpp30_F_1314_GATAATGGAG	AATGATACGGCGACCACCGAGATCTACACGATAATGGAGGAGCGGCTGTCTCCACAAGT
rpp30_F_1315_CATGACGAGC	AATGATACGGCGACCACCGAGATCTACACCATGACGAGCGAGCGGCTGTCTCCACAAGT
rpp30_F_1316_CCGTAGCAAC	AATGATACGGCGACCACCGAGATCTACACCCGTAGCAACGAGCGGCTGTCTCCACAAGT
rpp30_F_1317_CAAGAATGGC	AATGATACGGCGACCACCGAGATCTACACCAAGAATGGCGAGCGGCTGTCTCCACAAGT
rpp30_F_1318_ATGATGGACC	AATGATACGGCGACCACCGAGATCTACACATGATGGACCGAGCGGCTGTCTCCACAAGT
rpp30_F_1319_ACTCGTACTT	AATGATACGGCGACCACCGAGATCTACACACTCGTACTTGAGCGGCTGTCTCCACAAGT
rpp30_F_1320_CGAACAGCGT	AATGATACGGCGACCACCGAGATCTACACCGAACAGCGTGAGCGGCTGTCTCCACAAGT
rpp30_F_1321_ACATCTGACC	AATGATACGGCGACCACCGAGATCTACACACATCTGACCGAGCGGCTGTCTCCACAAGT
rpp30_F_1322_AGTTACGACC	AATGATACGGCGACCACCGAGATCTACACAGTTACGACCGAGCGGCTGTCTCCACAAGT
rpp30_F_1323_AGGATCAGTC	AATGATACGGCGACCACCGAGATCTACACAGGATCAGTCGAGCGGCTGTCTCCACAAGT
rpp30_F_1324_GCCTGTACAC	AATGATACGGCGACCACCGAGATCTACACGCCTGTACACGAGCGGCTGTCTCCACAAGT
rpp30_F_1325_CATCCTCGTG	AATGATACGGCGACCACCGAGATCTACACCATCCTCGTGGAGCGGCTGTCTCCACAAGT
rpp30_F_1326_AACCAGCCTA	AATGATACGGCGACCACCGAGATCTACACAACCAGCCTAGAGCGGCTGTCTCCACAAGT
rpp30_F_1327_AAGCATTAGC	AATGATACGGCGACCACCGAGATCTACACAAGCATTAGCGAGCGGCTGTCTCCACAAGT
rpp30_F_1328_CAGACCAGTC	AATGATACGGCGACCACCGAGATCTACACCAGACCAGTCGAGCGGCTGTCTCCACAAGT
rpp30_F_1329_AGGACGCAAT	AATGATACGGCGACCACCGAGATCTACACAGGACGCAATGAGCGGCTGTCTCCACAAGT
rpp30_F_1330_CCGGAGAACA	AATGATACGGCGACCACCGAGATCTACACCCGGAGAACAGAGCGGCTGTCTCCACAAGT
rpp30_F_1331_AGCGGTTACA	AATGATACGGCGACCACCGAGATCTACACAGCGGTTACAGAGCGGCTGTCTCCACAAGT
rpp30_F_1332_AGCTTCTACA	AATGATACGGCGACCACCGAGATCTACACAGCTTCTACAGAGCGGCTGTCTCCACAAGT
rpp30_F_1333_AAGGCGACTG	AATGATACGGCGACCACCGAGATCTACACAAGGCGACTGGAGCGGCTGTCTCCACAAGT
rpp30_F_1334_ACGTCTACGT	AATGATACGGCGACCACCGAGATCTACACACGTCTACGTGAGCGGCTGTCTCCACAAGT
rpp30_F_1335_GCCTACTTGT	AATGATACGGCGACCACCGAGATCTACACGCCTACTTGTGAGCGGCTGTCTCCACAAGT
rpp30_F_1336_CAGGAAGACC	AATGATACGGCGACCACCGAGATCTACACCAGGAAGACCGAGCGGCTGTCTCCACAAGT
rpp30_F_1337_CTATACGACC	AATGATACGGCGACCACCGAGATCTACACCTATACGACCGAGCGGCTGTCTCCACAAGT
rpp30_F_1338_AACTCTACAG	AATGATACGGCGACCACCGAGATCTACACAACTCTACAGGAGCGGCTGTCTCCACAAGT
rpp30_F_1339_AGGCATACAG	AATGATACGGCGACCACCGAGATCTACACAGGCATACAGGAGCGGCTGTCTCCACAAGT
rpp30_F_1340_CCTAGTACAG	AATGATACGGCGACCACCGAGATCTACACCCTAGTACAGGAGCGGCTGTCTCCACAAGT
rpp30_F_1341_ACAGTGCCAC	AATGATACGGCGACCACCGAGATCTACACACAGTGCCACGAGCGGCTGTCTCCACAAGT
rpp30_F_1342_ATAGCGGCAA	AATGATACGGCGACCACCGAGATCTACACATAGCGGCAAGAGCGGCTGTCTCCACAAGT
rpp30_F_1343_ACAACCTACC	AATGATACGGCGACCACCGAGATCTACACACAACCTACCGAGCGGCTGTCTCCACAAGT
rpp30_F_1344_ACGAATTACC	AATGATACGGCGACCACCGAGATCTACACACGAATTACCGAGCGGCTGTCTCCACAAGT
rpp30_F_1345_ACTCGATACC	AATGATACGGCGACCACCGAGATCTACACACTCGATACCGAGCGGCTGTCTCCACAAGT
rpp30_F_1346_AGTCCGTACC	AATGATACGGCGACCACCGAGATCTACACAGTCCGTACCGAGCGGCTGTCTCCACAAGT
rpp30_F_1347_AGTGCATATC	AATGATACGGCGACCACCGAGATCTACACAGTGCATATCGAGCGGCTGTCTCCACAAGT
rpp30_F_1348_AATCTCACTC	AATGATACGGCGACCACCGAGATCTACACAATCTCACTCGAGCGGCTGTCTCCACAAGT
rpp30_F_1349_CATGAAGTAC	AATGATACGGCGACCACCGAGATCTACACCATGAAGTACGAGCGGCTGTCTCCACAAGT
rpp30_F_1350_AATCAGCTTC	AATGATACGGCGACCACCGAGATCTACACAATCAGCTTCGAGCGGCTGTCTCCACAAGT
rpp30_F_1351_CGCCATTAGC	AATGATACGGCGACCACCGAGATCTACACCGCCATTAGCGAGCGGCTGTCTCCACAAGT
rpp30_F_1352_AGCAAGCTAT	AATGATACGGCGACCACCGAGATCTACACAGCAAGCTATGAGCGGCTGTCTCCACAAGT
rpp30_F_1353_AACCACCGTG	AATGATACGGCGACCACCGAGATCTACACAACCACCGTGGAGCGGCTGTCTCCACAAGT
rpp30_F_1354_CAGGAGAGAA	AATGATACGGCGACCACCGAGATCTACACCAGGAGAGAAGAGCGGCTGTCTCCACAAGT
rpp30_F_1355_CTAAGCCATC	AATGATACGGCGACCACCGAGATCTACACCTAAGCCATCGAGCGGCTGTCTCCACAAGT
rpp30_F_1356_AACAAGCTCC	AATGATACGGCGACCACCGAGATCTACACAACAAGCTCCGAGCGGCTGTCTCCACAAGT
rpp30_F_1357_AAGCCGGAAC	AATGATACGGCGACCACCGAGATCTACACAAGCCGGAACGAGCGGCTGTCTCCACAAGT
rpp30_F_1358_GATGTCGTTG	AATGATACGGCGACCACCGAGATCTACACGATGTCGTTGGAGCGGCTGTCTCCACAAGT
rpp30_F_1359_CGTGCTACAG	AATGATACGGCGACCACCGAGATCTACACCGTGCTACAGGAGCGGCTGTCTCCACAAGT
rpp30_F_1360_CAGTCACTCG	AATGATACGGCGACCACCGAGATCTACACCAGTCACTCGGAGCGGCTGTCTCCACAAGT
rpp30_F_1361_TACCGACTCG	AATGATACGGCGACCACCGAGATCTACACTACCGACTCGGAGCGGCTGTCTCCACAAGT
rpp30_F_1362_AGCTTAACCG	AATGATACGGCGACCACCGAGATCTACACAGCTTAACCGGAGCGGCTGTCTCCACAAGT
rpp30_F_1363_AGGTCAGAAC	AATGATACGGCGACCACCGAGATCTACACAGGTCAGAACGAGCGGCTGTCTCCACAAGT
rpp30_F_1364_AGAATGCTGC	AATGATACGGCGACCACCGAGATCTACACAGAATGCTGCGAGCGGCTGTCTCCACAAGT
rpp30_F_1365_ACCGGACATC	AATGATACGGCGACCACCGAGATCTACACACCGGACATCGAGCGGCTGTCTCCACAAGT
rpp30_F_1366_ACGCGGTAAC	AATGATACGGCGACCACCGAGATCTACACACGCGGTAACGAGCGGCTGTCTCCACAAGT
rpp30_F_1367_ACCGTTAATC	AATGATACGGCGACCACCGAGATCTACACACCGTTAATCGAGCGGCTGTCTCCACAAGT
rpp30_F_1368_CCACTGAAGC	AATGATACGGCGACCACCGAGATCTACACCCACTGAAGCGAGCGGCTGTCTCCACAAGT
rpp30_F_1369_GCTAGTGGTT	AATGATACGGCGACCACCGAGATCTACACGCTAGTGGTTGAGCGGCTGTCTCCACAAGT
rpp30_F_1370_AGACAATACC	AATGATACGGCGACCACCGAGATCTACACAGACAATACCGAGCGGCTGTCTCCACAAGT
rpp30_F_1371_ATCGACGGAC	AATGATACGGCGACCACCGAGATCTACACATCGACGGACGAGCGGCTGTCTCCACAAGT
rpp30_F_1372_ACGGTCTGAC	AATGATACGGCGACCACCGAGATCTACACACGGTCTGACGAGCGGCTGTCTCCACAAGT
rpp30_F_1373_TGCGCTGCTA	AATGATACGGCGACCACCGAGATCTACACTGCGCTGCTAGAGCGGCTGTCTCCACAAGT
rpp30_F_1374_GTGAGGTCGA	AATGATACGGCGACCACCGAGATCTACACGTGAGGTCGAGAGCGGCTGTCTCCACAAGT
rpp30_F_1375_AAGAGGCTGC	AATGATACGGCGACCACCGAGATCTACACAAGAGGCTGCGAGCGGCTGTCTCCACAAGT
rpp30_F_1376_AGCAAGATGC	AATGATACGGCGACCACCGAGATCTACACAGCAAGATGCGAGCGGCTGTCTCCACAAGT
rpp30_F_1377_ACACGAGTAC	AATGATACGGCGACCACCGAGATCTACACACACGAGTACGAGCGGCTGTCTCCACAAGT
rpp30_F_1378_CACAACGACC	AATGATACGGCGACCACCGAGATCTACACCACAACGACCGAGCGGCTGTCTCCACAAGT
rpp30_F_1379_CATCAATACC	AATGATACGGCGACCACCGAGATCTACACCATCAATACCGAGCGGCTGTCTCCACAAGT
rpp30_F_1380_CGAGAATTCC	AATGATACGGCGACCACCGAGATCTACACCGAGAATTCCGAGCGGCTGTCTCCACAAGT
rpp30_F_1381_CGAGGTTACC	AATGATACGGCGACCACCGAGATCTACACCGAGGTTACCGAGCGGCTGTCTCCACAAGT
rpp30_F_1382_CTTAGGTACC	AATGATACGGCGACCACCGAGATCTACACCTTAGGTACCGAGCGGCTGTCTCCACAAGT
rpp30_F_1383_GATATAGACC	AATGATACGGCGACCACCGAGATCTACACGATATAGACCGAGCGGCTGTCTCCACAAGT
rpp30_F_1384_GCAGAACTCC	AATGATACGGCGACCACCGAGATCTACACGCAGAACTCCGAGCGGCTGTCTCCACAAGT
rpp30_F_1385_ACTCGCCTAG	AATGATACGGCGACCACCGAGATCTACACACTCGCCTAGGAGCGGCTGTCTCCACAAGT
rpp30_F_1386_AATTCGCCTG	AATGATACGGCGACCACCGAGATCTACACAATTCGCCTGGAGCGGCTGTCTCCACAAGT
rpp30_F_1387_CATTAGAACC	AATGATACGGCGACCACCGAGATCTACACCATTAGAACCGAGCGGCTGTCTCCACAAGT
rpp30_F_1388_AAGATACACC	AATGATACGGCGACCACCGAGATCTACACAAGATACACCGAGCGGCTGTCTCCACAAGT
rpp30_F_1389_ACCTTACACC	AATGATACGGCGACCACCGAGATCTACACACCTTACACCGAGCGGCTGTCTCCACAAGT
rpp30_F_1390_ACGCTGCTTC	AATGATACGGCGACCACCGAGATCTACACACGCTGCTTCGAGCGGCTGTCTCCACAAGT
rpp30_F_1391_AACGAATCAC	AATGATACGGCGACCACCGAGATCTACACAACGAATCACGAGCGGCTGTCTCCACAAGT
rpp30_F_1392_TAGATCGCAA	AATGATACGGCGACCACCGAGATCTACACTAGATCGCAAGAGCGGCTGTCTCCACAAGT
rpp30_F_1393_AACATCCTAG	AATGATACGGCGACCACCGAGATCTACACAACATCCTAGGAGCGGCTGTCTCCACAAGT
rpp30_F_1394_CACATGCTGC	AATGATACGGCGACCACCGAGATCTACACCACATGCTGCGAGCGGCTGTCTCCACAAGT
rpp30_F_1395_AGGCACTCTG	AATGATACGGCGACCACCGAGATCTACACAGGCACTCTGGAGCGGCTGTCTCCACAAGT
rpp30_F_1396_AACTCCTCAC	AATGATACGGCGACCACCGAGATCTACACAACTCCTCACGAGCGGCTGTCTCCACAAGT
rpp30_F_1397_AAGGTGAATC	AATGATACGGCGACCACCGAGATCTACACAAGGTGAATCGAGCGGCTGTCTCCACAAGT
rpp30_F_1398_AACCAGTCCG	AATGATACGGCGACCACCGAGATCTACACAACCAGTCCGGAGCGGCTGTCTCCACAAGT
rpp30_F_1399_GAGGACACAG	AATGATACGGCGACCACCGAGATCTACACGAGGACACAGGAGCGGCTGTCTCCACAAGT
rpp30_F_1400_AGAAGACTCC	AATGATACGGCGACCACCGAGATCTACACAGAAGACTCCGAGCGGCTGTCTCCACAAGT
rpp30_F_1401_ATCCGAGATC	AATGATACGGCGACCACCGAGATCTACACATCCGAGATCGAGCGGCTGTCTCCACAAGT
rpp30_F_1402_CTTAAGCCGG	AATGATACGGCGACCACCGAGATCTACACCTTAAGCCGGGAGCGGCTGTCTCCACAAGT
rpp30_F_1403_GAACAGTATC	AATGATACGGCGACCACCGAGATCTACACGAACAGTATCGAGCGGCTGTCTCCACAAGT
rpp30_F_1404_AAGAGCGGCT	AATGATACGGCGACCACCGAGATCTACACAAGAGCGGCTGAGCGGCTGTCTCCACAAGT
rpp30_F_1405_TAGTGAGACC	AATGATACGGCGACCACCGAGATCTACACTAGTGAGACCGAGCGGCTGTCTCCACAAGT
rpp30_F_1406_ATACCGAGCT	AATGATACGGCGACCACCGAGATCTACACATACCGAGCTGAGCGGCTGTCTCCACAAGT
rpp30_F_1407_AATACCGACA	AATGATACGGCGACCACCGAGATCTACACAATACCGACAGAGCGGCTGTCTCCACAAGT
rpp30_F_1408_CAACACGACA	AATGATACGGCGACCACCGAGATCTACACCAACACGACAGAGCGGCTGTCTCCACAAGT
rpp30_F_1409_CTAGTAAGAC	AATGATACGGCGACCACCGAGATCTACACCTAGTAAGACGAGCGGCTGTCTCCACAAGT
rpp30_F_1410_CCGGATTAGC	AATGATACGGCGACCACCGAGATCTACACCCGGATTAGCGAGCGGCTGTCTCCACAAGT
rpp30_F_1411_CTACGTTCTC	AATGATACGGCGACCACCGAGATCTACACCTACGTTCTCGAGCGGCTGTCTCCACAAGT
rpp30_F_1412_CCTTCTTACC	AATGATACGGCGACCACCGAGATCTACACCCTTCTTACCGAGCGGCTGTCTCCACAAGT
rpp30_F_1413_GGCACAATCC	AATGATACGGCGACCACCGAGATCTACACGGCACAATCCGAGCGGCTGTCTCCACAAGT
rpp30_F_1414_GTTAGCCACC	AATGATACGGCGACCACCGAGATCTACACGTTAGCCACCGAGCGGCTGTCTCCACAAGT
rpp30_F_1415_CACTGCATCC	AATGATACGGCGACCACCGAGATCTACACCACTGCATCCGAGCGGCTGTCTCCACAAGT
rpp30_F_1416_AGGACTTAGC	AATGATACGGCGACCACCGAGATCTACACAGGACTTAGCGAGCGGCTGTCTCCACAAGT
rpp30_F_1417_AGTTCTCAGC	AATGATACGGCGACCACCGAGATCTACACAGTTCTCAGCGAGCGGCTGTCTCCACAAGT
rpp30_F_1418_ACATTGAGAC	AATGATACGGCGACCACCGAGATCTACACACATTGAGACGAGCGGCTGTCTCCACAAGT
rpp30_F_1419_ATAACGAGAC	AATGATACGGCGACCACCGAGATCTACACATAACGAGACGAGCGGCTGTCTCCACAAGT
rpp30_F_1420_AACGTCCGAC	AATGATACGGCGACCACCGAGATCTACACAACGTCCGACGAGCGGCTGTCTCCACAAGT
rpp30_F_1421_AGAGAATCTC	AATGATACGGCGACCACCGAGATCTACACAGAGAATCTCGAGCGGCTGTCTCCACAAGT
rpp30_F_1422_ATGAGTCAGC	AATGATACGGCGACCACCGAGATCTACACATGAGTCAGCGAGCGGCTGTCTCCACAAGT
rpp30_F_1423_GAATGTCAGC	AATGATACGGCGACCACCGAGATCTACACGAATGTCAGCGAGCGGCTGTCTCCACAAGT
rpp30_F_1424_GAGTACAAGC	AATGATACGGCGACCACCGAGATCTACACGAGTACAAGCGAGCGGCTGTCTCCACAAGT
rpp30_F_1425_GAGTCTGAGC	AATGATACGGCGACCACCGAGATCTACACGAGTCTGAGCGAGCGGCTGTCTCCACAAGT
rpp30_F_1426_AGTATGGAGC	AATGATACGGCGACCACCGAGATCTACACAGTATGGAGCGAGCGGCTGTCTCCACAAGT
rpp30_F_1427_GAACGCCAAT	AATGATACGGCGACCACCGAGATCTACACGAACGCCAATGAGCGGCTGTCTCCACAAGT
rpp30_F_1428_TAACGCCACG	AATGATACGGCGACCACCGAGATCTACACTAACGCCACGGAGCGGCTGTCTCCACAAGT
rpp30_F_1429_TTGAGACGTC	AATGATACGGCGACCACCGAGATCTACACTTGAGACGTCGAGCGGCTGTCTCCACAAGT
rpp30_F_1430_ATCTCAAGTG	AATGATACGGCGACCACCGAGATCTACACATCTCAAGTGGAGCGGCTGTCTCCACAAGT
rpp30_F_1431_ACACTATCAC	AATGATACGGCGACCACCGAGATCTACACACACTATCACGAGCGGCTGTCTCCACAAGT
rpp30_F_1432_GTCATGAATC	AATGATACGGCGACCACCGAGATCTACACGTCATGAATCGAGCGGCTGTCTCCACAAGT
rpp30_F_1433_CGACCTAGAC	AATGATACGGCGACCACCGAGATCTACACCGACCTAGACGAGCGGCTGTCTCCACAAGT
rpp30_F_1434_CAGTCCTCAT	AATGATACGGCGACCACCGAGATCTACACCAGTCCTCATGAGCGGCTGTCTCCACAAGT
rpp30_F_1435_CCTTAACAGC	AATGATACGGCGACCACCGAGATCTACACCCTTAACAGCGAGCGGCTGTCTCCACAAGT
rpp30_F_1436_ACTACTAGAC	AATGATACGGCGACCACCGAGATCTACACACTACTAGACGAGCGGCTGTCTCCACAAGT
rpp30_F_1437_AGGAACTGAC	AATGATACGGCGACCACCGAGATCTACACAGGAACTGACGAGCGGCTGTCTCCACAAGT
rpp30_F_1438_AAGCACGATC	AATGATACGGCGACCACCGAGATCTACACAAGCACGATCGAGCGGCTGTCTCCACAAGT
rpp30_F_1439_TATGGCACGT	AATGATACGGCGACCACCGAGATCTACACTATGGCACGTGAGCGGCTGTCTCCACAAGT
rpp30_F_1440_ACATAGGACA	AATGATACGGCGACCACCGAGATCTACACACATAGGACAGAGCGGCTGTCTCCACAAGT
rpp30_F_1441_CGTTAGGACA	AATGATACGGCGACCACCGAGATCTACACCGTTAGGACAGAGCGGCTGTCTCCACAAGT
rpp30_F_1442_GATGAGGACA	AATGATACGGCGACCACCGAGATCTACACGATGAGGACAGAGCGGCTGTCTCCACAAGT
rpp30_F_1443_GCGATGGACA	AATGATACGGCGACCACCGAGATCTACACGCGATGGACAGAGCGGCTGTCTCCACAAGT
rpp30_F_1444_GAAGAGCAAC	AATGATACGGCGACCACCGAGATCTACACGAAGAGCAACGAGCGGCTGTCTCCACAAGT
rpp30_F_1445_ATCCACAGTC	AATGATACGGCGACCACCGAGATCTACACATCCACAGTCGAGCGGCTGTCTCCACAAGT
rpp30_F_1446_ACTGCGAGCT	AATGATACGGCGACCACCGAGATCTACACACTGCGAGCTGAGCGGCTGTCTCCACAAGT
rpp30_F_1447_ACTTGGTCGG	AATGATACGGCGACCACCGAGATCTACACACTTGGTCGGGAGCGGCTGTCTCCACAAGT
rpp30_F_1448_AAGGTCGTGC	AATGATACGGCGACCACCGAGATCTACACAAGGTCGTGCGAGCGGCTGTCTCCACAAGT
rpp30_F_1449_AAGCTAGGTC	AATGATACGGCGACCACCGAGATCTACACAAGCTAGGTCGAGCGGCTGTCTCCACAAGT
rpp30_F_1450_GTTACTGACA	AATGATACGGCGACCACCGAGATCTACACGTTACTGACAGAGCGGCTGTCTCCACAAGT
rpp30_F_1451_ACGCATTCTC	AATGATACGGCGACCACCGAGATCTACACACGCATTCTCGAGCGGCTGTCTCCACAAGT
rpp30_F_1452_GCTGCCATAG	AATGATACGGCGACCACCGAGATCTACACGCTGCCATAGGAGCGGCTGTCTCCACAAGT
rpp30_F_1453_GCTGTTATCC	AATGATACGGCGACCACCGAGATCTACACGCTGTTATCCGAGCGGCTGTCTCCACAAGT
rpp30_F_1454_CGCGCCAATT	AATGATACGGCGACCACCGAGATCTACACCGCGCCAATTGAGCGGCTGTCTCCACAAGT
rpp30_F_1455_ACCAGGTGAG	AATGATACGGCGACCACCGAGATCTACACACCAGGTGAGGAGCGGCTGTCTCCACAAGT
rpp30_F_1456_CAGGCACTAC	AATGATACGGCGACCACCGAGATCTACACCAGGCACTACGAGCGGCTGTCTCCACAAGT
rpp30_F_1457_GCGCTAATTG	AATGATACGGCGACCACCGAGATCTACACGCGCTAATTGGAGCGGCTGTCTCCACAAGT
rpp30_F_1458_AGTGCAAGGC	AATGATACGGCGACCACCGAGATCTACACAGTGCAAGGCGAGCGGCTGTCTCCACAAGT
rpp30_F_1459_TAAGCACGGC	AATGATACGGCGACCACCGAGATCTACACTAAGCACGGCGAGCGGCTGTCTCCACAAGT
rpp30_F_1460_ACTCCAGACA	AATGATACGGCGACCACCGAGATCTACACACTCCAGACAGAGCGGCTGTCTCCACAAGT
rpp30_F_1461_CAGTCAGACA	AATGATACGGCGACCACCGAGATCTACACCAGTCAGACAGAGCGGCTGTCTCCACAAGT
rpp30_F_1462_TAACCAGACA	AATGATACGGCGACCACCGAGATCTACACTAACCAGACAGAGCGGCTGTCTCCACAAGT
rpp30_F_1463_CACAGCAATC	AATGATACGGCGACCACCGAGATCTACACCACAGCAATCGAGCGGCTGTCTCCACAAGT
rpp30_F_1464_AAGTCAGCTA	AATGATACGGCGACCACCGAGATCTACACAAGTCAGCTAGAGCGGCTGTCTCCACAAGT
rpp30_F_1465_AACAACACAC	AATGATACGGCGACCACCGAGATCTACACAACAACACACGAGCGGCTGTCTCCACAAGT
rpp30_F_1466_ACCGTAACAC	AATGATACGGCGACCACCGAGATCTACACACCGTAACACGAGCGGCTGTCTCCACAAGT
rpp30_F_1467_ATAATCCACC	AATGATACGGCGACCACCGAGATCTACACATAATCCACCGAGCGGCTGTCTCCACAAGT
rpp30_F_1468_CCTAACCACC	AATGATACGGCGACCACCGAGATCTACACCCTAACCACCGAGCGGCTGTCTCCACAAGT
rpp30_F_1469_AACCGGTCTC	AATGATACGGCGACCACCGAGATCTACACAACCGGTCTCGAGCGGCTGTCTCCACAAGT
rpp30_F_1470_AAGAGAGAAC	AATGATACGGCGACCACCGAGATCTACACAAGAGAGAACGAGCGGCTGTCTCCACAAGT
rpp30_F_1471_AATCCAACAC	AATGATACGGCGACCACCGAGATCTACACAATCCAACACGAGCGGCTGTCTCCACAAGT
rpp30_F_1472_ACCAAGAGAC	AATGATACGGCGACCACCGAGATCTACACACCAAGAGACGAGCGGCTGTCTCCACAAGT
rpp30_F_1473_AGACATGGAC	AATGATACGGCGACCACCGAGATCTACACAGACATGGACGAGCGGCTGTCTCCACAAGT
rpp30_F_1474_AGTCAACCAC	AATGATACGGCGACCACCGAGATCTACACAGTCAACCACGAGCGGCTGTCTCCACAAGT
rpp30_F_1475_CAAGATTCAC	AATGATACGGCGACCACCGAGATCTACACCAAGATTCACGAGCGGCTGTCTCCACAAGT
rpp30_F_1476_CACAGCTTAC	AATGATACGGCGACCACCGAGATCTACACCACAGCTTACGAGCGGCTGTCTCCACAAGT
rpp30_F_1477_CACCTCTCAC	AATGATACGGCGACCACCGAGATCTACACCACCTCTCACGAGCGGCTGTCTCCACAAGT
rpp30_F_1478_CATAGAGGAC	AATGATACGGCGACCACCGAGATCTACACCATAGAGGACGAGCGGCTGTCTCCACAAGT
rpp30_F_1479_CCTCGAGAAC	AATGATACGGCGACCACCGAGATCTACACCCTCGAGAACGAGCGGCTGTCTCCACAAGT
rpp30_F_1480_CGTTATACAC	AATGATACGGCGACCACCGAGATCTACACCGTTATACACGAGCGGCTGTCTCCACAAGT
rpp30_F_1481_CTTGTACAAC	AATGATACGGCGACCACCGAGATCTACACCTTGTACAACGAGCGGCTGTCTCCACAAGT
rpp30_F_1482_GCAGCTTCAA	AATGATACGGCGACCACCGAGATCTACACGCAGCTTCAAGAGCGGCTGTCTCCACAAGT
rpp30_F_1483_ACTACTCACC	AATGATACGGCGACCACCGAGATCTACACACTACTCACCGAGCGGCTGTCTCCACAAGT
rpp30_F_1484_CGATATCACC	AATGATACGGCGACCACCGAGATCTACACCGATATCACCGAGCGGCTGTCTCCACAAGT
rpp30_F_1485_ACGAGCTACA	AATGATACGGCGACCACCGAGATCTACACACGAGCTACAGAGCGGCTGTCTCCACAAGT
rpp30_F_1486_TCGTTACGTC	AATGATACGGCGACCACCGAGATCTACACTCGTTACGTCGAGCGGCTGTCTCCACAAGT
rpp30_F_1487_ACACAACGGT	AATGATACGGCGACCACCGAGATCTACACACACAACGGTGAGCGGCTGTCTCCACAAGT
rpp30_F_1488_ACCTTCCGGT	AATGATACGGCGACCACCGAGATCTACACACCTTCCGGTGAGCGGCTGTCTCCACAAGT
rpp30_F_1489_GCCTAACGGT	AATGATACGGCGACCACCGAGATCTACACGCCTAACGGTGAGCGGCTGTCTCCACAAGT
rpp30_F_1490_AGCTTACCAC	AATGATACGGCGACCACCGAGATCTACACAGCTTACCACGAGCGGCTGTCTCCACAAGT
rpp30_F_1491_GCTGAGTTAC	AATGATACGGCGACCACCGAGATCTACACGCTGAGTTACGAGCGGCTGTCTCCACAAGT
rpp30_F_1492_GCCATCGTAT	AATGATACGGCGACCACCGAGATCTACACGCCATCGTATGAGCGGCTGTCTCCACAAGT
rpp30_F_1493_ATTGCATGCT	AATGATACGGCGACCACCGAGATCTACACATTGCATGCTGAGCGGCTGTCTCCACAAGT
rpp30_F_1494_AAGTGGCGAC	AATGATACGGCGACCACCGAGATCTACACAAGTGGCGACGAGCGGCTGTCTCCACAAGT
rpp30_F_1495_GGACTAGTAT	AATGATACGGCGACCACCGAGATCTACACGGACTAGTATGAGCGGCTGTCTCCACAAGT
rpp30_F_1496_ACCTACTGGC	AATGATACGGCGACCACCGAGATCTACACACCTACTGGCGAGCGGCTGTCTCCACAAGT
rpp30_F_1497_GATCGCAGTC	AATGATACGGCGACCACCGAGATCTACACGATCGCAGTCGAGCGGCTGTCTCCACAAGT
rpp30_F_1498_ACCGCCTTAA	AATGATACGGCGACCACCGAGATCTACACACCGCCTTAAGAGCGGCTGTCTCCACAAGT
rpp30_F_1499_CACTCTAGGC	AATGATACGGCGACCACCGAGATCTACACCACTCTAGGCGAGCGGCTGTCTCCACAAGT
rpp30_F_1500_CCTAATTCAC	AATGATACGGCGACCACCGAGATCTACACCCTAATTCACGAGCGGCTGTCTCCACAAGT
rpp30_F_1501_ACCAGTGGAT	AATGATACGGCGACCACCGAGATCTACACACCAGTGGATGAGCGGCTGTCTCCACAAGT
rpp30_F_1502_CCGCATATAG	AATGATACGGCGACCACCGAGATCTACACCCGCATATAGGAGCGGCTGTCTCCACAAGT
rpp30_F_1503_TCAACAAGTC	AATGATACGGCGACCACCGAGATCTACACTCAACAAGTCGAGCGGCTGTCTCCACAAGT
rpp30_F_1504_TTACTGAGTC	AATGATACGGCGACCACCGAGATCTACACTTACTGAGTCGAGCGGCTGTCTCCACAAGT
rpp30_F_1505_CTAGCCTCAG	AATGATACGGCGACCACCGAGATCTACACCTAGCCTCAGGAGCGGCTGTCTCCACAAGT
rpp30_F_1506_CACAGAGCAG	AATGATACGGCGACCACCGAGATCTACACCACAGAGCAGGAGCGGCTGTCTCCACAAGT
rpp30_F_1507_TGAAGAGCTT	AATGATACGGCGACCACCGAGATCTACACTGAAGAGCTTGAGCGGCTGTCTCCACAAGT
rpp30_F_1508_AGGTATAAGC	AATGATACGGCGACCACCGAGATCTACACAGGTATAAGCGAGCGGCTGTCTCCACAAGT
rpp30_F_1509_GCCACAGCAA	AATGATACGGCGACCACCGAGATCTACACGCCACAGCAAGAGCGGCTGTCTCCACAAGT
rpp30_F_1510_GACTAGTACC	AATGATACGGCGACCACCGAGATCTACACGACTAGTACCGAGCGGCTGTCTCCACAAGT
rpp30_F_1511_GCAATACACC	AATGATACGGCGACCACCGAGATCTACACGCAATACACCGAGCGGCTGTCTCCACAAGT
rpp30_F_1512_TGAGCATACC	AATGATACGGCGACCACCGAGATCTACACTGAGCATACCGAGCGGCTGTCTCCACAAGT
rpp30_F_1513_ACAGCCTCTG	AATGATACGGCGACCACCGAGATCTACACACAGCCTCTGGAGCGGCTGTCTCCACAAGT
rpp30_F_1514_ACCTGAGCAG	AATGATACGGCGACCACCGAGATCTACACACCTGAGCAGGAGCGGCTGTCTCCACAAGT
rpp30_F_1515_ACCTATAGCT	AATGATACGGCGACCACCGAGATCTACACACCTATAGCTGAGCGGCTGTCTCCACAAGT
rpp30_F_1516_TGGCATGCTT	AATGATACGGCGACCACCGAGATCTACACTGGCATGCTTGAGCGGCTGTCTCCACAAGT
rpp30_F_1517_ACCGAAGACA	AATGATACGGCGACCACCGAGATCTACACACCGAAGACAGAGCGGCTGTCTCCACAAGT
rpp30_F_1518_AGCAACGAAC	AATGATACGGCGACCACCGAGATCTACACAGCAACGAACGAGCGGCTGTCTCCACAAGT
rpp30_F_1519_AGTGGCTTAC	AATGATACGGCGACCACCGAGATCTACACAGTGGCTTACGAGCGGCTGTCTCCACAAGT
rpp30_F_1520_ATTCTTCCAC	AATGATACGGCGACCACCGAGATCTACACATTCTTCCACGAGCGGCTGTCTCCACAAGT
rpp30_F_1521_CAGGTTATAC	AATGATACGGCGACCACCGAGATCTACACCAGGTTATACGAGCGGCTGTCTCCACAAGT
rpp30_F_1522_GAGATACCAC	AATGATACGGCGACCACCGAGATCTACACGAGATACCACGAGCGGCTGTCTCCACAAGT
rpp30_F_1523_AACCTTCCTC	AATGATACGGCGACCACCGAGATCTACACAACCTTCCTCGAGCGGCTGTCTCCACAAGT
rpp30_F_1524_CAATGTCCTC	AATGATACGGCGACCACCGAGATCTACACCAATGTCCTCGAGCGGCTGTCTCCACAAGT
rpp30_F_1525_GCAGAGTACC	AATGATACGGCGACCACCGAGATCTACACGCAGAGTACCGAGCGGCTGTCTCCACAAGT
rpp30_F_1526_GAGAGAGACT	AATGATACGGCGACCACCGAGATCTACACGAGAGAGACTGAGCGGCTGTCTCCACAAGT
rpp30_F_1527_ACTTGTCCAC	AATGATACGGCGACCACCGAGATCTACACACTTGTCCACGAGCGGCTGTCTCCACAAGT
rpp30_F_1528_GGTTCCGCAT	AATGATACGGCGACCACCGAGATCTACACGGTTCCGCATGAGCGGCTGTCTCCACAAGT
rpp30_F_1529_AACGCCAGTC	AATGATACGGCGACCACCGAGATCTACACAACGCCAGTCGAGCGGCTGTCTCCACAAGT
rpp30_F_1530_ACTTAGACAC	AATGATACGGCGACCACCGAGATCTACACACTTAGACACGAGCGGCTGTCTCCACAAGT
rpp30_F_1531_CGAACGACAG	AATGATACGGCGACCACCGAGATCTACACCGAACGACAGGAGCGGCTGTCTCCACAAGT
rpp30_F_1532_GATCCGACAG	AATGATACGGCGACCACCGAGATCTACACGATCCGACAGGAGCGGCTGTCTCCACAAGT
rpp30_F_1533_AACTGCTACC	AATGATACGGCGACCACCGAGATCTACACAACTGCTACCGAGCGGCTGTCTCCACAAGT
rpp30_F_1534_CACAGATGCC	AATGATACGGCGACCACCGAGATCTACACCACAGATGCCGAGCGGCTGTCTCCACAAGT
rpp30_F_1535_ACACACAGAC	AATGATACGGCGACCACCGAGATCTACACACACACAGACGAGCGGCTGTCTCCACAAGT
rpp30_F_1536_AGCGAATCCG	AATGATACGGCGACCACCGAGATCTACACAGCGAATCCGGAGCGGCTGTCTCCACAAGT
rpp30_F_1537_GCCTAACTTC	AATGATACGGCGACCACCGAGATCTACACGCCTAACTTCGAGCGGCTGTCTCCACAAGT
rpp30_F_1538_TCACGTGGTT	AATGATACGGCGACCACCGAGATCTACACTCACGTGGTTGAGCGGCTGTCTCCACAAGT
rpp30_F_1539_ATTCACGTAC	AATGATACGGCGACCACCGAGATCTACACATTCACGTACGAGCGGCTGTCTCCACAAGT
rpp30_F_1540_ACTAGGACGT	AATGATACGGCGACCACCGAGATCTACACACTAGGACGTGAGCGGCTGTCTCCACAAGT
rpp30_F_1541_AGCTCTGCAT	AATGATACGGCGACCACCGAGATCTACACAGCTCTGCATGAGCGGCTGTCTCCACAAGT
rpp30_F_1542_ACTCAAGCTT	AATGATACGGCGACCACCGAGATCTACACACTCAAGCTTGAGCGGCTGTCTCCACAAGT
rpp30_F_1543_CGATTACAGC	AATGATACGGCGACCACCGAGATCTACACCGATTACAGCGAGCGGCTGTCTCCACAAGT
rpp30_F_1544_GATGGAGAGC	AATGATACGGCGACCACCGAGATCTACACGATGGAGAGCGAGCGGCTGTCTCCACAAGT
rpp30_F_1545_GATATCAGCT	AATGATACGGCGACCACCGAGATCTACACGATATCAGCTGAGCGGCTGTCTCCACAAGT
rpp30_F_1546_ACACACTAGT	AATGATACGGCGACCACCGAGATCTACACACACACTAGTGAGCGGCTGTCTCCACAAGT
rpp30_F_1547_ACACTGTACA	AATGATACGGCGACCACCGAGATCTACACACACTGTACAGAGCGGCTGTCTCCACAAGT
rpp30_F_1548_AGGACTACAC	AATGATACGGCGACCACCGAGATCTACACAGGACTACACGAGCGGCTGTCTCCACAAGT
rpp30_F_1549_CCATCCTCAC	AATGATACGGCGACCACCGAGATCTACACCCATCCTCACGAGCGGCTGTCTCCACAAGT
rpp30_F_1550_AACAACGAGA	AATGATACGGCGACCACCGAGATCTACACAACAACGAGAGAGCGGCTGTCTCCACAAGT
rpp30_F_1551_AACACACAGG	AATGATACGGCGACCACCGAGATCTACACAACACACAGGGAGCGGCTGTCTCCACAAGT
rpp30_F_1552_AACACAGTAG	AATGATACGGCGACCACCGAGATCTACACAACACAGTAGGAGCGGCTGTCTCCACAAGT
rpp30_F_1553_AACACCATTG	AATGATACGGCGACCACCGAGATCTACACAACACCATTGGAGCGGCTGTCTCCACAAGT
rpp30_F_1554_AACACGTCCA	AATGATACGGCGACCACCGAGATCTACACAACACGTCCAGAGCGGCTGTCTCCACAAGT
rpp30_F_1555_AACACTGCTT	AATGATACGGCGACCACCGAGATCTACACAACACTGCTTGAGCGGCTGTCTCCACAAGT
rpp30_F_1556_AACAGAGTGT	AATGATACGGCGACCACCGAGATCTACACAACAGAGTGTGAGCGGCTGTCTCCACAAGT
rpp30_F_1557_AACAGATAGC	AATGATACGGCGACCACCGAGATCTACACAACAGATAGCGAGCGGCTGTCTCCACAAGT
rpp30_F_1558_AACAGGATTC	AATGATACGGCGACCACCGAGATCTACACAACAGGATTCGAGCGGCTGTCTCCACAAGT
rpp30_F_1559_AACATCAAGC	AATGATACGGCGACCACCGAGATCTACACAACATCAAGCGAGCGGCTGTCTCCACAAGT
rpp30_F_1560_AACATGCAGT	AATGATACGGCGACCACCGAGATCTACACAACATGCAGTGAGCGGCTGTCTCCACAAGT
rpp30_F_1561_AACCAACCAG	AATGATACGGCGACCACCGAGATCTACACAACCAACCAGGAGCGGCTGTCTCCACAAGT
rpp30_F_1562_AACCAATAGG	AATGATACGGCGACCACCGAGATCTACACAACCAATAGGGAGCGGCTGTCTCCACAAGT
rpp30_F_1563_AACCACTGGT	AATGATACGGCGACCACCGAGATCTACACAACCACTGGTGAGCGGCTGTCTCCACAAGT
rpp30_F_1564_AACCAGAGGA	AATGATACGGCGACCACCGAGATCTACACAACCAGAGGAGAGCGGCTGTCTCCACAAGT
rpp30_F_1565_AACCAGCGAT	AATGATACGGCGACCACCGAGATCTACACAACCAGCGATGAGCGGCTGTCTCCACAAGT
rpp30_F_1566_AACCATGCAA	AATGATACGGCGACCACCGAGATCTACACAACCATGCAAGAGCGGCTGTCTCCACAAGT
rpp30_F_1567_AACCATTGAC	AATGATACGGCGACCACCGAGATCTACACAACCATTGACGAGCGGCTGTCTCCACAAGT
rpp30_F_1568_AACCGAATGC	AATGATACGGCGACCACCGAGATCTACACAACCGAATGCGAGCGGCTGTCTCCACAAGT
rpp30_F_1569_AACCGATCGT	AATGATACGGCGACCACCGAGATCTACACAACCGATCGTGAGCGGCTGTCTCCACAAGT
rpp30_F_1570_AACCGTACTA	AATGATACGGCGACCACCGAGATCTACACAACCGTACTAGAGCGGCTGTCTCCACAAGT
rpp30_F_1571_AACCGTGCCT	AATGATACGGCGACCACCGAGATCTACACAACCGTGCCTGAGCGGCTGTCTCCACAAGT
rpp30_F_1572_AACCTCATCC	AATGATACGGCGACCACCGAGATCTACACAACCTCATCCGAGCGGCTGTCTCCACAAGT
rpp30_F_1573_AACCTCCAGA	AATGATACGGCGACCACCGAGATCTACACAACCTCCAGAGAGCGGCTGTCTCCACAAGT
rpp30_F_1574_AACCTGAAGG	AATGATACGGCGACCACCGAGATCTACACAACCTGAAGGGAGCGGCTGTCTCCACAAGT
rpp30_F_1575_AACCTTAGAG	AATGATACGGCGACCACCGAGATCTACACAACCTTAGAGGAGCGGCTGTCTCCACAAGT
rpp30_F_1576_AACGAACCGT	AATGATACGGCGACCACCGAGATCTACACAACGAACCGTGAGCGGCTGTCTCCACAAGT
rpp30_F_1577_AACGACAGAA	AATGATACGGCGACCACCGAGATCTACACAACGACAGAAGAGCGGCTGTCTCCACAAGT
rpp30_F_1578_AACGACCACA	AATGATACGGCGACCACCGAGATCTACACAACGACCACAGAGCGGCTGTCTCCACAAGT
rpp30_F_1579_AACGACTCCT	AATGATACGGCGACCACCGAGATCTACACAACGACTCCTGAGCGGCTGTCTCCACAAGT
rpp30_F_1580_AACGAGTTAG	AATGATACGGCGACCACCGAGATCTACACAACGAGTTAGGAGCGGCTGTCTCCACAAGT
rpp30_F_1581_AACGATCAGG	AATGATACGGCGACCACCGAGATCTACACAACGATCAGGGAGCGGCTGTCTCCACAAGT
rpp30_F_1582_AACGATTCTG	AATGATACGGCGACCACCGAGATCTACACAACGATTCTGGAGCGGCTGTCTCCACAAGT
rpp30_F_1583_AACGCACAAC	AATGATACGGCGACCACCGAGATCTACACAACGCACAACGAGCGGCTGTCTCCACAAGT
rpp30_F_1584_AACGTAGCGA	AATGATACGGCGACCACCGAGATCTACACAACGTAGCGAGAGCGGCTGTCTCCACAAGT
rpp30_F_1585_AACGTGACAA	AATGATACGGCGACCACCGAGATCTACACAACGTGACAAGAGCGGCTGTCTCCACAAGT
rpp30_F_1586_AACGTGCTAT	AATGATACGGCGACCACCGAGATCTACACAACGTGCTATGAGCGGCTGTCTCCACAAGT
rpp30_F_1587_AACTACATGG	AATGATACGGCGACCACCGAGATCTACACAACTACATGGGAGCGGCTGTCTCCACAAGT
rpp30_F_1588_AACTACGTCT	AATGATACGGCGACCACCGAGATCTACACAACTACGTCTGAGCGGCTGTCTCCACAAGT
rpp30_F_1589_AACTAGAGAG	AATGATACGGCGACCACCGAGATCTACACAACTAGAGAGGAGCGGCTGTCTCCACAAGT
rpp30_F_1590_AACTCACCTT	AATGATACGGCGACCACCGAGATCTACACAACTCACCTTGAGCGGCTGTCTCCACAAGT
rpp30_F_1591_AACTCAGTCA	AATGATACGGCGACCACCGAGATCTACACAACTCAGTCAGAGCGGCTGTCTCCACAAGT
rpp30_F_1592_AACTGAACTG	AATGATACGGCGACCACCGAGATCTACACAACTGAACTGGAGCGGCTGTCTCCACAAGT
rpp30_F_1593_AACTGAGGAA	AATGATACGGCGACCACCGAGATCTACACAACTGAGGAAGAGCGGCTGTCTCCACAAGT
rpp30_F_1594_AACTGCCTTC	AATGATACGGCGACCACCGAGATCTACACAACTGCCTTCGAGCGGCTGTCTCCACAAGT
rpp30_F_1595_AACTGGATGA	AATGATACGGCGACCACCGAGATCTACACAACTGGATGAGAGCGGCTGTCTCCACAAGT
rpp30_F_1596_AACTGGCCAT	AATGATACGGCGACCACCGAGATCTACACAACTGGCCATGAGCGGCTGTCTCCACAAGT
rpp30_F_1597_AACTTCGTAC	AATGATACGGCGACCACCGAGATCTACACAACTTCGTACGAGCGGCTGTCTCCACAAGT
rpp30_F_1598_AACTTGGCTT	AATGATACGGCGACCACCGAGATCTACACAACTTGGCTTGAGCGGCTGTCTCCACAAGT
rpp30_F_1599_AAGAACCTCT	AATGATACGGCGACCACCGAGATCTACACAAGAACCTCTGAGCGGCTGTCTCCACAAGT
rpp30_F_1600_AAGAAGGATG	AATGATACGGCGACCACCGAGATCTACACAAGAAGGATGGAGCGGCTGTCTCCACAAGT
rpp30_F_1601_AAGACAAGAG	AATGATACGGCGACCACCGAGATCTACACAAGACAAGAGGAGCGGCTGTCTCCACAAGT
rpp30_F_1602_AAGACCAGGA	AATGATACGGCGACCACCGAGATCTACACAAGACCAGGAGAGCGGCTGTCTCCACAAGT
rpp30_F_1603_AAGACTCCAG	AATGATACGGCGACCACCGAGATCTACACAAGACTCCAGGAGCGGCTGTCTCCACAAGT
rpp30_F_1604_AAGACTGACT	AATGATACGGCGACCACCGAGATCTACACAAGACTGACTGAGCGGCTGTCTCCACAAGT
rpp30_F_1605_AAGAGACCAA	AATGATACGGCGACCACCGAGATCTACACAAGAGACCAAGAGCGGCTGTCTCCACAAGT
rpp30_F_1606_AAGATGTCCT	AATGATACGGCGACCACCGAGATCTACACAAGATGTCCTGAGCGGCTGTCTCCACAAGT
rpp30_F_1607_AAGCAAGTTG	AATGATACGGCGACCACCGAGATCTACACAAGCAAGTTGGAGCGGCTGTCTCCACAAGT
rpp30_F_1608_AAGCACTGAG	AATGATACGGCGACCACCGAGATCTACACAAGCACTGAGGAGCGGCTGTCTCCACAAGT
rpp30_F_1609_AAGCAGACAT	AATGATACGGCGACCACCGAGATCTACACAAGCAGACATGAGCGGCTGTCTCCACAAGT
rpp30_F_1610_AAGCATCATG	AATGATACGGCGACCACCGAGATCTACACAAGCATCATGGAGCGGCTGTCTCCACAAGT
rpp30_F_1611_AAGCCAGATT	AATGATACGGCGACCACCGAGATCTACACAAGCCAGATTGAGCGGCTGTCTCCACAAGT
rpp30_F_1612_AAGGAAGCAT	AATGATACGGCGACCACCGAGATCTACACAAGGAAGCATGAGCGGCTGTCTCCACAAGT
rpp30_F_1613_AAGGACACGA	AATGATACGGCGACCACCGAGATCTACACAAGGACACGAGAGCGGCTGTCTCCACAAGT
rpp30_F_1614_AAGGACGTAA	AATGATACGGCGACCACCGAGATCTACACAAGGACGTAAGAGCGGCTGTCTCCACAAGT
rpp30_F_1615_AAGGAGGACT	AATGATACGGCGACCACCGAGATCTACACAAGGAGGACTGAGCGGCTGTCTCCACAAGT
rpp30_F_1616_AAGGATGAGA	AATGATACGGCGACCACCGAGATCTACACAAGGATGAGAGAGCGGCTGTCTCCACAAGT
rpp30_F_1617_AAGGATTCCA	AATGATACGGCGACCACCGAGATCTACACAAGGATTCCAGAGCGGCTGTCTCCACAAGT
rpp30_F_1618_AAGGCAACCT	AATGATACGGCGACCACCGAGATCTACACAAGGCAACCTGAGCGGCTGTCTCCACAAGT
rpp30_F_1619_AAGGCATAGT	AATGATACGGCGACCACCGAGATCTACACAAGGCATAGTGAGCGGCTGTCTCCACAAGT
rpp30_F_1620_AAGGCTCATT	AATGATACGGCGACCACCGAGATCTACACAAGGCTCATTGAGCGGCTGTCTCCACAAGT
rpp30_F_1621_AAGGTTCTGG	AATGATACGGCGACCACCGAGATCTACACAAGGTTCTGGGAGCGGCTGTCTCCACAAGT
rpp30_F_1622_AAGTAACCGA	AATGATACGGCGACCACCGAGATCTACACAAGTAACCGAGAGCGGCTGTCTCCACAAGT
rpp30_F_1623_AAGTAACGTG	AATGATACGGCGACCACCGAGATCTACACAAGTAACGTGGAGCGGCTGTCTCCACAAGT
rpp30_F_1624_AAGTAAGGCT	AATGATACGGCGACCACCGAGATCTACACAAGTAAGGCTGAGCGGCTGTCTCCACAAGT
rpp30_F_1625_AAGTCAATGG	AATGATACGGCGACCACCGAGATCTACACAAGTCAATGGGAGCGGCTGTCTCCACAAGT
rpp30_F_1626_AAGTCCTGGT	AATGATACGGCGACCACCGAGATCTACACAAGTCCTGGTGAGCGGCTGTCTCCACAAGT
rpp30_F_1627_AAGTCTCAGG	AATGATACGGCGACCACCGAGATCTACACAAGTCTCAGGGAGCGGCTGTCTCCACAAGT
rpp30_F_1628_AAGTTCGAGA	AATGATACGGCGACCACCGAGATCTACACAAGTTCGAGAGAGCGGCTGTCTCCACAAGT
rpp30_F_1629_AATACACTCC	AATGATACGGCGACCACCGAGATCTACACAATACACTCCGAGCGGCTGTCTCCACAAGT
rpp30_F_1630_AATAGGAGGA	AATGATACGGCGACCACCGAGATCTACACAATAGGAGGAGAGCGGCTGTCTCCACAAGT
rpp30_F_1631_AATCAAGAGC	AATGATACGGCGACCACCGAGATCTACACAATCAAGAGCGAGCGGCTGTCTCCACAAGT
rpp30_F_1632_AATCCATCTG	AATGATACGGCGACCACCGAGATCTACACAATCCATCTGGAGCGGCTGTCTCCACAAGT
rpp30_F_1633_AATCCGTTCT	AATGATACGGCGACCACCGAGATCTACACAATCCGTTCTGAGCGGCTGTCTCCACAAGT
rpp30_F_1634_AATCGACCTA	AATGATACGGCGACCACCGAGATCTACACAATCGACCTAGAGCGGCTGTCTCCACAAGT
rpp30_F_1635_AATCGAGTCT	AATGATACGGCGACCACCGAGATCTACACAATCGAGTCTGAGCGGCTGTCTCCACAAGT
rpp30_F_1636_AATCGTCCAT	AATGATACGGCGACCACCGAGATCTACACAATCGTCCATGAGCGGCTGTCTCCACAAGT
rpp30_F_1637_AATCTGTCGT	AATGATACGGCGACCACCGAGATCTACACAATCTGTCGTGAGCGGCTGTCTCCACAAGT
rpp30_F_1638_AATGAGCAAG	AATGATACGGCGACCACCGAGATCTACACAATGAGCAAGGAGCGGCTGTCTCCACAAGT
rpp30_F_1639_AATGCGAAGA	AATGATACGGCGACCACCGAGATCTACACAATGCGAAGAGAGCGGCTGTCTCCACAAGT
rpp30_F_1640_AATGCTGAGT	AATGATACGGCGACCACCGAGATCTACACAATGCTGAGTGAGCGGCTGTCTCCACAAGT
rpp30_F_1641_AATGCTGTTG	AATGATACGGCGACCACCGAGATCTACACAATGCTGTTGGAGCGGCTGTCTCCACAAGT
rpp30_F_1642_AATGGATGGT	AATGATACGGCGACCACCGAGATCTACACAATGGATGGTGAGCGGCTGTCTCCACAAGT
rpp30_F_1643_AATGTTCCAG	AATGATACGGCGACCACCGAGATCTACACAATGTTCCAGGAGCGGCTGTCTCCACAAGT
rpp30_F_1644_AATTGCCACT	AATGATACGGCGACCACCGAGATCTACACAATTGCCACTGAGCGGCTGTCTCCACAAGT
rpp30_F_1645_ACAACAACCT	AATGATACGGCGACCACCGAGATCTACACACAACAACCTGAGCGGCTGTCTCCACAAGT
rpp30_F_1646_ACAACCGAGT	AATGATACGGCGACCACCGAGATCTACACACAACCGAGTGAGCGGCTGTCTCCACAAGT
rpp30_F_1647_ACAACCTCGA	AATGATACGGCGACCACCGAGATCTACACACAACCTCGAGAGCGGCTGTCTCCACAAGT
rpp30_F_1648_ACAACGAATG	AATGATACGGCGACCACCGAGATCTACACACAACGAATGGAGCGGCTGTCTCCACAAGT
rpp30_F_1649_ACAACTTAGG	AATGATACGGCGACCACCGAGATCTACACACAACTTAGGGAGCGGCTGTCTCCACAAGT
rpp30_F_1650_ACAACTTGCT	AATGATACGGCGACCACCGAGATCTACACACAACTTGCTGAGCGGCTGTCTCCACAAGT
rpp30_F_1651_ACAAGCCACT	AATGATACGGCGACCACCGAGATCTACACACAAGCCACTGAGCGGCTGTCTCCACAAGT
rpp30_F_1652_ACAAGCCTAA	AATGATACGGCGACCACCGAGATCTACACACAAGCCTAAGAGCGGCTGTCTCCACAAGT
rpp30_F_1653_ACAAGGATGG	AATGATACGGCGACCACCGAGATCTACACACAAGGATGGGAGCGGCTGTCTCCACAAGT
rpp30_F_1654_ACAAGTAGGA	AATGATACGGCGACCACCGAGATCTACACACAAGTAGGAGAGCGGCTGTCTCCACAAGT
rpp30_F_1655_ACAAGTCTTG	AATGATACGGCGACCACCGAGATCTACACACAAGTCTTGGAGCGGCTGTCTCCACAAGT
rpp30_F_1656_ACAAGTTCAG	AATGATACGGCGACCACCGAGATCTACACACAAGTTCAGGAGCGGCTGTCTCCACAAGT
rpp30_F_1657_ACAATACGTG	AATGATACGGCGACCACCGAGATCTACACACAATACGTGGAGCGGCTGTCTCCACAAGT
rpp30_F_1658_ACAATGCTCA	AATGATACGGCGACCACCGAGATCTACACACAATGCTCAGAGCGGCTGTCTCCACAAGT
rpp30_F_1659_ACAATGGACT	AATGATACGGCGACCACCGAGATCTACACACAATGGACTGAGCGGCTGTCTCCACAAGT
rpp30_F_1660_ACAATGGTTG	AATGATACGGCGACCACCGAGATCTACACACAATGGTTGGAGCGGCTGTCTCCACAAGT
rpp30_F_1661_ACACACTCTA	AATGATACGGCGACCACCGAGATCTACACACACACTCTAGAGCGGCTGTCTCCACAAGT
rpp30_F_1662_ACACATGAGA	AATGATACGGCGACCACCGAGATCTACACACACATGAGAGAGCGGCTGTCTCCACAAGT
rpp30_F_1663_ACACATGCCT	AATGATACGGCGACCACCGAGATCTACACACACATGCCTGAGCGGCTGTCTCCACAAGT
rpp30_F_1664_ACACCTGATG	AATGATACGGCGACCACCGAGATCTACACACACCTGATGGAGCGGCTGTCTCCACAAGT
rpp30_F_1665_ACACCTTCTT	AATGATACGGCGACCACCGAGATCTACACACACCTTCTTGAGCGGCTGTCTCCACAAGT
rpp30_F_1666_ACACGACAAG	AATGATACGGCGACCACCGAGATCTACACACACGACAAGGAGCGGCTGTCTCCACAAGT
rpp30_F_1667_ACACGAGAGT	AATGATACGGCGACCACCGAGATCTACACACACGAGAGTGAGCGGCTGTCTCCACAAGT
rpp30_F_1668_ACACGTAAGG	AATGATACGGCGACCACCGAGATCTACACACACGTAAGGGAGCGGCTGTCTCCACAAGT
rpp30_F_1669_ACACTAGGCT	AATGATACGGCGACCACCGAGATCTACACACACTAGGCTGAGCGGCTGTCTCCACAAGT
rpp30_F_1670_ACACTCAGGA	AATGATACGGCGACCACCGAGATCTACACACACTCAGGAGAGCGGCTGTCTCCACAAGT
rpp30_F_1671_ACACTCGAAC	AATGATACGGCGACCACCGAGATCTACACACACTCGAACGAGCGGCTGTCTCCACAAGT
rpp30_F_1672_ACACTGTCTG	AATGATACGGCGACCACCGAGATCTACACACACTGTCTGGAGCGGCTGTCTCCACAAGT
rpp30_F_1673_ACAGAACAGG	AATGATACGGCGACCACCGAGATCTACACACAGAACAGGGAGCGGCTGTCTCCACAAGT
rpp30_F_1674_ACAGACGATT	AATGATACGGCGACCACCGAGATCTACACACAGACGATTGAGCGGCTGTCTCCACAAGT
rpp30_F_1675_ACAGATCCTA	AATGATACGGCGACCACCGAGATCTACACACAGATCCTAGAGCGGCTGTCTCCACAAGT
rpp30_F_1676_ACAGATGAAG	AATGATACGGCGACCACCGAGATCTACACACAGATGAAGGAGCGGCTGTCTCCACAAGT
rpp30_F_1677_ACAGCGACTA	AATGATACGGCGACCACCGAGATCTACACACAGCGACTAGAGCGGCTGTCTCCACAAGT
rpp30_F_1678_ACAGCTATTG	AATGATACGGCGACCACCGAGATCTACACACAGCTATTGGAGCGGCTGTCTCCACAAGT
rpp30_F_1679_ACAGGACTGC	AATGATACGGCGACCACCGAGATCTACACACAGGACTGCGAGCGGCTGTCTCCACAAGT
rpp30_F_1680_ACAGTACGAA	AATGATACGGCGACCACCGAGATCTACACACAGTACGAAGAGCGGCTGTCTCCACAAGT
rpp30_F_1681_ACAGTCACAT	AATGATACGGCGACCACCGAGATCTACACACAGTCACATGAGCGGCTGTCTCCACAAGT
rpp30_F_1682_ACAGTTCTGA	AATGATACGGCGACCACCGAGATCTACACACAGTTCTGAGAGCGGCTGTCTCCACAAGT
rpp30_F_1683_ACATAGCGAG	AATGATACGGCGACCACCGAGATCTACACACATAGCGAGGAGCGGCTGTCTCCACAAGT
rpp30_F_1684_ACATCCGTGA	AATGATACGGCGACCACCGAGATCTACACACATCCGTGAGAGCGGCTGTCTCCACAAGT
rpp30_F_1685_ACATGCGTCC	AATGATACGGCGACCACCGAGATCTACACACATGCGTCCGAGCGGCTGTCTCCACAAGT
rpp30_F_1686_ACATGCTAAC	AATGATACGGCGACCACCGAGATCTACACACATGCTAACGAGCGGCTGTCTCCACAAGT
rpp30_F_1687_ACATTCCATC	AATGATACGGCGACCACCGAGATCTACACACATTCCATCGAGCGGCTGTCTCCACAAGT
rpp30_F_1688_ACATTGCGTT	AATGATACGGCGACCACCGAGATCTACACACATTGCGTTGAGCGGCTGTCTCCACAAGT
rpp30_F_1689_ACATTGGCGA	AATGATACGGCGACCACCGAGATCTACACACATTGGCGAGAGCGGCTGTCTCCACAAGT
rpp30_F_1690_ACCAACAAGG	AATGATACGGCGACCACCGAGATCTACACACCAACAAGGGAGCGGCTGTCTCCACAAGT
rpp30_F_1691_ACCAACACTA	AATGATACGGCGACCACCGAGATCTACACACCAACACTAGAGCGGCTGTCTCCACAAGT
rpp30_F_1692_ACCAACTATC	AATGATACGGCGACCACCGAGATCTACACACCAACTATCGAGCGGCTGTCTCCACAAGT
rpp30_F_1693_ACCACAAGAA	AATGATACGGCGACCACCGAGATCTACACACCACAAGAAGAGCGGCTGTCTCCACAAGT
rpp30_F_1694_ACCACATAAG	AATGATACGGCGACCACCGAGATCTACACACCACATAAGGAGCGGCTGTCTCCACAAGT
rpp30_F_1695_ACCACATTCA	AATGATACGGCGACCACCGAGATCTACACACCACATTCAGAGCGGCTGTCTCCACAAGT
rpp30_F_1696_ACCACGCTAC	AATGATACGGCGACCACCGAGATCTACACACCACGCTACGAGCGGCTGTCTCCACAAGT
rpp30_F_1697_ACCACGTCTT	AATGATACGGCGACCACCGAGATCTACACACCACGTCTTGAGCGGCTGTCTCCACAAGT
rpp30_F_1698_ACCAGATACT	AATGATACGGCGACCACCGAGATCTACACACCAGATACTGAGCGGCTGTCTCCACAAGT
rpp30_F_1699_ACCAGGAAGA	AATGATACGGCGACCACCGAGATCTACACACCAGGAAGAGAGCGGCTGTCTCCACAAGT
rpp30_F_1700_ACCATCAGAT	AATGATACGGCGACCACCGAGATCTACACACCATCAGATGAGCGGCTGTCTCCACAAGT
rpp30_F_1701_ACCATCTTAC	AATGATACGGCGACCACCGAGATCTACACACCATCTTACGAGCGGCTGTCTCCACAAGT
rpp30_F_1702_ACCGAACCAA	AATGATACGGCGACCACCGAGATCTACACACCGAACCAAGAGCGGCTGTCTCCACAAGT
rpp30_F_1703_ACCGAGAATG	AATGATACGGCGACCACCGAGATCTACACACCGAGAATGGAGCGGCTGTCTCCACAAGT
rpp30_F_1704_ACCGTCCTCA	AATGATACGGCGACCACCGAGATCTACACACCGTCCTCAGAGCGGCTGTCTCCACAAGT
rpp30_F_1705_ACCTAAGATG	AATGATACGGCGACCACCGAGATCTACACACCTAAGATGGAGCGGCTGTCTCCACAAGT
rpp30_F_1706_ACCTACCTGA	AATGATACGGCGACCACCGAGATCTACACACCTACCTGAGAGCGGCTGTCTCCACAAGT
rpp30_F_1707_ACCTACTTAG	AATGATACGGCGACCACCGAGATCTACACACCTACTTAGGAGCGGCTGTCTCCACAAGT
rpp30_F_1708_ACCTCAATAG	AATGATACGGCGACCACCGAGATCTACACACCTCAATAGGAGCGGCTGTCTCCACAAGT
rpp30_F_1709_ACCTCATGAC	AATGATACGGCGACCACCGAGATCTACACACCTCATGACGAGCGGCTGTCTCCACAAGT
rpp30_F_1710_ACCTCCGACT	AATGATACGGCGACCACCGAGATCTACACACCTCCGACTGAGCGGCTGTCTCCACAAGT
rpp30_F_1711_ACCTCCTGTT	AATGATACGGCGACCACCGAGATCTACACACCTCCTGTTGAGCGGCTGTCTCCACAAGT
rpp30_F_1712_ACCTGAACGA	AATGATACGGCGACCACCGAGATCTACACACCTGAACGAGAGCGGCTGTCTCCACAAGT
rpp30_F_1713_ACCTGTCTAT	AATGATACGGCGACCACCGAGATCTACACACCTGTCTATGAGCGGCTGTCTCCACAAGT
rpp30_F_1714_ACCTTATAGG	AATGATACGGCGACCACCGAGATCTACACACCTTATAGGGAGCGGCTGTCTCCACAAGT
rpp30_F_1715_ACCTTCCTTG	AATGATACGGCGACCACCGAGATCTACACACCTTCCTTGGAGCGGCTGTCTCCACAAGT
rpp30_F_1716_ACGAAGTCAA	AATGATACGGCGACCACCGAGATCTACACACGAAGTCAAGAGCGGCTGTCTCCACAAGT
rpp30_F_1717_ACGAATCAGT	AATGATACGGCGACCACCGAGATCTACACACGAATCAGTGAGCGGCTGTCTCCACAAGT
rpp30_F_1718_ACGACAGGAT	AATGATACGGCGACCACCGAGATCTACACACGACAGGATGAGCGGCTGTCTCCACAAGT
rpp30_F_1719_ACGACCTCAG	AATGATACGGCGACCACCGAGATCTACACACGACCTCAGGAGCGGCTGTCTCCACAAGT
rpp30_F_1720_ACGACTATCT	AATGATACGGCGACCACCGAGATCTACACACGACTATCTGAGCGGCTGTCTCCACAAGT
rpp30_F_1721_ACGAGACTCT	AATGATACGGCGACCACCGAGATCTACACACGAGACTCTGAGCGGCTGTCTCCACAAGT
rpp30_F_1722_ACGAGATAGG	AATGATACGGCGACCACCGAGATCTACACACGAGATAGGGAGCGGCTGTCTCCACAAGT
rpp30_F_1723_ACGAGGCATT	AATGATACGGCGACCACCGAGATCTACACACGAGGCATTGAGCGGCTGTCTCCACAAGT
rpp30_F_1724_ACGAGTCCGA	AATGATACGGCGACCACCGAGATCTACACACGAGTCCGAGAGCGGCTGTCTCCACAAGT
rpp30_F_1725_ACGATAGCCA	AATGATACGGCGACCACCGAGATCTACACACGATAGCCAGAGCGGCTGTCTCCACAAGT
rpp30_F_1726_ACGATTAAGG	AATGATACGGCGACCACCGAGATCTACACACGATTAAGGGAGCGGCTGTCTCCACAAGT
rpp30_F_1727_ACGCAACAAT	AATGATACGGCGACCACCGAGATCTACACACGCAACAATGAGCGGCTGTCTCCACAAGT
rpp30_F_1728_ACGCAATATG	AATGATACGGCGACCACCGAGATCTACACACGCAATATGGAGCGGCTGTCTCCACAAGT
rpp30_F_1729_ACGCATAACT	AATGATACGGCGACCACCGAGATCTACACACGCATAACTGAGCGGCTGTCTCCACAAGT
rpp30_F_1730_ACGCTATGTT	AATGATACGGCGACCACCGAGATCTACACACGCTATGTTGAGCGGCTGTCTCCACAAGT
rpp30_F_1731_ACGCTTCAAG	AATGATACGGCGACCACCGAGATCTACACACGCTTCAAGGAGCGGCTGTCTCCACAAGT
rpp30_F_1732_ACGTAACTCC	AATGATACGGCGACCACCGAGATCTACACACGTAACTCCGAGCGGCTGTCTCCACAAGT
rpp30_F_1733_ACGTAATTGG	AATGATACGGCGACCACCGAGATCTACACACGTAATTGGGAGCGGCTGTCTCCACAAGT
rpp30_F_1734_ACGTACACCT	AATGATACGGCGACCACCGAGATCTACACACGTACACCTGAGCGGCTGTCTCCACAAGT
rpp30_F_1735_ACGTAGCTTA	AATGATACGGCGACCACCGAGATCTACACACGTAGCTTAGAGCGGCTGTCTCCACAAGT
rpp30_F_1736_ACGTCACGAG	AATGATACGGCGACCACCGAGATCTACACACGTCACGAGGAGCGGCTGTCTCCACAAGT
rpp30_F_1737_ACGTCCAACC	AATGATACGGCGACCACCGAGATCTACACACGTCCAACCGAGCGGCTGTCTCCACAAGT
rpp30_F_1738_ACTAACCTTG	AATGATACGGCGACCACCGAGATCTACACACTAACCTTGGAGCGGCTGTCTCCACAAGT
rpp30_F_1739_ACTACAACTG	AATGATACGGCGACCACCGAGATCTACACACTACAACTGGAGCGGCTGTCTCCACAAGT
rpp30_F_1740_ACTACCAAGC	AATGATACGGCGACCACCGAGATCTACACACTACCAAGCGAGCGGCTGTCTCCACAAGT
rpp30_F_1741_ACTACCACAA	AATGATACGGCGACCACCGAGATCTACACACTACCACAAGAGCGGCTGTCTCCACAAGT
rpp30_F_1742_ACTACGAACA	AATGATACGGCGACCACCGAGATCTACACACTACGAACAGAGCGGCTGTCTCCACAAGT
rpp30_F_1743_ACTAGAGTCC	AATGATACGGCGACCACCGAGATCTACACACTAGAGTCCGAGCGGCTGTCTCCACAAGT
rpp30_F_1744_ACTAGCGAAT	AATGATACGGCGACCACCGAGATCTACACACTAGCGAATGAGCGGCTGTCTCCACAAGT
rpp30_F_1745_ACTATCCAGG	AATGATACGGCGACCACCGAGATCTACACACTATCCAGGGAGCGGCTGTCTCCACAAGT
rpp30_F_1746_ACTCACCAGA	AATGATACGGCGACCACCGAGATCTACACACTCACCAGAGAGCGGCTGTCTCCACAAGT
rpp30_F_1747_ACTCAGCCAT	AATGATACGGCGACCACCGAGATCTACACACTCAGCCATGAGCGGCTGTCTCCACAAGT
rpp30_F_1748_ACTCATTCAG	AATGATACGGCGACCACCGAGATCTACACACTCATTCAGGAGCGGCTGTCTCCACAAGT
rpp30_F_1749_ACTCCTCAAT	AATGATACGGCGACCACCGAGATCTACACACTCCTCAATGAGCGGCTGTCTCCACAAGT
rpp30_F_1750_ACTCCTTAGC	AATGATACGGCGACCACCGAGATCTACACACTCCTTAGCGAGCGGCTGTCTCCACAAGT
rpp30_F_1751_ACTCTGTAAG	AATGATACGGCGACCACCGAGATCTACACACTCTGTAAGGAGCGGCTGTCTCCACAAGT
rpp30_F_1752_ACTGACTCGT	AATGATACGGCGACCACCGAGATCTACACACTGACTCGTGAGCGGCTGTCTCCACAAGT
rpp30_F_1753_ACTGAGTTCA	AATGATACGGCGACCACCGAGATCTACACACTGAGTTCAGAGCGGCTGTCTCCACAAGT
rpp30_F_1754_ACTGATGCGA	AATGATACGGCGACCACCGAGATCTACACACTGATGCGAGAGCGGCTGTCTCCACAAGT
rpp30_F_1755_ACTGCCATTA	AATGATACGGCGACCACCGAGATCTACACACTGCCATTAGAGCGGCTGTCTCCACAAGT
rpp30_F_1756_ACTGCTCAGG	AATGATACGGCGACCACCGAGATCTACACACTGCTCAGGGAGCGGCTGTCTCCACAAGT
rpp30_F_1757_ACTGCTCCTT	AATGATACGGCGACCACCGAGATCTACACACTGCTCCTTGAGCGGCTGTCTCCACAAGT
rpp30_F_1758_ACTGGAATCA	AATGATACGGCGACCACCGAGATCTACACACTGGAATCAGAGCGGCTGTCTCCACAAGT
rpp30_F_1759_ACTTACAGAG	AATGATACGGCGACCACCGAGATCTACACACTTACAGAGGAGCGGCTGTCTCCACAAGT
rpp30_F_1760_ACTTAGGAAG	AATGATACGGCGACCACCGAGATCTACACACTTAGGAAGGAGCGGCTGTCTCCACAAGT
rpp30_F_1761_AGAACACAAC	AATGATACGGCGACCACCGAGATCTACACAGAACACAACGAGCGGCTGTCTCCACAAGT
rpp30_F_1762_AGAACACTGA	AATGATACGGCGACCACCGAGATCTACACAGAACACTGAGAGCGGCTGTCTCCACAAGT
rpp30_F_1763_AGAACCGTAG	AATGATACGGCGACCACCGAGATCTACACAGAACCGTAGGAGCGGCTGTCTCCACAAGT
rpp30_F_1764_AGAACTCCAA	AATGATACGGCGACCACCGAGATCTACACAGAACTCCAAGAGCGGCTGTCTCCACAAGT
rpp30_F_1765_AGAAGACGAG	AATGATACGGCGACCACCGAGATCTACACAGAAGACGAGGAGCGGCTGTCTCCACAAGT
rpp30_F_1766_AGAAGGTGAT	AATGATACGGCGACCACCGAGATCTACACAGAAGGTGATGAGCGGCTGTCTCCACAAGT
rpp30_F_1767_AGAATGAGGA	AATGATACGGCGACCACCGAGATCTACACAGAATGAGGAGAGCGGCTGTCTCCACAAGT
rpp30_F_1768_AGACAACCTG	AATGATACGGCGACCACCGAGATCTACACAGACAACCTGGAGCGGCTGTCTCCACAAGT
rpp30_F_1769_AGACAGATGA	AATGATACGGCGACCACCGAGATCTACACAGACAGATGAGAGCGGCTGTCTCCACAAGT
rpp30_F_1770_AGACATCTCA	AATGATACGGCGACCACCGAGATCTACACAGACATCTCAGAGCGGCTGTCTCCACAAGT
rpp30_F_1771_AGACCATGTT	AATGATACGGCGACCACCGAGATCTACACAGACCATGTTGAGCGGCTGTCTCCACAAGT
rpp30_F_1772_AGACGACATT	AATGATACGGCGACCACCGAGATCTACACAGACGACATTGAGCGGCTGTCTCCACAAGT
rpp30_F_1773_AGAGACTAAG	AATGATACGGCGACCACCGAGATCTACACAGAGACTAAGGAGCGGCTGTCTCCACAAGT
rpp30_F_1774_AGAGCAACGA	AATGATACGGCGACCACCGAGATCTACACAGAGCAACGAGAGCGGCTGTCTCCACAAGT
rpp30_F_1775_AGAGCCTTCC	AATGATACGGCGACCACCGAGATCTACACAGAGCCTTCCGAGCGGCTGTCTCCACAAGT
rpp30_F_1776_AGAGCGTACT	AATGATACGGCGACCACCGAGATCTACACAGAGCGTACTGAGCGGCTGTCTCCACAAGT
rpp30_F_1777_AGAGGAATAC	AATGATACGGCGACCACCGAGATCTACACAGAGGAATACGAGCGGCTGTCTCCACAAGT
rpp30_F_1778_AGAGGATTCT	AATGATACGGCGACCACCGAGATCTACACAGAGGATTCTGAGCGGCTGTCTCCACAAGT
rpp30_F_1779_AGAGGCATGA	AATGATACGGCGACCACCGAGATCTACACAGAGGCATGAGAGCGGCTGTCTCCACAAGT
rpp30_F_1780_AGAGGCCAAT	AATGATACGGCGACCACCGAGATCTACACAGAGGCCAATGAGCGGCTGTCTCCACAAGT
rpp30_F_1781_AGAGTGAAGG	AATGATACGGCGACCACCGAGATCTACACAGAGTGAAGGGAGCGGCTGTCTCCACAAGT
rpp30_F_1782_AGATGTACGA	AATGATACGGCGACCACCGAGATCTACACAGATGTACGAGAGCGGCTGTCTCCACAAGT
rpp30_F_1783_AGATTGCGAA	AATGATACGGCGACCACCGAGATCTACACAGATTGCGAAGAGCGGCTGTCTCCACAAGT
rpp30_F_1784_AGCAAGACAA	AATGATACGGCGACCACCGAGATCTACACAGCAAGACAAGAGCGGCTGTCTCCACAAGT
rpp30_F_1785_AGCAGAGTAA	AATGATACGGCGACCACCGAGATCTACACAGCAGAGTAAGAGCGGCTGTCTCCACAAGT
rpp30_F_1786_AGCATTCTGG	AATGATACGGCGACCACCGAGATCTACACAGCATTCTGGGAGCGGCTGTCTCCACAAGT
rpp30_F_1787_AGCCACTGAA	AATGATACGGCGACCACCGAGATCTACACAGCCACTGAAGAGCGGCTGTCTCCACAAGT
rpp30_F_1788_AGCCATTCCT	AATGATACGGCGACCACCGAGATCTACACAGCCATTCCTGAGCGGCTGTCTCCACAAGT
rpp30_F_1789_AGCGATAGGA	AATGATACGGCGACCACCGAGATCTACACAGCGATAGGAGAGCGGCTGTCTCCACAAGT
rpp30_F_1790_AGCGTAATCT	AATGATACGGCGACCACCGAGATCTACACAGCGTAATCTGAGCGGCTGTCTCCACAAGT
rpp30_F_1791_AGCGTCATTA	AATGATACGGCGACCACCGAGATCTACACAGCGTCATTAGAGCGGCTGTCTCCACAAGT
rpp30_F_1792_AGCTAGAAGG	AATGATACGGCGACCACCGAGATCTACACAGCTAGAAGGGAGCGGCTGTCTCCACAAGT
rpp30_F_1793_AGCTTACTGA	AATGATACGGCGACCACCGAGATCTACACAGCTTACTGAGAGCGGCTGTCTCCACAAGT
rpp30_F_1794_AGGAACCAAG	AATGATACGGCGACCACCGAGATCTACACAGGAACCAAGGAGCGGCTGTCTCCACAAGT
rpp30_F_1795_AGGACGAAGA	AATGATACGGCGACCACCGAGATCTACACAGGACGAAGAGAGCGGCTGTCTCCACAAGT
rpp30_F_1796_AGGATATCTG	AATGATACGGCGACCACCGAGATCTACACAGGATATCTGGAGCGGCTGTCTCCACAAGT
rpp30_F_1797_AGGCAGTAAT	AATGATACGGCGACCACCGAGATCTACACAGGCAGTAATGAGCGGCTGTCTCCACAAGT
rpp30_F_1798_AGGCTATAGG	AATGATACGGCGACCACCGAGATCTACACAGGCTATAGGGAGCGGCTGTCTCCACAAGT
rpp30_F_1799_AGGTGCAAGT	AATGATACGGCGACCACCGAGATCTACACAGGTGCAAGTGAGCGGCTGTCTCCACAAGT
rpp30_F_1800_AGTACGAGAT	AATGATACGGCGACCACCGAGATCTACACAGTACGAGATGAGCGGCTGTCTCCACAAGT
rpp30_F_1801_AGTAGGATCA	AATGATACGGCGACCACCGAGATCTACACAGTAGGATCAGAGCGGCTGTCTCCACAAGT
rpp30_F_1802_AGTAGTGCCT	AATGATACGGCGACCACCGAGATCTACACAGTAGTGCCTGAGCGGCTGTCTCCACAAGT
rpp30_F_1803_AGTATACCAG	AATGATACGGCGACCACCGAGATCTACACAGTATACCAGGAGCGGCTGTCTCCACAAGT
rpp30_F_1804_AGTATCCAAC	AATGATACGGCGACCACCGAGATCTACACAGTATCCAACGAGCGGCTGTCTCCACAAGT
rpp30_F_1805_AGTATTCCGT	AATGATACGGCGACCACCGAGATCTACACAGTATTCCGTGAGCGGCTGTCTCCACAAGT
rpp30_F_1806_AGTCAGCGAA	AATGATACGGCGACCACCGAGATCTACACAGTCAGCGAAGAGCGGCTGTCTCCACAAGT
rpp30_F_1807_AGTCCAGGAT	AATGATACGGCGACCACCGAGATCTACACAGTCCAGGATGAGCGGCTGTCTCCACAAGT
rpp30_F_1808_AGTCCTCCAG	AATGATACGGCGACCACCGAGATCTACACAGTCCTCCAGGAGCGGCTGTCTCCACAAGT
rpp30_F_1809_AGTCTCAGAA	AATGATACGGCGACCACCGAGATCTACACAGTCTCAGAAGAGCGGCTGTCTCCACAAGT
rpp30_F_1810_AGTCTTCATC	AATGATACGGCGACCACCGAGATCTACACAGTCTTCATCGAGCGGCTGTCTCCACAAGT
rpp30_F_1811_AGTTCCAAGA	AATGATACGGCGACCACCGAGATCTACACAGTTCCAAGAGAGCGGCTGTCTCCACAAGT
rpp30_F_1812_AGTTGCTCTT	AATGATACGGCGACCACCGAGATCTACACAGTTGCTCTTGAGCGGCTGTCTCCACAAGT
rpp30_F_1813_ATACAGTTGG	AATGATACGGCGACCACCGAGATCTACACATACAGTTGGGAGCGGCTGTCTCCACAAGT
rpp30_F_1814_ATACCACATG	AATGATACGGCGACCACCGAGATCTACACATACCACATGGAGCGGCTGTCTCCACAAGT
rpp30_F_1815_ATACCTCACA	AATGATACGGCGACCACCGAGATCTACACATACCTCACAGAGCGGCTGTCTCCACAAGT
rpp30_F_1816_ATAGCCTAAC	AATGATACGGCGACCACCGAGATCTACACATAGCCTAACGAGCGGCTGTCTCCACAAGT
rpp30_F_1817_ATAGGATAGG	AATGATACGGCGACCACCGAGATCTACACATAGGATAGGGAGCGGCTGTCTCCACAAGT
rpp30_F_1818_ATAGTCTTGG	AATGATACGGCGACCACCGAGATCTACACATAGTCTTGGGAGCGGCTGTCTCCACAAGT
rpp30_F_1819_ATAGTTCCTG	AATGATACGGCGACCACCGAGATCTACACATAGTTCCTGGAGCGGCTGTCTCCACAAGT
rpp30_F_1820_ATATGGTGAG	AATGATACGGCGACCACCGAGATCTACACATATGGTGAGGAGCGGCTGTCTCCACAAGT
rpp30_F_1821_ATCAACAGAG	AATGATACGGCGACCACCGAGATCTACACATCAACAGAGGAGCGGCTGTCTCCACAAGT
rpp30_F_1822_ATCAACTGGA	AATGATACGGCGACCACCGAGATCTACACATCAACTGGAGAGCGGCTGTCTCCACAAGT
rpp30_F_1823_ATCACACGTT	AATGATACGGCGACCACCGAGATCTACACATCACACGTTGAGCGGCTGTCTCCACAAGT
rpp30_F_1824_ATCACTCTCC	AATGATACGGCGACCACCGAGATCTACACATCACTCTCCGAGCGGCTGTCTCCACAAGT
rpp30_F_1825_ATCATCCTTC	AATGATACGGCGACCACCGAGATCTACACATCATCCTTCGAGCGGCTGTCTCCACAAGT
rpp30_F_1826_ATCCACCATT	AATGATACGGCGACCACCGAGATCTACACATCCACCATTGAGCGGCTGTCTCCACAAGT
rpp30_F_1827_ATCCAGTCAT	AATGATACGGCGACCACCGAGATCTACACATCCAGTCATGAGCGGCTGTCTCCACAAGT
rpp30_F_1828_ATCCGATCCA	AATGATACGGCGACCACCGAGATCTACACATCCGATCCAGAGCGGCTGTCTCCACAAGT
rpp30_F_1829_ATCCGTTAAG	AATGATACGGCGACCACCGAGATCTACACATCCGTTAAGGAGCGGCTGTCTCCACAAGT
rpp30_F_1830_ATCCTCGAAG	AATGATACGGCGACCACCGAGATCTACACATCCTCGAAGGAGCGGCTGTCTCCACAAGT
rpp30_F_1831_ATCCTGCATA	AATGATACGGCGACCACCGAGATCTACACATCCTGCATAGAGCGGCTGTCTCCACAAGT
rpp30_F_1832_ATCGACTAGG	AATGATACGGCGACCACCGAGATCTACACATCGACTAGGGAGCGGCTGTCTCCACAAGT
rpp30_F_1833_ATCGAGTTCC	AATGATACGGCGACCACCGAGATCTACACATCGAGTTCCGAGCGGCTGTCTCCACAAGT
rpp30_F_1834_ATCGTATAGC	AATGATACGGCGACCACCGAGATCTACACATCGTATAGCGAGCGGCTGTCTCCACAAGT
rpp30_F_1835_ATCTACGCAA	AATGATACGGCGACCACCGAGATCTACACATCTACGCAAGAGCGGCTGTCTCCACAAGT
rpp30_F_1836_ATCTGCCTCA	AATGATACGGCGACCACCGAGATCTACACATCTGCCTCAGAGCGGCTGTCTCCACAAGT
rpp30_F_1837_ATCTGTCACT	AATGATACGGCGACCACCGAGATCTACACATCTGTCACTGAGCGGCTGTCTCCACAAGT
rpp30_F_1838_ATGAAGGTCA	AATGATACGGCGACCACCGAGATCTACACATGAAGGTCAGAGCGGCTGTCTCCACAAGT
rpp30_F_1839_ATGACCGAAG	AATGATACGGCGACCACCGAGATCTACACATGACCGAAGGAGCGGCTGTCTCCACAAGT
rpp30_F_1840_ATGCGTACAA	AATGATACGGCGACCACCGAGATCTACACATGCGTACAAGAGCGGCTGTCTCCACAAGT
rpp30_F_1841_ATTACGATGC	AATGATACGGCGACCACCGAGATCTACACATTACGATGCGAGCGGCTGTCTCCACAAGT
rpp30_F_1842_ATTAGGCTGA	AATGATACGGCGACCACCGAGATCTACACATTAGGCTGAGAGCGGCTGTCTCCACAAGT
rpp30_F_1843_ATTCCTGCTT	AATGATACGGCGACCACCGAGATCTACACATTCCTGCTTGAGCGGCTGTCTCCACAAGT
rpp30_F_1844_ATTGCCTAGT	AATGATACGGCGACCACCGAGATCTACACATTGCCTAGTGAGCGGCTGTCTCCACAAGT
rpp30_F_1845_ATTGTCAAGG	AATGATACGGCGACCACCGAGATCTACACATTGTCAAGGGAGCGGCTGTCTCCACAAGT
rpp30_F_1846_CAACAATCAG	AATGATACGGCGACCACCGAGATCTACACCAACAATCAGGAGCGGCTGTCTCCACAAGT
rpp30_F_1847_CAACAGATGG	AATGATACGGCGACCACCGAGATCTACACCAACAGATGGGAGCGGCTGTCTCCACAAGT
rpp30_F_1848_CAACATAGGT	AATGATACGGCGACCACCGAGATCTACACCAACATAGGTGAGCGGCTGTCTCCACAAGT
rpp30_F_1849_CAACATCATC	AATGATACGGCGACCACCGAGATCTACACCAACATCATCGAGCGGCTGTCTCCACAAGT
rpp30_F_1850_CAACATGAAG	AATGATACGGCGACCACCGAGATCTACACCAACATGAAGGAGCGGCTGTCTCCACAAGT
rpp30_F_1851_CAACCAACGT	AATGATACGGCGACCACCGAGATCTACACCAACCAACGTGAGCGGCTGTCTCCACAAGT
rpp30_F_1852_CAACGAAGAG	AATGATACGGCGACCACCGAGATCTACACCAACGAAGAGGAGCGGCTGTCTCCACAAGT
rpp30_F_1853_CAACGAGAAT	AATGATACGGCGACCACCGAGATCTACACCAACGAGAATGAGCGGCTGTCTCCACAAGT
rpp30_F_1854_CAACTACTGA	AATGATACGGCGACCACCGAGATCTACACCAACTACTGAGAGCGGCTGTCTCCACAAGT
rpp30_F_1855_CAACTTCCAG	AATGATACGGCGACCACCGAGATCTACACCAACTTCCAGGAGCGGCTGTCTCCACAAGT
rpp30_F_1856_CAAGAAGGTT	AATGATACGGCGACCACCGAGATCTACACCAAGAAGGTTGAGCGGCTGTCTCCACAAGT
rpp30_F_1857_CAAGACCTGA	AATGATACGGCGACCACCGAGATCTACACCAAGACCTGAGAGCGGCTGTCTCCACAAGT
rpp30_F_1858_CAAGCCATAG	AATGATACGGCGACCACCGAGATCTACACCAAGCCATAGGAGCGGCTGTCTCCACAAGT
rpp30_F_1859_CAAGGATAAG	AATGATACGGCGACCACCGAGATCTACACCAAGGATAAGGAGCGGCTGTCTCCACAAGT
rpp30_F_1860_CAATATGCCT	AATGATACGGCGACCACCGAGATCTACACCAATATGCCTGAGCGGCTGTCTCCACAAGT
rpp30_F_1861_CAATCCACGA	AATGATACGGCGACCACCGAGATCTACACCAATCCACGAGAGCGGCTGTCTCCACAAGT
rpp30_F_1862_CAATCGTTGA	AATGATACGGCGACCACCGAGATCTACACCAATCGTTGAGAGCGGCTGTCTCCACAAGT
rpp30_F_1863_CAATTACCTG	AATGATACGGCGACCACCGAGATCTACACCAATTACCTGGAGCGGCTGTCTCCACAAGT
rpp30_F_1864_CAATTCCGAT	AATGATACGGCGACCACCGAGATCTACACCAATTCCGATGAGCGGCTGTCTCCACAAGT
rpp30_F_1865_CACAAGAAGG	AATGATACGGCGACCACCGAGATCTACACCACAAGAAGGGAGCGGCTGTCTCCACAAGT
rpp30_F_1866_CACAAGGAAT	AATGATACGGCGACCACCGAGATCTACACCACAAGGAATGAGCGGCTGTCTCCACAAGT
rpp30_F_1867_CACAGAACGA	AATGATACGGCGACCACCGAGATCTACACCACAGAACGAGAGCGGCTGTCTCCACAAGT
rpp30_F_1868_CACATATAGG	AATGATACGGCGACCACCGAGATCTACACCACATATAGGGAGCGGCTGTCTCCACAAGT
rpp30_F_1869_CACCAATCCT	AATGATACGGCGACCACCGAGATCTACACCACCAATCCTGAGCGGCTGTCTCCACAAGT
rpp30_F_1870_CACCATCTAG	AATGATACGGCGACCACCGAGATCTACACCACCATCTAGGAGCGGCTGTCTCCACAAGT
rpp30_F_1871_CACCGTTGAT	AATGATACGGCGACCACCGAGATCTACACCACCGTTGATGAGCGGCTGTCTCCACAAGT
rpp30_F_1872_CACCTATGAG	AATGATACGGCGACCACCGAGATCTACACCACCTATGAGGAGCGGCTGTCTCCACAAGT
rpp30_F_1873_CACCTCCTTA	AATGATACGGCGACCACCGAGATCTACACCACCTCCTTAGAGCGGCTGTCTCCACAAGT
rpp30_F_1874_CACCTCGATT	AATGATACGGCGACCACCGAGATCTACACCACCTCGATTGAGCGGCTGTCTCCACAAGT
rpp30_F_1875_CACTATTGCT	AATGATACGGCGACCACCGAGATCTACACCACTATTGCTGAGCGGCTGTCTCCACAAGT
rpp30_F_1876_CACTGAACAT	AATGATACGGCGACCACCGAGATCTACACCACTGAACATGAGCGGCTGTCTCCACAAGT
rpp30_F_1877_CACTTCTAAG	AATGATACGGCGACCACCGAGATCTACACCACTTCTAAGGAGCGGCTGTCTCCACAAGT
rpp30_F_1878_CAGAACACTT	AATGATACGGCGACCACCGAGATCTACACCAGAACACTTGAGCGGCTGTCTCCACAAGT
rpp30_F_1879_CAGGTCTAAT	AATGATACGGCGACCACCGAGATCTACACCAGGTCTAATGAGCGGCTGTCTCCACAAGT
rpp30_F_1880_CAGTAACAAG	AATGATACGGCGACCACCGAGATCTACACCAGTAACAAGGAGCGGCTGTCTCCACAAGT
rpp30_F_1881_CAGTAGTAGG	AATGATACGGCGACCACCGAGATCTACACCAGTAGTAGGGAGCGGCTGTCTCCACAAGT
rpp30_F_1882_CAGTTGATTG	AATGATACGGCGACCACCGAGATCTACACCAGTTGATTGGAGCGGCTGTCTCCACAAGT
rpp30_F_1883_CATAAGTTGC	AATGATACGGCGACCACCGAGATCTACACCATAAGTTGCGAGCGGCTGTCTCCACAAGT
rpp30_F_1884_CATCATAGAG	AATGATACGGCGACCACCGAGATCTACACCATCATAGAGGAGCGGCTGTCTCCACAAGT
rpp30_F_1885_CATCCACAGG	AATGATACGGCGACCACCGAGATCTACACCATCCACAGGGAGCGGCTGTCTCCACAAGT
rpp30_F_1886_CATCCACTAT	AATGATACGGCGACCACCGAGATCTACACCATCCACTATGAGCGGCTGTCTCCACAAGT
rpp30_F_1887_CATCCTATGT	AATGATACGGCGACCACCGAGATCTACACCATCCTATGTGAGCGGCTGTCTCCACAAGT
rpp30_F_1888_CATGACTTAG	AATGATACGGCGACCACCGAGATCTACACCATGACTTAGGAGCGGCTGTCTCCACAAGT
rpp30_F_1889_CATTCATCCA	AATGATACGGCGACCACCGAGATCTACACCATTCATCCAGAGCGGCTGTCTCCACAAGT
rpp30_F_1890_CCAACGAGGA	AATGATACGGCGACCACCGAGATCTACACCCAACGAGGAGAGCGGCTGTCTCCACAAGT
rpp30_F_1891_CCAAGAGAAG	AATGATACGGCGACCACCGAGATCTACACCCAAGAGAAGGAGCGGCTGTCTCCACAAGT
rpp30_F_1892_CCAAGGTAGT	AATGATACGGCGACCACCGAGATCTACACCCAAGGTAGTGAGCGGCTGTCTCCACAAGT
rpp30_F_1893_CCAATCTCAA	AATGATACGGCGACCACCGAGATCTACACCCAATCTCAAGAGCGGCTGTCTCCACAAGT
rpp30_F_1894_CCACACTGAA	AATGATACGGCGACCACCGAGATCTACACCCACACTGAAGAGCGGCTGTCTCCACAAGT
rpp30_F_1895_CCACATAACC	AATGATACGGCGACCACCGAGATCTACACCCACATAACCGAGCGGCTGTCTCCACAAGT
rpp30_F_1896_CCACCTAGTA	AATGATACGGCGACCACCGAGATCTACACCCACCTAGTAGAGCGGCTGTCTCCACAAGT
rpp30_F_1897_CCACCTATGC	AATGATACGGCGACCACCGAGATCTACACCCACCTATGCGAGCGGCTGTCTCCACAAGT
rpp30_F_1898_CCACTTCGTT	AATGATACGGCGACCACCGAGATCTACACCCACTTCGTTGAGCGGCTGTCTCCACAAGT
rpp30_F_1899_CCAGAAGACT	AATGATACGGCGACCACCGAGATCTACACCCAGAAGACTGAGCGGCTGTCTCCACAAGT
rpp30_F_1900_CCATCACAGA	AATGATACGGCGACCACCGAGATCTACACCCATCACAGAGAGCGGCTGTCTCCACAAGT
rpp30_F_1901_CCATCCACCT	AATGATACGGCGACCACCGAGATCTACACCCATCCACCTGAGCGGCTGTCTCCACAAGT
rpp30_F_1902_CCATCCATTC	AATGATACGGCGACCACCGAGATCTACACCCATCCATTCGAGCGGCTGTCTCCACAAGT
rpp30_F_1903_CCATGTGACT	AATGATACGGCGACCACCGAGATCTACACCCATGTGACTGAGCGGCTGTCTCCACAAGT
rpp30_F_1904_CCGAACTAGA	AATGATACGGCGACCACCGAGATCTACACCCGAACTAGAGAGCGGCTGTCTCCACAAGT
rpp30_F_1905_CCGAAGTTCT	AATGATACGGCGACCACCGAGATCTACACCCGAAGTTCTGAGCGGCTGTCTCCACAAGT
rpp30_F_1906_CCGAGGATAG	AATGATACGGCGACCACCGAGATCTACACCCGAGGATAGGAGCGGCTGTCTCCACAAGT
rpp30_F_1907_CCGATAACTT	AATGATACGGCGACCACCGAGATCTACACCCGATAACTTGAGCGGCTGTCTCCACAAGT
rpp30_F_1908_CCGTCAGAAG	AATGATACGGCGACCACCGAGATCTACACCCGTCAGAAGGAGCGGCTGTCTCCACAAGT
rpp30_F_1909_CCGTTAATAG	AATGATACGGCGACCACCGAGATCTACACCCGTTAATAGGAGCGGCTGTCTCCACAAGT
rpp30_F_1910_CCTACCTTCC	AATGATACGGCGACCACCGAGATCTACACCCTACCTTCCGAGCGGCTGTCTCCACAAGT
rpp30_F_1911_CCTAGATGAG	AATGATACGGCGACCACCGAGATCTACACCCTAGATGAGGAGCGGCTGTCTCCACAAGT
rpp30_F_1912_CCTCAAGTCC	AATGATACGGCGACCACCGAGATCTACACCCTCAAGTCCGAGCGGCTGTCTCCACAAGT
rpp30_F_1913_CCTCACCATT	AATGATACGGCGACCACCGAGATCTACACCCTCACCATTGAGCGGCTGTCTCCACAAGT
rpp30_F_1914_CCTCATTCTT	AATGATACGGCGACCACCGAGATCTACACCCTCATTCTTGAGCGGCTGTCTCCACAAGT
rpp30_F_1915_CCTCGACTCT	AATGATACGGCGACCACCGAGATCTACACCCTCGACTCTGAGCGGCTGTCTCCACAAGT
rpp30_F_1916_CCTGAACACA	AATGATACGGCGACCACCGAGATCTACACCCTGAACACAGAGCGGCTGTCTCCACAAGT
rpp30_F_1917_CCTGAATCTG	AATGATACGGCGACCACCGAGATCTACACCCTGAATCTGGAGCGGCTGTCTCCACAAGT
rpp30_F_1918_CCTGAGTAAT	AATGATACGGCGACCACCGAGATCTACACCCTGAGTAATGAGCGGCTGTCTCCACAAGT
rpp30_F_1919_CCTTCCTCTT	AATGATACGGCGACCACCGAGATCTACACCCTTCCTCTTGAGCGGCTGTCTCCACAAGT
rpp30_F_1920_CGAACCAGTA	AATGATACGGCGACCACCGAGATCTACACCGAACCAGTAGAGCGGCTGTCTCCACAAGT
rpp30_F_1921_CGAACGCTTG	AATGATACGGCGACCACCGAGATCTACACCGAACGCTTGGAGCGGCTGTCTCCACAAGT
rpp30_F_1922_CGAAGACACA	AATGATACGGCGACCACCGAGATCTACACCGAAGACACAGAGCGGCTGTCTCCACAAGT
rpp30_F_1923_CGAAGAGTAT	AATGATACGGCGACCACCGAGATCTACACCGAAGAGTATGAGCGGCTGTCTCCACAAGT
rpp30_F_1924_CGAAGGTTAG	AATGATACGGCGACCACCGAGATCTACACCGAAGGTTAGGAGCGGCTGTCTCCACAAGT
rpp30_F_1925_CGAAGTATGG	AATGATACGGCGACCACCGAGATCTACACCGAAGTATGGGAGCGGCTGTCTCCACAAGT
rpp30_F_1926_CGAATCTAAG	AATGATACGGCGACCACCGAGATCTACACCGAATCTAAGGAGCGGCTGTCTCCACAAGT
rpp30_F_1927_CGACCAATAG	AATGATACGGCGACCACCGAGATCTACACCGACCAATAGGAGCGGCTGTCTCCACAAGT
rpp30_F_1928_CGACTAAGTA	AATGATACGGCGACCACCGAGATCTACACCGACTAAGTAGAGCGGCTGTCTCCACAAGT
rpp30_F_1929_CGAGAATAGT	AATGATACGGCGACCACCGAGATCTACACCGAGAATAGTGAGCGGCTGTCTCCACAAGT
rpp30_F_1930_CGAGGACTAA	AATGATACGGCGACCACCGAGATCTACACCGAGGACTAAGAGCGGCTGTCTCCACAAGT
rpp30_F_1931_CGAGTAACCA	AATGATACGGCGACCACCGAGATCTACACCGAGTAACCAGAGCGGCTGTCTCCACAAGT
rpp30_F_1932_CGAGTTGAAG	AATGATACGGCGACCACCGAGATCTACACCGAGTTGAAGGAGCGGCTGTCTCCACAAGT
rpp30_F_1933_CGTACCGTTA	AATGATACGGCGACCACCGAGATCTACACCGTACCGTTAGAGCGGCTGTCTCCACAAGT
rpp30_F_1934_CGTGCGTGAA	AATGATACGGCGACCACCGAGATCTACACCGTGCGTGAAGAGCGGCTGTCTCCACAAGT
rpp30_F_1935_CTACCTCTTC	AATGATACGGCGACCACCGAGATCTACACCTACCTCTTCGAGCGGCTGTCTCCACAAGT
rpp30_F_1936_CTAGTTCCAA	AATGATACGGCGACCACCGAGATCTACACCTAGTTCCAAGAGCGGCTGTCTCCACAAGT
rpp30_F_1937_CTATTCACTG	AATGATACGGCGACCACCGAGATCTACACCTATTCACTGGAGCGGCTGTCTCCACAAGT
rpp30_F_1938_CTCATATCTG	AATGATACGGCGACCACCGAGATCTACACCTCATATCTGGAGCGGCTGTCTCCACAAGT
rpp30_F_1939_CTCCACCACA	AATGATACGGCGACCACCGAGATCTACACCTCCACCACAGAGCGGCTGTCTCCACAAGT
rpp30_F_1940_CTCCTTCAGA	AATGATACGGCGACCACCGAGATCTACACCTCCTTCAGAGAGCGGCTGTCTCCACAAGT
rpp30_F_1941_CTGAGTTCTT	AATGATACGGCGACCACCGAGATCTACACCTGAGTTCTTGAGCGGCTGTCTCCACAAGT
rpp30_F_1942_CTGATGTACT	AATGATACGGCGACCACCGAGATCTACACCTGATGTACTGAGCGGCTGTCTCCACAAGT
rpp30_F_1943_CTTCCAGTAA	AATGATACGGCGACCACCGAGATCTACACCTTCCAGTAAGAGCGGCTGTCTCCACAAGT
rpp30_F_1944_GAACGAATCT	AATGATACGGCGACCACCGAGATCTACACGAACGAATCTGAGCGGCTGTCTCCACAAGT
rpp30_F_1945_GAACTGTAAG	AATGATACGGCGACCACCGAGATCTACACGAACTGTAAGGAGCGGCTGTCTCCACAAGT
rpp30_F_1946_GAAGAAGTTC	AATGATACGGCGACCACCGAGATCTACACGAAGAAGTTCGAGCGGCTGTCTCCACAAGT
rpp30_F_1947_GAAGAGGTAG	AATGATACGGCGACCACCGAGATCTACACGAAGAGGTAGGAGCGGCTGTCTCCACAAGT
rpp30_F_1948_GAAGGCAAGG	AATGATACGGCGACCACCGAGATCTACACGAAGGCAAGGGAGCGGCTGTCTCCACAAGT
rpp30_F_1949_GAAGGTTCTT	AATGATACGGCGACCACCGAGATCTACACGAAGGTTCTTGAGCGGCTGTCTCCACAAGT
rpp30_F_1950_GAATAGCGAT	AATGATACGGCGACCACCGAGATCTACACGAATAGCGATGAGCGGCTGTCTCCACAAGT
rpp30_F_1951_GACAAGATAG	AATGATACGGCGACCACCGAGATCTACACGACAAGATAGGAGCGGCTGTCTCCACAAGT
rpp30_F_1952_GACCGAATTA	AATGATACGGCGACCACCGAGATCTACACGACCGAATTAGAGCGGCTGTCTCCACAAGT
rpp30_F_1953_GACCTACTAA	AATGATACGGCGACCACCGAGATCTACACGACCTACTAAGAGCGGCTGTCTCCACAAGT
rpp30_F_1954_GACTGGATAT	AATGATACGGCGACCACCGAGATCTACACGACTGGATATGAGCGGCTGTCTCCACAAGT
rpp30_F_1955_GACTGTTCCT	AATGATACGGCGACCACCGAGATCTACACGACTGTTCCTGAGCGGCTGTCTCCACAAGT
rpp30_F_1956_GAGATCGAAT	AATGATACGGCGACCACCGAGATCTACACGAGATCGAATGAGCGGCTGTCTCCACAAGT
rpp30_F_1957_GAGCAAGTCA	AATGATACGGCGACCACCGAGATCTACACGAGCAAGTCAGAGCGGCTGTCTCCACAAGT
rpp30_F_1958_GAGGACATTA	AATGATACGGCGACCACCGAGATCTACACGAGGACATTAGAGCGGCTGTCTCCACAAGT
rpp30_F_1959_GAGGCATGTT	AATGATACGGCGACCACCGAGATCTACACGAGGCATGTTGAGCGGCTGTCTCCACAAGT
rpp30_F_1960_GAGTACGACT	AATGATACGGCGACCACCGAGATCTACACGAGTACGACTGAGCGGCTGTCTCCACAAGT
rpp30_F_1961_GATCTTGCCT	AATGATACGGCGACCACCGAGATCTACACGATCTTGCCTGAGCGGCTGTCTCCACAAGT
rpp30_F_1962_GATGCTCATG	AATGATACGGCGACCACCGAGATCTACACGATGCTCATGGAGCGGCTGTCTCCACAAGT
rpp30_F_1963_GATTCATTCC	AATGATACGGCGACCACCGAGATCTACACGATTCATTCCGAGCGGCTGTCTCCACAAGT
rpp30_F_1964_GATTCCTCAA	AATGATACGGCGACCACCGAGATCTACACGATTCCTCAAGAGCGGCTGTCTCCACAAGT
rpp30_F_1965_GCAGCTAAGG	AATGATACGGCGACCACCGAGATCTACACGCAGCTAAGGGAGCGGCTGTCTCCACAAGT
rpp30_F_1966_GCAGTCCAAT	AATGATACGGCGACCACCGAGATCTACACGCAGTCCAATGAGCGGCTGTCTCCACAAGT
rpp30_F_1967_GCTACAGTCT	AATGATACGGCGACCACCGAGATCTACACGCTACAGTCTGAGCGGCTGTCTCCACAAGT
rpp30_F_1968_GTACACCTAG	AATGATACGGCGACCACCGAGATCTACACGTACACCTAGGAGCGGCTGTCTCCACAAGT
rpp30_F_1969_GTACTAGTTG	AATGATACGGCGACCACCGAGATCTACACGTACTAGTTGGAGCGGCTGTCTCCACAAGT
rpp30_F_1970_GTCTAACAGA	AATGATACGGCGACCACCGAGATCTACACGTCTAACAGAGAGCGGCTGTCTCCACAAGT
rpp30_F_1971_GTTCATCAAG	AATGATACGGCGACCACCGAGATCTACACGTTCATCAAGGAGCGGCTGTCTCCACAAGT
rpp30_F_1972_TAGGAGAATG	AATGATACGGCGACCACCGAGATCTACACTAGGAGAATGGAGCGGCTGTCTCCACAAGT
rpp30_F_1973_TCAGGACTTA	AATGATACGGCGACCACCGAGATCTACACTCAGGACTTAGAGCGGCTGTCTCCACAAGT
rpp30_F_1974_TCAGTACCTG	AATGATACGGCGACCACCGAGATCTACACTCAGTACCTGGAGCGGCTGTCTCCACAAGT
rpp30_F_1975_GTCTTCACTA	AATGATACGGCGACCACCGAGATCTACACGTCTTCACTAGAGCGGCTGTCTCCACAAGT
rpp30_F_1976_AAGAGGACAG	AATGATACGGCGACCACCGAGATCTACACAAGAGGACAGGAGCGGCTGTCTCCACAAGT
rpp30_F_1977_ATCTAGGACC	AATGATACGGCGACCACCGAGATCTACACATCTAGGACCGAGCGGCTGTCTCCACAAGT
rpp30_F_1978_GAGACCTAAC	AATGATACGGCGACCACCGAGATCTACACGAGACCTAACGAGCGGCTGTCTCCACAAGT
rpp30_F_1979_ACTCCATGGA	AATGATACGGCGACCACCGAGATCTACACACTCCATGGAGAGCGGCTGTCTCCACAAGT
rpp30_F_1980_CGACAAGTCG	AATGATACGGCGACCACCGAGATCTACACCGACAAGTCGGAGCGGCTGTCTCCACAAGT
rpp30_F_1981_AAGCAACTAC	AATGATACGGCGACCACCGAGATCTACACAAGCAACTACGAGCGGCTGTCTCCACAAGT
rpp30_F_1982_ACGAGTATAC	AATGATACGGCGACCACCGAGATCTACACACGAGTATACGAGCGGCTGTCTCCACAAGT
rpp30_F_1983_AGTTCCTGAC	AATGATACGGCGACCACCGAGATCTACACAGTTCCTGACGAGCGGCTGTCTCCACAAGT
rpp30_F_1984_CAACCTTAAC	AATGATACGGCGACCACCGAGATCTACACCAACCTTAACGAGCGGCTGTCTCCACAAGT
rpp30_F_1985_CACATTGTAC	AATGATACGGCGACCACCGAGATCTACACCACATTGTACGAGCGGCTGTCTCCACAAGT
rpp30_F_1986_CAGACAACAC	AATGATACGGCGACCACCGAGATCTACACCAGACAACACGAGCGGCTGTCTCCACAAGT
rpp30_F_1987_CATTACTGAC	AATGATACGGCGACCACCGAGATCTACACCATTACTGACGAGCGGCTGTCTCCACAAGT
rpp30_F_1988_CCACACCAAC	AATGATACGGCGACCACCGAGATCTACACCCACACCAACGAGCGGCTGTCTCCACAAGT
rpp30_F_1989_CTCCGACTAC	AATGATACGGCGACCACCGAGATCTACACCTCCGACTACGAGCGGCTGTCTCCACAAGT
rpp30_F_1990_GAACCACTAC	AATGATACGGCGACCACCGAGATCTACACGAACCACTACGAGCGGCTGTCTCCACAAGT
rpp30_F_1991_GACGTGTTAC	AATGATACGGCGACCACCGAGATCTACACGACGTGTTACGAGCGGCTGTCTCCACAAGT
rpp30_F_1992_GCCAGATCAC	AATGATACGGCGACCACCGAGATCTACACGCCAGATCACGAGCGGCTGTCTCCACAAGT
rpp30_F_1993_GCCATAAGAC	AATGATACGGCGACCACCGAGATCTACACGCCATAAGACGAGCGGCTGTCTCCACAAGT
rpp30_F_1994_GGTTGAAGAC	AATGATACGGCGACCACCGAGATCTACACGGTTGAAGACGAGCGGCTGTCTCCACAAGT
rpp30_F_1995_TCTACTCTAG	AATGATACGGCGACCACCGAGATCTACACTCTACTCTAGGAGCGGCTGTCTCCACAAGT
rpp30_F_1996_CGCAACAGAC	AATGATACGGCGACCACCGAGATCTACACCGCAACAGACGAGCGGCTGTCTCCACAAGT
rpp30_F_1997_AACACGAGGC	AATGATACGGCGACCACCGAGATCTACACAACACGAGGCGAGCGGCTGTCTCCACAAGT
rpp30_F_1998_AACCTAGCTG	AATGATACGGCGACCACCGAGATCTACACAACCTAGCTGGAGCGGCTGTCTCCACAAGT
rpp30_F_1999_CCAAGCATAT	AATGATACGGCGACCACCGAGATCTACACCCAAGCATATGAGCGGCTGTCTCCACAAGT
rpp30_F_2000_ATTATCTGCC	AATGATACGGCGACCACCGAGATCTACACATTATCTGCCGAGCGGCTGTCTCCACAAGT
rpp30_F_2001_ACGCTAATAC	AATGATACGGCGACCACCGAGATCTACACACGCTAATACGAGCGGCTGTCTCCACAAGT
rpp30_F_2002_ATAAGCTGAC	AATGATACGGCGACCACCGAGATCTACACATAAGCTGACGAGCGGCTGTCTCCACAAGT
rpp30_F_2003_GCTACCGGAA	AATGATACGGCGACCACCGAGATCTACACGCTACCGGAAGAGCGGCTGTCTCCACAAGT
rpp30_F_2004_AAGGTCGAAG	AATGATACGGCGACCACCGAGATCTACACAAGGTCGAAGGAGCGGCTGTCTCCACAAGT
rpp30_F_2005_CAATCCGTAC	AATGATACGGCGACCACCGAGATCTACACCAATCCGTACGAGCGGCTGTCTCCACAAGT
rpp30_F_2006_AAGTCGCATC	AATGATACGGCGACCACCGAGATCTACACAAGTCGCATCGAGCGGCTGTCTCCACAAGT
rpp30_F_2007_ATAACTGGTC	AATGATACGGCGACCACCGAGATCTACACATAACTGGTCGAGCGGCTGTCTCCACAAGT
rpp30_F_2008_AAGAACGCTA	AATGATACGGCGACCACCGAGATCTACACAAGAACGCTAGAGCGGCTGTCTCCACAAGT
rpp30_F_2009_ACCGGTGACT	AATGATACGGCGACCACCGAGATCTACACACCGGTGACTGAGCGGCTGTCTCCACAAGT
rpp30_F_2010_AACACATCTC	AATGATACGGCGACCACCGAGATCTACACAACACATCTCGAGCGGCTGTCTCCACAAGT
rpp30_F_2011_ACAGAAGGCC	AATGATACGGCGACCACCGAGATCTACACACAGAAGGCCGAGCGGCTGTCTCCACAAGT
rpp30_F_2012_ATAGTTGGCC	AATGATACGGCGACCACCGAGATCTACACATAGTTGGCCGAGCGGCTGTCTCCACAAGT
rpp30_F_2013_AGGTCGACAA	AATGATACGGCGACCACCGAGATCTACACAGGTCGACAAGAGCGGCTGTCTCCACAAGT
rpp30_F_2014_ACAAGGCCTC	AATGATACGGCGACCACCGAGATCTACACACAAGGCCTCGAGCGGCTGTCTCCACAAGT
rpp30_F_2015_ACGGTTCCTC	AATGATACGGCGACCACCGAGATCTACACACGGTTCCTCGAGCGGCTGTCTCCACAAGT
rpp30_F_2016_GACGGTATTC	AATGATACGGCGACCACCGAGATCTACACGACGGTATTCGAGCGGCTGTCTCCACAAGT
rpp30_F_2017_ACTGCGCAAC	AATGATACGGCGACCACCGAGATCTACACACTGCGCAACGAGCGGCTGTCTCCACAAGT
rpp30_F_2018_AAGCTGGACG	AATGATACGGCGACCACCGAGATCTACACAAGCTGGACGGAGCGGCTGTCTCCACAAGT
rpp30_F_2019_ACTGATGGTC	AATGATACGGCGACCACCGAGATCTACACACTGATGGTCGAGCGGCTGTCTCCACAAGT
rpp30_F_2020_CGAGACGCTA	AATGATACGGCGACCACCGAGATCTACACCGAGACGCTAGAGCGGCTGTCTCCACAAGT
rpp30_F_2021_ATGTCAACTC	AATGATACGGCGACCACCGAGATCTACACATGTCAACTCGAGCGGCTGTCTCCACAAGT
rpp30_F_2022_AGATTGCACC	AATGATACGGCGACCACCGAGATCTACACAGATTGCACCGAGCGGCTGTCTCCACAAGT
rpp30_F_2023_ACCACTGCAG	AATGATACGGCGACCACCGAGATCTACACACCACTGCAGGAGCGGCTGTCTCCACAAGT
rpp30_F_2024_AAGTGGACTC	AATGATACGGCGACCACCGAGATCTACACAAGTGGACTCGAGCGGCTGTCTCCACAAGT
