s2_F_1_ATGAGACTTG	AATGATACGGCGACCACCGAGATCTACACATGAGACTTGGCTGGTGCTGCAGCTTATTA
s2_F_2_GAGGCTATCT	AATGATACGGCGACCACCGAGATCTACACGAGGCTATCTGCTGGTGCTGCAGCTTATTA
s2_F_3_ACGTTGAAGA	AATGATACGGCGACCACCGAGATCTACACACGTTGAAGAGCTGGTGCTGCAGCTTATTA
s2_F_4_AGATTCTCTG	AATGATACGGCGACCACCGAGATCTACACAGATTCTCTGGCTGGTGCTGCAGCTTATTA
s2_F_5_AACGGCAAGA	AATGATACGGCGACCACCGAGATCTACACAACGGCAAGAGCTGGTGCTGCAGCTTATTA
s2_F_6_AGCGATCTAA	AATGATACGGCGACCACCGAGATCTACACAGCGATCTAAGCTGGTGCTGCAGCTTATTA
s2_F_7_ATCTGGAACG	AATGATACGGCGACCACCGAGATCTACACATCTGGAACGGCTGGTGCTGCAGCTTATTA
s2_F_8_CGATACAACG	AATGATACGGCGACCACCGAGATCTACACCGATACAACGGCTGGTGCTGCAGCTTATTA
s2_F_9_GAACTACACG	AATGATACGGCGACCACCGAGATCTACACGAACTACACGGCTGGTGCTGCAGCTTATTA
s2_F_10_TAAGGTAACG	AATGATACGGCGACCACCGAGATCTACACTAAGGTAACGGCTGGTGCTGCAGCTTATTA
s2_F_11_CAAGAACTAG	AATGATACGGCGACCACCGAGATCTACACCAAGAACTAGGCTGGTGCTGCAGCTTATTA
s2_F_12_CGAACTTGCG	AATGATACGGCGACCACCGAGATCTACACCGAACTTGCGGCTGGTGCTGCAGCTTATTA
s2_F_13_ACACATAGCG	AATGATACGGCGACCACCGAGATCTACACACACATAGCGGCTGGTGCTGCAGCTTATTA
s2_F_14_AGACTATGCG	AATGATACGGCGACCACCGAGATCTACACAGACTATGCGGCTGGTGCTGCAGCTTATTA
s2_F_15_CATTGGCTTG	AATGATACGGCGACCACCGAGATCTACACCATTGGCTTGGCTGGTGCTGCAGCTTATTA
s2_F_16_CGTTCATAGA	AATGATACGGCGACCACCGAGATCTACACCGTTCATAGAGCTGGTGCTGCAGCTTATTA
s2_F_17_CATCTCTGTA	AATGATACGGCGACCACCGAGATCTACACCATCTCTGTAGCTGGTGCTGCAGCTTATTA
s2_F_18_ATGGACCATA	AATGATACGGCGACCACCGAGATCTACACATGGACCATAGCTGGTGCTGCAGCTTATTA
s2_F_19_ATTGAGCGTA	AATGATACGGCGACCACCGAGATCTACACATTGAGCGTAGCTGGTGCTGCAGCTTATTA
s2_F_20_ACCTGATTCG	AATGATACGGCGACCACCGAGATCTACACACCTGATTCGGCTGGTGCTGCAGCTTATTA
s2_F_21_AACATAACGG	AATGATACGGCGACCACCGAGATCTACACAACATAACGGGCTGGTGCTGCAGCTTATTA
s2_F_22_ACCGATACGG	AATGATACGGCGACCACCGAGATCTACACACCGATACGGGCTGGTGCTGCAGCTTATTA
s2_F_23_ACTCTGTTGA	AATGATACGGCGACCACCGAGATCTACACACTCTGTTGAGCTGGTGCTGCAGCTTATTA
s2_F_24_TATTGTCACG	AATGATACGGCGACCACCGAGATCTACACTATTGTCACGGCTGGTGCTGCAGCTTATTA
s2_F_25_ACAAGATCGT	AATGATACGGCGACCACCGAGATCTACACACAAGATCGTGCTGGTGCTGCAGCTTATTA
s2_F_26_ATAGAAGACG	AATGATACGGCGACCACCGAGATCTACACATAGAAGACGGCTGGTGCTGCAGCTTATTA
s2_F_27_CACAGGATCG	AATGATACGGCGACCACCGAGATCTACACCACAGGATCGGCTGGTGCTGCAGCTTATTA
s2_F_28_CCACGAATCG	AATGATACGGCGACCACCGAGATCTACACCCACGAATCGGCTGGTGCTGCAGCTTATTA
s2_F_29_ACGAAGAACG	AATGATACGGCGACCACCGAGATCTACACACGAAGAACGGCTGGTGCTGCAGCTTATTA
s2_F_30_AAGTGAGTGA	AATGATACGGCGACCACCGAGATCTACACAAGTGAGTGAGCTGGTGCTGCAGCTTATTA
s2_F_31_ACCGCATAGA	AATGATACGGCGACCACCGAGATCTACACACCGCATAGAGCTGGTGCTGCAGCTTATTA
s2_F_32_CTATCCTTCG	AATGATACGGCGACCACCGAGATCTACACCTATCCTTCGGCTGGTGCTGCAGCTTATTA
s2_F_33_GTATAGAGAG	AATGATACGGCGACCACCGAGATCTACACGTATAGAGAGGCTGGTGCTGCAGCTTATTA
s2_F_34_CACACATGTT	AATGATACGGCGACCACCGAGATCTACACCACACATGTTGCTGGTGCTGCAGCTTATTA
s2_F_35_ACTCATCTGG	AATGATACGGCGACCACCGAGATCTACACACTCATCTGGGCTGGTGCTGCAGCTTATTA
s2_F_36_GATAACCGGA	AATGATACGGCGACCACCGAGATCTACACGATAACCGGAGCTGGTGCTGCAGCTTATTA
s2_F_37_ACCTTGGACG	AATGATACGGCGACCACCGAGATCTACACACCTTGGACGGCTGGTGCTGCAGCTTATTA
s2_F_38_AGATCCTCGT	AATGATACGGCGACCACCGAGATCTACACAGATCCTCGTGCTGGTGCTGCAGCTTATTA
s2_F_39_CTTGTCTACG	AATGATACGGCGACCACCGAGATCTACACCTTGTCTACGGCTGGTGCTGCAGCTTATTA
s2_F_40_ACAATGACCG	AATGATACGGCGACCACCGAGATCTACACACAATGACCGGCTGGTGCTGCAGCTTATTA
s2_F_41_ACCAATGGTA	AATGATACGGCGACCACCGAGATCTACACACCAATGGTAGCTGGTGCTGCAGCTTATTA
s2_F_42_CACTTAGCGG	AATGATACGGCGACCACCGAGATCTACACCACTTAGCGGGCTGGTGCTGCAGCTTATTA
s2_F_43_CATATGATGG	AATGATACGGCGACCACCGAGATCTACACCATATGATGGGCTGGTGCTGCAGCTTATTA
s2_F_44_CATGTCGTGA	AATGATACGGCGACCACCGAGATCTACACCATGTCGTGAGCTGGTGCTGCAGCTTATTA
s2_F_45_ATCTATACCG	AATGATACGGCGACCACCGAGATCTACACATCTATACCGGCTGGTGCTGCAGCTTATTA
s2_F_46_GTATCCTGTA	AATGATACGGCGACCACCGAGATCTACACGTATCCTGTAGCTGGTGCTGCAGCTTATTA
s2_F_47_CCATGGTGAA	AATGATACGGCGACCACCGAGATCTACACCCATGGTGAAGCTGGTGCTGCAGCTTATTA
s2_F_48_ACTGGTTGTA	AATGATACGGCGACCACCGAGATCTACACACTGGTTGTAGCTGGTGCTGCAGCTTATTA
s2_F_49_AAGTGATCAG	AATGATACGGCGACCACCGAGATCTACACAAGTGATCAGGCTGGTGCTGCAGCTTATTA
s2_F_50_GCGCCATCTT	AATGATACGGCGACCACCGAGATCTACACGCGCCATCTTGCTGGTGCTGCAGCTTATTA
s2_F_51_AGAATTGACG	AATGATACGGCGACCACCGAGATCTACACAGAATTGACGGCTGGTGCTGCAGCTTATTA
s2_F_52_ATGACAGTCG	AATGATACGGCGACCACCGAGATCTACACATGACAGTCGGCTGGTGCTGCAGCTTATTA
s2_F_53_ACTGATAACG	AATGATACGGCGACCACCGAGATCTACACACTGATAACGGCTGGTGCTGCAGCTTATTA
s2_F_54_CAGATCACAG	AATGATACGGCGACCACCGAGATCTACACCAGATCACAGGCTGGTGCTGCAGCTTATTA
s2_F_55_CATGTCTCTG	AATGATACGGCGACCACCGAGATCTACACCATGTCTCTGGCTGGTGCTGCAGCTTATTA
s2_F_56_AATCCTACCG	AATGATACGGCGACCACCGAGATCTACACAATCCTACCGGCTGGTGCTGCAGCTTATTA
s2_F_57_CGCAGAGGTT	AATGATACGGCGACCACCGAGATCTACACCGCAGAGGTTGCTGGTGCTGCAGCTTATTA
s2_F_58_GAGTATAGGT	AATGATACGGCGACCACCGAGATCTACACGAGTATAGGTGCTGGTGCTGCAGCTTATTA
s2_F_59_CTGGTCTCTA	AATGATACGGCGACCACCGAGATCTACACCTGGTCTCTAGCTGGTGCTGCAGCTTATTA
s2_F_60_CGCAATTGTA	AATGATACGGCGACCACCGAGATCTACACCGCAATTGTAGCTGGTGCTGCAGCTTATTA
s2_F_61_ACAGCGTTGG	AATGATACGGCGACCACCGAGATCTACACACAGCGTTGGGCTGGTGCTGCAGCTTATTA
s2_F_62_GATCAACGTA	AATGATACGGCGACCACCGAGATCTACACGATCAACGTAGCTGGTGCTGCAGCTTATTA
s2_F_63_AATGGAACGG	AATGATACGGCGACCACCGAGATCTACACAATGGAACGGGCTGGTGCTGCAGCTTATTA
s2_F_64_CTAATGAACG	AATGATACGGCGACCACCGAGATCTACACCTAATGAACGGCTGGTGCTGCAGCTTATTA
s2_F_65_AACCTTCACG	AATGATACGGCGACCACCGAGATCTACACAACCTTCACGGCTGGTGCTGCAGCTTATTA
s2_F_66_AATCTCCGAG	AATGATACGGCGACCACCGAGATCTACACAATCTCCGAGGCTGGTGCTGCAGCTTATTA
s2_F_67_CATGTTGTCG	AATGATACGGCGACCACCGAGATCTACACCATGTTGTCGGCTGGTGCTGCAGCTTATTA
s2_F_68_AGTGTCTATG	AATGATACGGCGACCACCGAGATCTACACAGTGTCTATGGCTGGTGCTGCAGCTTATTA
s2_F_69_GCAAGCTGTT	AATGATACGGCGACCACCGAGATCTACACGCAAGCTGTTGCTGGTGCTGCAGCTTATTA
s2_F_70_ACATGGTCTT	AATGATACGGCGACCACCGAGATCTACACACATGGTCTTGCTGGTGCTGCAGCTTATTA
s2_F_71_TAGTATACGG	AATGATACGGCGACCACCGAGATCTACACTAGTATACGGGCTGGTGCTGCAGCTTATTA
s2_F_72_AAGGCCTCTA	AATGATACGGCGACCACCGAGATCTACACAAGGCCTCTAGCTGGTGCTGCAGCTTATTA
s2_F_73_ACGACACACG	AATGATACGGCGACCACCGAGATCTACACACGACACACGGCTGGTGCTGCAGCTTATTA
s2_F_74_ATCGAGAAGA	AATGATACGGCGACCACCGAGATCTACACATCGAGAAGAGCTGGTGCTGCAGCTTATTA
s2_F_75_ACTAGGTCTA	AATGATACGGCGACCACCGAGATCTACACACTAGGTCTAGCTGGTGCTGCAGCTTATTA
s2_F_76_AACGGATCTA	AATGATACGGCGACCACCGAGATCTACACAACGGATCTAGCTGGTGCTGCAGCTTATTA
s2_F_77_ATTCTGTCCG	AATGATACGGCGACCACCGAGATCTACACATTCTGTCCGGCTGGTGCTGCAGCTTATTA
s2_F_78_ACTGTGGCCT	AATGATACGGCGACCACCGAGATCTACACACTGTGGCCTGCTGGTGCTGCAGCTTATTA
s2_F_79_CACACCTGGA	AATGATACGGCGACCACCGAGATCTACACCACACCTGGAGCTGGTGCTGCAGCTTATTA
s2_F_80_CACGGTATCA	AATGATACGGCGACCACCGAGATCTACACCACGGTATCAGCTGGTGCTGCAGCTTATTA
s2_F_81_TCAAGCAACG	AATGATACGGCGACCACCGAGATCTACACTCAAGCAACGGCTGGTGCTGCAGCTTATTA
s2_F_82_ACGAGTTGCG	AATGATACGGCGACCACCGAGATCTACACACGAGTTGCGGCTGGTGCTGCAGCTTATTA
s2_F_83_AGATCAGAGG	AATGATACGGCGACCACCGAGATCTACACAGATCAGAGGGCTGGTGCTGCAGCTTATTA
s2_F_84_CAATCTAGCG	AATGATACGGCGACCACCGAGATCTACACCAATCTAGCGGCTGGTGCTGCAGCTTATTA
s2_F_85_AACGGCCTAA	AATGATACGGCGACCACCGAGATCTACACAACGGCCTAAGCTGGTGCTGCAGCTTATTA
s2_F_86_ACGTTCATCG	AATGATACGGCGACCACCGAGATCTACACACGTTCATCGGCTGGTGCTGCAGCTTATTA
s2_F_87_AAGACCTTGG	AATGATACGGCGACCACCGAGATCTACACAAGACCTTGGGCTGGTGCTGCAGCTTATTA
s2_F_88_CCGATCAGTA	AATGATACGGCGACCACCGAGATCTACACCCGATCAGTAGCTGGTGCTGCAGCTTATTA
s2_F_89_AGGTGTCCAG	AATGATACGGCGACCACCGAGATCTACACAGGTGTCCAGGCTGGTGCTGCAGCTTATTA
s2_F_90_CTATGTACCG	AATGATACGGCGACCACCGAGATCTACACCTATGTACCGGCTGGTGCTGCAGCTTATTA
s2_F_91_ACAGATTCCG	AATGATACGGCGACCACCGAGATCTACACACAGATTCCGGCTGGTGCTGCAGCTTATTA
s2_F_92_AAGGAGATCA	AATGATACGGCGACCACCGAGATCTACACAAGGAGATCAGCTGGTGCTGCAGCTTATTA
s2_F_93_AATGCACGTA	AATGATACGGCGACCACCGAGATCTACACAATGCACGTAGCTGGTGCTGCAGCTTATTA
s2_F_94_GTTCTGGATG	AATGATACGGCGACCACCGAGATCTACACGTTCTGGATGGCTGGTGCTGCAGCTTATTA
s2_F_95_ATGGTAGTGG	AATGATACGGCGACCACCGAGATCTACACATGGTAGTGGGCTGGTGCTGCAGCTTATTA
s2_F_96_ATAGCTCTCT	AATGATACGGCGACCACCGAGATCTACACATAGCTCTCTGCTGGTGCTGCAGCTTATTA
s2_F_97_AAGGTGACGT	AATGATACGGCGACCACCGAGATCTACACAAGGTGACGTGCTGGTGCTGCAGCTTATTA
s2_F_98_ATTAGTACGG	AATGATACGGCGACCACCGAGATCTACACATTAGTACGGGCTGGTGCTGCAGCTTATTA
s2_F_99_AGACATTGGT	AATGATACGGCGACCACCGAGATCTACACAGACATTGGTGCTGGTGCTGCAGCTTATTA
s2_F_100_GATTGTCGTA	AATGATACGGCGACCACCGAGATCTACACGATTGTCGTAGCTGGTGCTGCAGCTTATTA
s2_F_101_AACTGTCCGG	AATGATACGGCGACCACCGAGATCTACACAACTGTCCGGGCTGGTGCTGCAGCTTATTA
s2_F_102_CGTGTAATTG	AATGATACGGCGACCACCGAGATCTACACCGTGTAATTGGCTGGTGCTGCAGCTTATTA
s2_F_103_ATGTCATACG	AATGATACGGCGACCACCGAGATCTACACATGTCATACGGCTGGTGCTGCAGCTTATTA
s2_F_104_CACTAGGATA	AATGATACGGCGACCACCGAGATCTACACCACTAGGATAGCTGGTGCTGCAGCTTATTA
s2_F_105_AATACGAGCG	AATGATACGGCGACCACCGAGATCTACACAATACGAGCGGCTGGTGCTGCAGCTTATTA
s2_F_106_ACACAATTCG	AATGATACGGCGACCACCGAGATCTACACACACAATTCGGCTGGTGCTGCAGCTTATTA
s2_F_107_CTGTGTTCAA	AATGATACGGCGACCACCGAGATCTACACCTGTGTTCAAGCTGGTGCTGCAGCTTATTA
s2_F_108_AGAAGGTCTG	AATGATACGGCGACCACCGAGATCTACACAGAAGGTCTGGCTGGTGCTGCAGCTTATTA
s2_F_109_AGTGCCAACG	AATGATACGGCGACCACCGAGATCTACACAGTGCCAACGGCTGGTGCTGCAGCTTATTA
s2_F_110_AGTGTTCTCT	AATGATACGGCGACCACCGAGATCTACACAGTGTTCTCTGCTGGTGCTGCAGCTTATTA
s2_F_111_CCGTGTTGTA	AATGATACGGCGACCACCGAGATCTACACCCGTGTTGTAGCTGGTGCTGCAGCTTATTA
s2_F_112_ACTGTGACGG	AATGATACGGCGACCACCGAGATCTACACACTGTGACGGGCTGGTGCTGCAGCTTATTA
s2_F_113_AACAGTGACG	AATGATACGGCGACCACCGAGATCTACACAACAGTGACGGCTGGTGCTGCAGCTTATTA
s2_F_114_CGTAACGTGG	AATGATACGGCGACCACCGAGATCTACACCGTAACGTGGGCTGGTGCTGCAGCTTATTA
s2_F_115_ATATGACGGA	AATGATACGGCGACCACCGAGATCTACACATATGACGGAGCTGGTGCTGCAGCTTATTA
s2_F_116_TTATCTTGCG	AATGATACGGCGACCACCGAGATCTACACTTATCTTGCGGCTGGTGCTGCAGCTTATTA
s2_F_117_CTAGTATTCG	AATGATACGGCGACCACCGAGATCTACACCTAGTATTCGGCTGGTGCTGCAGCTTATTA
s2_F_118_AATAGCTACG	AATGATACGGCGACCACCGAGATCTACACAATAGCTACGGCTGGTGCTGCAGCTTATTA
s2_F_119_AACGGAGAGG	AATGATACGGCGACCACCGAGATCTACACAACGGAGAGGGCTGGTGCTGCAGCTTATTA
s2_F_120_ATGTCGAGAG	AATGATACGGCGACCACCGAGATCTACACATGTCGAGAGGCTGGTGCTGCAGCTTATTA
s2_F_121_AGTGAGAGAG	AATGATACGGCGACCACCGAGATCTACACAGTGAGAGAGGCTGGTGCTGCAGCTTATTA
s2_F_122_CAACGTCTAA	AATGATACGGCGACCACCGAGATCTACACCAACGTCTAAGCTGGTGCTGCAGCTTATTA
s2_F_123_AAGCTTAGGA	AATGATACGGCGACCACCGAGATCTACACAAGCTTAGGAGCTGGTGCTGCAGCTTATTA
s2_F_124_GAACAAGTGG	AATGATACGGCGACCACCGAGATCTACACGAACAAGTGGGCTGGTGCTGCAGCTTATTA
s2_F_125_CTTGGAACCG	AATGATACGGCGACCACCGAGATCTACACCTTGGAACCGGCTGGTGCTGCAGCTTATTA
s2_F_126_ACCATATCGA	AATGATACGGCGACCACCGAGATCTACACACCATATCGAGCTGGTGCTGCAGCTTATTA
s2_F_127_ACAGGAAGCG	AATGATACGGCGACCACCGAGATCTACACACAGGAAGCGGCTGGTGCTGCAGCTTATTA
s2_F_128_ATGCTTATCG	AATGATACGGCGACCACCGAGATCTACACATGCTTATCGGCTGGTGCTGCAGCTTATTA
s2_F_129_ATGAACGGAA	AATGATACGGCGACCACCGAGATCTACACATGAACGGAAGCTGGTGCTGCAGCTTATTA
s2_F_130_ACTGTTCTTG	AATGATACGGCGACCACCGAGATCTACACACTGTTCTTGGCTGGTGCTGCAGCTTATTA
s2_F_131_CCTTGCTTCG	AATGATACGGCGACCACCGAGATCTACACCCTTGCTTCGGCTGGTGCTGCAGCTTATTA
s2_F_132_CGACATACCG	AATGATACGGCGACCACCGAGATCTACACCGACATACCGGCTGGTGCTGCAGCTTATTA
s2_F_133_ACTATTAGCG	AATGATACGGCGACCACCGAGATCTACACACTATTAGCGGCTGGTGCTGCAGCTTATTA
s2_F_134_AGTTAGATCG	AATGATACGGCGACCACCGAGATCTACACAGTTAGATCGGCTGGTGCTGCAGCTTATTA
s2_F_135_AGGAACATCG	AATGATACGGCGACCACCGAGATCTACACAGGAACATCGGCTGGTGCTGCAGCTTATTA
s2_F_136_CAGTGTATCT	AATGATACGGCGACCACCGAGATCTACACCAGTGTATCTGCTGGTGCTGCAGCTTATTA
s2_F_137_CTAATCGGTA	AATGATACGGCGACCACCGAGATCTACACCTAATCGGTAGCTGGTGCTGCAGCTTATTA
s2_F_138_ATCAGTGTTG	AATGATACGGCGACCACCGAGATCTACACATCAGTGTTGGCTGGTGCTGCAGCTTATTA
s2_F_139_TCTAGTCGGA	AATGATACGGCGACCACCGAGATCTACACTCTAGTCGGAGCTGGTGCTGCAGCTTATTA
s2_F_140_GCCTTCATCA	AATGATACGGCGACCACCGAGATCTACACGCCTTCATCAGCTGGTGCTGCAGCTTATTA
s2_F_141_CCAACTAACG	AATGATACGGCGACCACCGAGATCTACACCCAACTAACGGCTGGTGCTGCAGCTTATTA
s2_F_142_ACTATCTCTG	AATGATACGGCGACCACCGAGATCTACACACTATCTCTGGCTGGTGCTGCAGCTTATTA
s2_F_143_CCAGGTTGTT	AATGATACGGCGACCACCGAGATCTACACCCAGGTTGTTGCTGGTGCTGCAGCTTATTA
s2_F_144_ACACGGTTAA	AATGATACGGCGACCACCGAGATCTACACACACGGTTAAGCTGGTGCTGCAGCTTATTA
s2_F_145_GAAGTGTGTT	AATGATACGGCGACCACCGAGATCTACACGAAGTGTGTTGCTGGTGCTGCAGCTTATTA
s2_F_146_AGGAATTCGG	AATGATACGGCGACCACCGAGATCTACACAGGAATTCGGGCTGGTGCTGCAGCTTATTA
s2_F_147_AAGTTGAGCG	AATGATACGGCGACCACCGAGATCTACACAAGTTGAGCGGCTGGTGCTGCAGCTTATTA
s2_F_148_CTGGATCAGA	AATGATACGGCGACCACCGAGATCTACACCTGGATCAGAGCTGGTGCTGCAGCTTATTA
s2_F_149_ATGTTCTGAG	AATGATACGGCGACCACCGAGATCTACACATGTTCTGAGGCTGGTGCTGCAGCTTATTA
s2_F_150_CACATGGTCA	AATGATACGGCGACCACCGAGATCTACACCACATGGTCAGCTGGTGCTGCAGCTTATTA
s2_F_151_ACTTCGTGCG	AATGATACGGCGACCACCGAGATCTACACACTTCGTGCGGCTGGTGCTGCAGCTTATTA
s2_F_152_CAGTACGATG	AATGATACGGCGACCACCGAGATCTACACCAGTACGATGGCTGGTGCTGCAGCTTATTA
s2_F_153_ACTTAAGTCG	AATGATACGGCGACCACCGAGATCTACACACTTAAGTCGGCTGGTGCTGCAGCTTATTA
s2_F_154_AATGGTCTGA	AATGATACGGCGACCACCGAGATCTACACAATGGTCTGAGCTGGTGCTGCAGCTTATTA
s2_F_155_CCAACTGGTT	AATGATACGGCGACCACCGAGATCTACACCCAACTGGTTGCTGGTGCTGCAGCTTATTA
s2_F_156_TAGGATTACG	AATGATACGGCGACCACCGAGATCTACACTAGGATTACGGCTGGTGCTGCAGCTTATTA
s2_F_157_GTTCGGCTCT	AATGATACGGCGACCACCGAGATCTACACGTTCGGCTCTGCTGGTGCTGCAGCTTATTA
s2_F_158_ACATGAGTGG	AATGATACGGCGACCACCGAGATCTACACACATGAGTGGGCTGGTGCTGCAGCTTATTA
s2_F_159_ACGCATGGAA	AATGATACGGCGACCACCGAGATCTACACACGCATGGAAGCTGGTGCTGCAGCTTATTA
s2_F_160_ACAGCGTGAA	AATGATACGGCGACCACCGAGATCTACACACAGCGTGAAGCTGGTGCTGCAGCTTATTA
s2_F_161_CACGTATCGT	AATGATACGGCGACCACCGAGATCTACACCACGTATCGTGCTGGTGCTGCAGCTTATTA
s2_F_162_ATGTTGCGGA	AATGATACGGCGACCACCGAGATCTACACATGTTGCGGAGCTGGTGCTGCAGCTTATTA
s2_F_163_AATCGTGAGA	AATGATACGGCGACCACCGAGATCTACACAATCGTGAGAGCTGGTGCTGCAGCTTATTA
s2_F_164_CAGTGAACGG	AATGATACGGCGACCACCGAGATCTACACCAGTGAACGGGCTGGTGCTGCAGCTTATTA
s2_F_165_CGGATAATGG	AATGATACGGCGACCACCGAGATCTACACCGGATAATGGGCTGGTGCTGCAGCTTATTA
s2_F_166_CACCTTATCG	AATGATACGGCGACCACCGAGATCTACACCACCTTATCGGCTGGTGCTGCAGCTTATTA
s2_F_167_AAGCGTACGG	AATGATACGGCGACCACCGAGATCTACACAAGCGTACGGGCTGGTGCTGCAGCTTATTA
s2_F_168_AACGTCAACG	AATGATACGGCGACCACCGAGATCTACACAACGTCAACGGCTGGTGCTGCAGCTTATTA
s2_F_169_TACGAGGTAA	AATGATACGGCGACCACCGAGATCTACACTACGAGGTAAGCTGGTGCTGCAGCTTATTA
s2_F_170_CCGAGTGCAA	AATGATACGGCGACCACCGAGATCTACACCCGAGTGCAAGCTGGTGCTGCAGCTTATTA
s2_F_171_CCACTGATCT	AATGATACGGCGACCACCGAGATCTACACCCACTGATCTGCTGGTGCTGCAGCTTATTA
s2_F_172_ACATACCACG	AATGATACGGCGACCACCGAGATCTACACACATACCACGGCTGGTGCTGCAGCTTATTA
s2_F_173_GGATCATTGG	AATGATACGGCGACCACCGAGATCTACACGGATCATTGGGCTGGTGCTGCAGCTTATTA
s2_F_174_ATCGTTCGTA	AATGATACGGCGACCACCGAGATCTACACATCGTTCGTAGCTGGTGCTGCAGCTTATTA
s2_F_175_ATATGCGACG	AATGATACGGCGACCACCGAGATCTACACATATGCGACGGCTGGTGCTGCAGCTTATTA
s2_F_176_AGGAGAGGTA	AATGATACGGCGACCACCGAGATCTACACAGGAGAGGTAGCTGGTGCTGCAGCTTATTA
s2_F_177_GACATAATCG	AATGATACGGCGACCACCGAGATCTACACGACATAATCGGCTGGTGCTGCAGCTTATTA
s2_F_178_ATGGATCTCA	AATGATACGGCGACCACCGAGATCTACACATGGATCTCAGCTGGTGCTGCAGCTTATTA
s2_F_179_GATCTGAGGA	AATGATACGGCGACCACCGAGATCTACACGATCTGAGGAGCTGGTGCTGCAGCTTATTA
s2_F_180_ATGTTGTTGG	AATGATACGGCGACCACCGAGATCTACACATGTTGTTGGGCTGGTGCTGCAGCTTATTA
s2_F_181_GTTCTCATCG	AATGATACGGCGACCACCGAGATCTACACGTTCTCATCGGCTGGTGCTGCAGCTTATTA
s2_F_182_ACAGGTGTTA	AATGATACGGCGACCACCGAGATCTACACACAGGTGTTAGCTGGTGCTGCAGCTTATTA
s2_F_183_CATCGATCAA	AATGATACGGCGACCACCGAGATCTACACCATCGATCAAGCTGGTGCTGCAGCTTATTA
s2_F_184_AACATTCGGA	AATGATACGGCGACCACCGAGATCTACACAACATTCGGAGCTGGTGCTGCAGCTTATTA
s2_F_185_AACGGCTTGG	AATGATACGGCGACCACCGAGATCTACACAACGGCTTGGGCTGGTGCTGCAGCTTATTA
s2_F_186_TGGTCTATCG	AATGATACGGCGACCACCGAGATCTACACTGGTCTATCGGCTGGTGCTGCAGCTTATTA
s2_F_187_AATGCAATCG	AATGATACGGCGACCACCGAGATCTACACAATGCAATCGGCTGGTGCTGCAGCTTATTA
s2_F_188_CAACACTTCG	AATGATACGGCGACCACCGAGATCTACACCAACACTTCGGCTGGTGCTGCAGCTTATTA
s2_F_189_ATATCACCGT	AATGATACGGCGACCACCGAGATCTACACATATCACCGTGCTGGTGCTGCAGCTTATTA
s2_F_190_GAACCTGTCG	AATGATACGGCGACCACCGAGATCTACACGAACCTGTCGGCTGGTGCTGCAGCTTATTA
s2_F_191_ACACAGCGTA	AATGATACGGCGACCACCGAGATCTACACACACAGCGTAGCTGGTGCTGCAGCTTATTA
s2_F_192_TGAGGATAGA	AATGATACGGCGACCACCGAGATCTACACTGAGGATAGAGCTGGTGCTGCAGCTTATTA
s2_F_193_ATCGACTGTT	AATGATACGGCGACCACCGAGATCTACACATCGACTGTTGCTGGTGCTGCAGCTTATTA
s2_F_194_AGACTTACGG	AATGATACGGCGACCACCGAGATCTACACAGACTTACGGGCTGGTGCTGCAGCTTATTA
s2_F_195_ACATCATCCG	AATGATACGGCGACCACCGAGATCTACACACATCATCCGGCTGGTGCTGCAGCTTATTA
s2_F_196_AATCAGAACG	AATGATACGGCGACCACCGAGATCTACACAATCAGAACGGCTGGTGCTGCAGCTTATTA
s2_F_197_AGTAGTTGGT	AATGATACGGCGACCACCGAGATCTACACAGTAGTTGGTGCTGGTGCTGCAGCTTATTA
s2_F_198_GAGATTCCGG	AATGATACGGCGACCACCGAGATCTACACGAGATTCCGGGCTGGTGCTGCAGCTTATTA
s2_F_199_CAGTAGAGTT	AATGATACGGCGACCACCGAGATCTACACCAGTAGAGTTGCTGGTGCTGCAGCTTATTA
s2_F_200_GAGTTCTATC	AATGATACGGCGACCACCGAGATCTACACGAGTTCTATCGCTGGTGCTGCAGCTTATTA
s2_F_201_ATAGATGCGG	AATGATACGGCGACCACCGAGATCTACACATAGATGCGGGCTGGTGCTGCAGCTTATTA
s2_F_202_AGATCGGCCA	AATGATACGGCGACCACCGAGATCTACACAGATCGGCCAGCTGGTGCTGCAGCTTATTA
s2_F_203_AGCTAGTGAT	AATGATACGGCGACCACCGAGATCTACACAGCTAGTGATGCTGGTGCTGCAGCTTATTA
s2_F_204_ACTCACTACG	AATGATACGGCGACCACCGAGATCTACACACTCACTACGGCTGGTGCTGCAGCTTATTA
s2_F_205_AGGTGAGGAT	AATGATACGGCGACCACCGAGATCTACACAGGTGAGGATGCTGGTGCTGCAGCTTATTA
s2_F_206_AAGCTGTCTA	AATGATACGGCGACCACCGAGATCTACACAAGCTGTCTAGCTGGTGCTGCAGCTTATTA
s2_F_207_CCACGCATGA	AATGATACGGCGACCACCGAGATCTACACCCACGCATGAGCTGGTGCTGCAGCTTATTA
s2_F_208_AGACGGATAG	AATGATACGGCGACCACCGAGATCTACACAGACGGATAGGCTGGTGCTGCAGCTTATTA
s2_F_209_CTCCTATACG	AATGATACGGCGACCACCGAGATCTACACCTCCTATACGGCTGGTGCTGCAGCTTATTA
s2_F_210_GTAAGATTGG	AATGATACGGCGACCACCGAGATCTACACGTAAGATTGGGCTGGTGCTGCAGCTTATTA
s2_F_211_AAGCTATCCG	AATGATACGGCGACCACCGAGATCTACACAAGCTATCCGGCTGGTGCTGCAGCTTATTA
s2_F_212_CAACTGGTAA	AATGATACGGCGACCACCGAGATCTACACCAACTGGTAAGCTGGTGCTGCAGCTTATTA
s2_F_213_GTAATGGCCA	AATGATACGGCGACCACCGAGATCTACACGTAATGGCCAGCTGGTGCTGCAGCTTATTA
s2_F_214_GACTGTAGCG	AATGATACGGCGACCACCGAGATCTACACGACTGTAGCGGCTGGTGCTGCAGCTTATTA
s2_F_215_ACATGTCAGA	AATGATACGGCGACCACCGAGATCTACACACATGTCAGAGCTGGTGCTGCAGCTTATTA
s2_F_216_ACGGCTATAA	AATGATACGGCGACCACCGAGATCTACACACGGCTATAAGCTGGTGCTGCAGCTTATTA
s2_F_217_GGCTAATCCT	AATGATACGGCGACCACCGAGATCTACACGGCTAATCCTGCTGGTGCTGCAGCTTATTA
s2_F_218_GGCTACGAAG	AATGATACGGCGACCACCGAGATCTACACGGCTACGAAGGCTGGTGCTGCAGCTTATTA
s2_F_219_GGCTTCCTAT	AATGATACGGCGACCACCGAGATCTACACGGCTTCCTATGCTGGTGCTGCAGCTTATTA
s2_F_220_ACATTGTTCG	AATGATACGGCGACCACCGAGATCTACACACATTGTTCGGCTGGTGCTGCAGCTTATTA
s2_F_221_ACTCCGGTAA	AATGATACGGCGACCACCGAGATCTACACACTCCGGTAAGCTGGTGCTGCAGCTTATTA
s2_F_222_CCGTGGATCA	AATGATACGGCGACCACCGAGATCTACACCCGTGGATCAGCTGGTGCTGCAGCTTATTA
s2_F_223_AAGACCAACG	AATGATACGGCGACCACCGAGATCTACACAAGACCAACGGCTGGTGCTGCAGCTTATTA
s2_F_224_TCTAAGGACG	AATGATACGGCGACCACCGAGATCTACACTCTAAGGACGGCTGGTGCTGCAGCTTATTA
s2_F_225_CGAGATCTTA	AATGATACGGCGACCACCGAGATCTACACCGAGATCTTAGCTGGTGCTGCAGCTTATTA
s2_F_226_GAATGTTACG	AATGATACGGCGACCACCGAGATCTACACGAATGTTACGGCTGGTGCTGCAGCTTATTA
s2_F_227_GTATAGCTCT	AATGATACGGCGACCACCGAGATCTACACGTATAGCTCTGCTGGTGCTGCAGCTTATTA
s2_F_228_CGTAAGCGTA	AATGATACGGCGACCACCGAGATCTACACCGTAAGCGTAGCTGGTGCTGCAGCTTATTA
s2_F_229_TCCTTCCACG	AATGATACGGCGACCACCGAGATCTACACTCCTTCCACGGCTGGTGCTGCAGCTTATTA
s2_F_230_ACGAGGTTGA	AATGATACGGCGACCACCGAGATCTACACACGAGGTTGAGCTGGTGCTGCAGCTTATTA
s2_F_231_CGTATAGCGG	AATGATACGGCGACCACCGAGATCTACACCGTATAGCGGGCTGGTGCTGCAGCTTATTA
s2_F_232_TAACCGTTCG	AATGATACGGCGACCACCGAGATCTACACTAACCGTTCGGCTGGTGCTGCAGCTTATTA
s2_F_233_AAGTTCTACG	AATGATACGGCGACCACCGAGATCTACACAAGTTCTACGGCTGGTGCTGCAGCTTATTA
s2_F_234_AGAGCGATCG	AATGATACGGCGACCACCGAGATCTACACAGAGCGATCGGCTGGTGCTGCAGCTTATTA
s2_F_235_CAAGCTTCCT	AATGATACGGCGACCACCGAGATCTACACCAAGCTTCCTGCTGGTGCTGCAGCTTATTA
s2_F_236_CACGCATACG	AATGATACGGCGACCACCGAGATCTACACCACGCATACGGCTGGTGCTGCAGCTTATTA
s2_F_237_ACATTCACGG	AATGATACGGCGACCACCGAGATCTACACACATTCACGGGCTGGTGCTGCAGCTTATTA
s2_F_238_AACTCTCTGT	AATGATACGGCGACCACCGAGATCTACACAACTCTCTGTGCTGGTGCTGCAGCTTATTA
s2_F_239_AGCAGTAGAG	AATGATACGGCGACCACCGAGATCTACACAGCAGTAGAGGCTGGTGCTGCAGCTTATTA
s2_F_240_ATCGGACAAG	AATGATACGGCGACCACCGAGATCTACACATCGGACAAGGCTGGTGCTGCAGCTTATTA
s2_F_241_ATCACCGTAA	AATGATACGGCGACCACCGAGATCTACACATCACCGTAAGCTGGTGCTGCAGCTTATTA
s2_F_242_CCAGTATGTA	AATGATACGGCGACCACCGAGATCTACACCCAGTATGTAGCTGGTGCTGCAGCTTATTA
s2_F_243_CGGTTCCTAA	AATGATACGGCGACCACCGAGATCTACACCGGTTCCTAAGCTGGTGCTGCAGCTTATTA
s2_F_244_CATAACACCG	AATGATACGGCGACCACCGAGATCTACACCATAACACCGGCTGGTGCTGCAGCTTATTA
s2_F_245_AACCACGACG	AATGATACGGCGACCACCGAGATCTACACAACCACGACGGCTGGTGCTGCAGCTTATTA
s2_F_246_AGCTAATGGA	AATGATACGGCGACCACCGAGATCTACACAGCTAATGGAGCTGGTGCTGCAGCTTATTA
s2_F_247_CGAGGTAGAG	AATGATACGGCGACCACCGAGATCTACACCGAGGTAGAGGCTGGTGCTGCAGCTTATTA
s2_F_248_GGATCCAATG	AATGATACGGCGACCACCGAGATCTACACGGATCCAATGGCTGGTGCTGCAGCTTATTA
s2_F_249_GGCAATCTTG	AATGATACGGCGACCACCGAGATCTACACGGCAATCTTGGCTGGTGCTGCAGCTTATTA
s2_F_250_AATATGGCCA	AATGATACGGCGACCACCGAGATCTACACAATATGGCCAGCTGGTGCTGCAGCTTATTA
s2_F_251_TCAAGCGGTA	AATGATACGGCGACCACCGAGATCTACACTCAAGCGGTAGCTGGTGCTGCAGCTTATTA
s2_F_252_CTCAATTGGT	AATGATACGGCGACCACCGAGATCTACACCTCAATTGGTGCTGGTGCTGCAGCTTATTA
s2_F_253_CAACCGGACT	AATGATACGGCGACCACCGAGATCTACACCAACCGGACTGCTGGTGCTGCAGCTTATTA
s2_F_254_ACTTCGGCAT	AATGATACGGCGACCACCGAGATCTACACACTTCGGCATGCTGGTGCTGCAGCTTATTA
s2_F_255_CTGATGCAAG	AATGATACGGCGACCACCGAGATCTACACCTGATGCAAGGCTGGTGCTGCAGCTTATTA
s2_F_256_AGATAGTCCG	AATGATACGGCGACCACCGAGATCTACACAGATAGTCCGGCTGGTGCTGCAGCTTATTA
s2_F_257_ACCAGGCTTA	AATGATACGGCGACCACCGAGATCTACACACCAGGCTTAGCTGGTGCTGCAGCTTATTA
s2_F_258_GCATATTCGG	AATGATACGGCGACCACCGAGATCTACACGCATATTCGGGCTGGTGCTGCAGCTTATTA
s2_F_259_GACGCACAGA	AATGATACGGCGACCACCGAGATCTACACGACGCACAGAGCTGGTGCTGCAGCTTATTA
s2_F_260_GGCCTGCATT	AATGATACGGCGACCACCGAGATCTACACGGCCTGCATTGCTGGTGCTGCAGCTTATTA
s2_F_261_GTAGTGTGAA	AATGATACGGCGACCACCGAGATCTACACGTAGTGTGAAGCTGGTGCTGCAGCTTATTA
s2_F_262_TACATGGCGG	AATGATACGGCGACCACCGAGATCTACACTACATGGCGGGCTGGTGCTGCAGCTTATTA
s2_F_263_GATATGAACG	AATGATACGGCGACCACCGAGATCTACACGATATGAACGGCTGGTGCTGCAGCTTATTA
s2_F_264_GGCTCCATTA	AATGATACGGCGACCACCGAGATCTACACGGCTCCATTAGCTGGTGCTGCAGCTTATTA
s2_F_265_AGTCGTTACG	AATGATACGGCGACCACCGAGATCTACACAGTCGTTACGGCTGGTGCTGCAGCTTATTA
s2_F_266_CCATCGGATT	AATGATACGGCGACCACCGAGATCTACACCCATCGGATTGCTGGTGCTGCAGCTTATTA
s2_F_267_GTAAGGAGTA	AATGATACGGCGACCACCGAGATCTACACGTAAGGAGTAGCTGGTGCTGCAGCTTATTA
s2_F_268_GAAGATGCGT	AATGATACGGCGACCACCGAGATCTACACGAAGATGCGTGCTGGTGCTGCAGCTTATTA
s2_F_269_AGATCTTCAG	AATGATACGGCGACCACCGAGATCTACACAGATCTTCAGGCTGGTGCTGCAGCTTATTA
s2_F_270_CGATGAGGTA	AATGATACGGCGACCACCGAGATCTACACCGATGAGGTAGCTGGTGCTGCAGCTTATTA
s2_F_271_ATTGAATCGG	AATGATACGGCGACCACCGAGATCTACACATTGAATCGGGCTGGTGCTGCAGCTTATTA
s2_F_272_CAATCATCGG	AATGATACGGCGACCACCGAGATCTACACCAATCATCGGGCTGGTGCTGCAGCTTATTA
s2_F_273_GACCTATCGG	AATGATACGGCGACCACCGAGATCTACACGACCTATCGGGCTGGTGCTGCAGCTTATTA
s2_F_274_GAATCGGCAA	AATGATACGGCGACCACCGAGATCTACACGAATCGGCAAGCTGGTGCTGCAGCTTATTA
s2_F_275_AGACGTTAGA	AATGATACGGCGACCACCGAGATCTACACAGACGTTAGAGCTGGTGCTGCAGCTTATTA
s2_F_276_GGATACCTTG	AATGATACGGCGACCACCGAGATCTACACGGATACCTTGGCTGGTGCTGCAGCTTATTA
s2_F_277_TCTCATCACG	AATGATACGGCGACCACCGAGATCTACACTCTCATCACGGCTGGTGCTGCAGCTTATTA
s2_F_278_AAGCTTGCGT	AATGATACGGCGACCACCGAGATCTACACAAGCTTGCGTGCTGGTGCTGCAGCTTATTA
s2_F_279_CTACTTGTCG	AATGATACGGCGACCACCGAGATCTACACCTACTTGTCGGCTGGTGCTGCAGCTTATTA
s2_F_280_AGGAAGGCCT	AATGATACGGCGACCACCGAGATCTACACAGGAAGGCCTGCTGGTGCTGCAGCTTATTA
s2_F_281_AGTGATGTAG	AATGATACGGCGACCACCGAGATCTACACAGTGATGTAGGCTGGTGCTGCAGCTTATTA
s2_F_282_AGGCATGTCG	AATGATACGGCGACCACCGAGATCTACACAGGCATGTCGGCTGGTGCTGCAGCTTATTA
s2_F_283_ACAGACATCG	AATGATACGGCGACCACCGAGATCTACACACAGACATCGGCTGGTGCTGCAGCTTATTA
s2_F_284_AGGTAGGTAA	AATGATACGGCGACCACCGAGATCTACACAGGTAGGTAAGCTGGTGCTGCAGCTTATTA
s2_F_285_ATCGGCTACT	AATGATACGGCGACCACCGAGATCTACACATCGGCTACTGCTGGTGCTGCAGCTTATTA
s2_F_286_ACGGCCACTT	AATGATACGGCGACCACCGAGATCTACACACGGCCACTTGCTGGTGCTGCAGCTTATTA
s2_F_287_CAGAGCGGAA	AATGATACGGCGACCACCGAGATCTACACCAGAGCGGAAGCTGGTGCTGCAGCTTATTA
s2_F_288_CAAGTCCGTG	AATGATACGGCGACCACCGAGATCTACACCAAGTCCGTGGCTGGTGCTGCAGCTTATTA
s2_F_289_CGTCAATGCG	AATGATACGGCGACCACCGAGATCTACACCGTCAATGCGGCTGGTGCTGCAGCTTATTA
s2_F_290_GGATCATGCT	AATGATACGGCGACCACCGAGATCTACACGGATCATGCTGCTGGTGCTGCAGCTTATTA
s2_F_291_GTGTTAGAGT	AATGATACGGCGACCACCGAGATCTACACGTGTTAGAGTGCTGGTGCTGCAGCTTATTA
s2_F_292_ATCAAGCGTC	AATGATACGGCGACCACCGAGATCTACACATCAAGCGTCGCTGGTGCTGCAGCTTATTA
s2_F_293_AGGAATGTGA	AATGATACGGCGACCACCGAGATCTACACAGGAATGTGAGCTGGTGCTGCAGCTTATTA
s2_F_294_AACATGCGCG	AATGATACGGCGACCACCGAGATCTACACAACATGCGCGGCTGGTGCTGCAGCTTATTA
s2_F_295_AACTTAGGCG	AATGATACGGCGACCACCGAGATCTACACAACTTAGGCGGCTGGTGCTGCAGCTTATTA
s2_F_296_ATACGTACTG	AATGATACGGCGACCACCGAGATCTACACATACGTACTGGCTGGTGCTGCAGCTTATTA
s2_F_297_ATGGATGCCT	AATGATACGGCGACCACCGAGATCTACACATGGATGCCTGCTGGTGCTGCAGCTTATTA
s2_F_298_GCTAGATCGA	AATGATACGGCGACCACCGAGATCTACACGCTAGATCGAGCTGGTGCTGCAGCTTATTA
s2_F_299_AGTTACCGTA	AATGATACGGCGACCACCGAGATCTACACAGTTACCGTAGCTGGTGCTGCAGCTTATTA
s2_F_300_AGACTGCGTG	AATGATACGGCGACCACCGAGATCTACACAGACTGCGTGGCTGGTGCTGCAGCTTATTA
s2_F_301_GCATGAACGT	AATGATACGGCGACCACCGAGATCTACACGCATGAACGTGCTGGTGCTGCAGCTTATTA
s2_F_302_CGTGAGAACG	AATGATACGGCGACCACCGAGATCTACACCGTGAGAACGGCTGGTGCTGCAGCTTATTA
s2_F_303_CAGAGTAACG	AATGATACGGCGACCACCGAGATCTACACCAGAGTAACGGCTGGTGCTGCAGCTTATTA
s2_F_304_AGCGGTAAGG	AATGATACGGCGACCACCGAGATCTACACAGCGGTAAGGGCTGGTGCTGCAGCTTATTA
s2_F_305_ACATGGAGTA	AATGATACGGCGACCACCGAGATCTACACACATGGAGTAGCTGGTGCTGCAGCTTATTA
s2_F_306_GTGAGATTCA	AATGATACGGCGACCACCGAGATCTACACGTGAGATTCAGCTGGTGCTGCAGCTTATTA
s2_F_307_GGATAGAGCT	AATGATACGGCGACCACCGAGATCTACACGGATAGAGCTGCTGGTGCTGCAGCTTATTA
s2_F_308_ACTACTTCCG	AATGATACGGCGACCACCGAGATCTACACACTACTTCCGGCTGGTGCTGCAGCTTATTA
s2_F_309_ATGTATGTCC	AATGATACGGCGACCACCGAGATCTACACATGTATGTCCGCTGGTGCTGCAGCTTATTA
s2_F_310_AAGCGGATTG	AATGATACGGCGACCACCGAGATCTACACAAGCGGATTGGCTGGTGCTGCAGCTTATTA
s2_F_311_CACGGCTATG	AATGATACGGCGACCACCGAGATCTACACCACGGCTATGGCTGGTGCTGCAGCTTATTA
s2_F_312_CCTGCTTAAG	AATGATACGGCGACCACCGAGATCTACACCCTGCTTAAGGCTGGTGCTGCAGCTTATTA
s2_F_313_AAGACTTGTC	AATGATACGGCGACCACCGAGATCTACACAAGACTTGTCGCTGGTGCTGCAGCTTATTA
s2_F_314_GGCTGTCATA	AATGATACGGCGACCACCGAGATCTACACGGCTGTCATAGCTGGTGCTGCAGCTTATTA
s2_F_315_ACAGTATCGG	AATGATACGGCGACCACCGAGATCTACACACAGTATCGGGCTGGTGCTGCAGCTTATTA
s2_F_316_AAGCAGTGTT	AATGATACGGCGACCACCGAGATCTACACAAGCAGTGTTGCTGGTGCTGCAGCTTATTA
s2_F_317_CGATCTACGG	AATGATACGGCGACCACCGAGATCTACACCGATCTACGGGCTGGTGCTGCAGCTTATTA
s2_F_318_ACCTAACCGG	AATGATACGGCGACCACCGAGATCTACACACCTAACCGGGCTGGTGCTGCAGCTTATTA
s2_F_319_GGTACACAAG	AATGATACGGCGACCACCGAGATCTACACGGTACACAAGGCTGGTGCTGCAGCTTATTA
s2_F_320_ACGTTCGGAA	AATGATACGGCGACCACCGAGATCTACACACGTTCGGAAGCTGGTGCTGCAGCTTATTA
s2_F_321_AGGTACGTTG	AATGATACGGCGACCACCGAGATCTACACAGGTACGTTGGCTGGTGCTGCAGCTTATTA
s2_F_322_AGACCGGAGT	AATGATACGGCGACCACCGAGATCTACACAGACCGGAGTGCTGGTGCTGCAGCTTATTA
s2_F_323_CTGATCATTG	AATGATACGGCGACCACCGAGATCTACACCTGATCATTGGCTGGTGCTGCAGCTTATTA
s2_F_324_GGAGTGCCTA	AATGATACGGCGACCACCGAGATCTACACGGAGTGCCTAGCTGGTGCTGCAGCTTATTA
s2_F_325_CATCGGAACT	AATGATACGGCGACCACCGAGATCTACACCATCGGAACTGCTGGTGCTGCAGCTTATTA
s2_F_326_AGTTGTACCG	AATGATACGGCGACCACCGAGATCTACACAGTTGTACCGGCTGGTGCTGCAGCTTATTA
s2_F_327_ATTATCGCGA	AATGATACGGCGACCACCGAGATCTACACATTATCGCGAGCTGGTGCTGCAGCTTATTA
s2_F_328_TAATCCAACG	AATGATACGGCGACCACCGAGATCTACACTAATCCAACGGCTGGTGCTGCAGCTTATTA
s2_F_329_CTGGAACCAA	AATGATACGGCGACCACCGAGATCTACACCTGGAACCAAGCTGGTGCTGCAGCTTATTA
s2_F_330_ACCGAGCTTC	AATGATACGGCGACCACCGAGATCTACACACCGAGCTTCGCTGGTGCTGCAGCTTATTA
s2_F_331_AGCGTTGTTG	AATGATACGGCGACCACCGAGATCTACACAGCGTTGTTGGCTGGTGCTGCAGCTTATTA
s2_F_332_CACTCCGTTG	AATGATACGGCGACCACCGAGATCTACACCACTCCGTTGGCTGGTGCTGCAGCTTATTA
s2_F_333_ATCCTGATCT	AATGATACGGCGACCACCGAGATCTACACATCCTGATCTGCTGGTGCTGCAGCTTATTA
s2_F_334_AATTCCGTCG	AATGATACGGCGACCACCGAGATCTACACAATTCCGTCGGCTGGTGCTGCAGCTTATTA
s2_F_335_ATGCGATTCG	AATGATACGGCGACCACCGAGATCTACACATGCGATTCGGCTGGTGCTGCAGCTTATTA
s2_F_336_ACGGTACATG	AATGATACGGCGACCACCGAGATCTACACACGGTACATGGCTGGTGCTGCAGCTTATTA
s2_F_337_ACCAATCACG	AATGATACGGCGACCACCGAGATCTACACACCAATCACGGCTGGTGCTGCAGCTTATTA
s2_F_338_AGCATGGTAG	AATGATACGGCGACCACCGAGATCTACACAGCATGGTAGGCTGGTGCTGCAGCTTATTA
s2_F_339_CGGTAGACAT	AATGATACGGCGACCACCGAGATCTACACCGGTAGACATGCTGGTGCTGCAGCTTATTA
s2_F_340_TAGAATAGCG	AATGATACGGCGACCACCGAGATCTACACTAGAATAGCGGCTGGTGCTGCAGCTTATTA
s2_F_341_CTACTAACGG	AATGATACGGCGACCACCGAGATCTACACCTACTAACGGGCTGGTGCTGCAGCTTATTA
s2_F_342_GTCAGAATTG	AATGATACGGCGACCACCGAGATCTACACGTCAGAATTGGCTGGTGCTGCAGCTTATTA
s2_F_343_CTGCAACAGG	AATGATACGGCGACCACCGAGATCTACACCTGCAACAGGGCTGGTGCTGCAGCTTATTA
s2_F_344_TATCTTACGG	AATGATACGGCGACCACCGAGATCTACACTATCTTACGGGCTGGTGCTGCAGCTTATTA
s2_F_345_CCTATTCCGG	AATGATACGGCGACCACCGAGATCTACACCCTATTCCGGGCTGGTGCTGCAGCTTATTA
s2_F_346_AGAGCTCAGA	AATGATACGGCGACCACCGAGATCTACACAGAGCTCAGAGCTGGTGCTGCAGCTTATTA
s2_F_347_CCGTGATCTT	AATGATACGGCGACCACCGAGATCTACACCCGTGATCTTGCTGGTGCTGCAGCTTATTA
s2_F_348_CTGCATTCGG	AATGATACGGCGACCACCGAGATCTACACCTGCATTCGGGCTGGTGCTGCAGCTTATTA
s2_F_349_GGCTAGAACA	AATGATACGGCGACCACCGAGATCTACACGGCTAGAACAGCTGGTGCTGCAGCTTATTA
s2_F_350_CATTAGGTCT	AATGATACGGCGACCACCGAGATCTACACCATTAGGTCTGCTGGTGCTGCAGCTTATTA
s2_F_351_ACCAACGTCG	AATGATACGGCGACCACCGAGATCTACACACCAACGTCGGCTGGTGCTGCAGCTTATTA
s2_F_352_CGTTGTCGAG	AATGATACGGCGACCACCGAGATCTACACCGTTGTCGAGGCTGGTGCTGCAGCTTATTA
s2_F_353_AGGAAGCGGA	AATGATACGGCGACCACCGAGATCTACACAGGAAGCGGAGCTGGTGCTGCAGCTTATTA
s2_F_354_CAGATCTACC	AATGATACGGCGACCACCGAGATCTACACCAGATCTACCGCTGGTGCTGCAGCTTATTA
s2_F_355_GCTTATACGT	AATGATACGGCGACCACCGAGATCTACACGCTTATACGTGCTGGTGCTGCAGCTTATTA
s2_F_356_TCCATGTTCG	AATGATACGGCGACCACCGAGATCTACACTCCATGTTCGGCTGGTGCTGCAGCTTATTA
s2_F_357_TCCGATCTAG	AATGATACGGCGACCACCGAGATCTACACTCCGATCTAGGCTGGTGCTGCAGCTTATTA
s2_F_358_ATTGTCCGTG	AATGATACGGCGACCACCGAGATCTACACATTGTCCGTGGCTGGTGCTGCAGCTTATTA
s2_F_359_CGTGACTATA	AATGATACGGCGACCACCGAGATCTACACCGTGACTATAGCTGGTGCTGCAGCTTATTA
s2_F_360_CAGGTAAGAT	AATGATACGGCGACCACCGAGATCTACACCAGGTAAGATGCTGGTGCTGCAGCTTATTA
s2_F_361_CCAATCTTCG	AATGATACGGCGACCACCGAGATCTACACCCAATCTTCGGCTGGTGCTGCAGCTTATTA
s2_F_362_ATTACCGTGG	AATGATACGGCGACCACCGAGATCTACACATTACCGTGGGCTGGTGCTGCAGCTTATTA
s2_F_363_AGCATGTTGA	AATGATACGGCGACCACCGAGATCTACACAGCATGTTGAGCTGGTGCTGCAGCTTATTA
s2_F_364_AGTACTACGA	AATGATACGGCGACCACCGAGATCTACACAGTACTACGAGCTGGTGCTGCAGCTTATTA
s2_F_365_GTAGCACACG	AATGATACGGCGACCACCGAGATCTACACGTAGCACACGGCTGGTGCTGCAGCTTATTA
s2_F_366_CAGTCTTGGA	AATGATACGGCGACCACCGAGATCTACACCAGTCTTGGAGCTGGTGCTGCAGCTTATTA
s2_F_367_AAGAGAATCG	AATGATACGGCGACCACCGAGATCTACACAAGAGAATCGGCTGGTGCTGCAGCTTATTA
s2_F_368_AGACTGGTTA	AATGATACGGCGACCACCGAGATCTACACAGACTGGTTAGCTGGTGCTGCAGCTTATTA
s2_F_369_GCTTCGTTGA	AATGATACGGCGACCACCGAGATCTACACGCTTCGTTGAGCTGGTGCTGCAGCTTATTA
s2_F_370_AGTGTCGACT	AATGATACGGCGACCACCGAGATCTACACAGTGTCGACTGCTGGTGCTGCAGCTTATTA
s2_F_371_GAAGTGGCCT	AATGATACGGCGACCACCGAGATCTACACGAAGTGGCCTGCTGGTGCTGCAGCTTATTA
s2_F_372_ATGCATCGGA	AATGATACGGCGACCACCGAGATCTACACATGCATCGGAGCTGGTGCTGCAGCTTATTA
s2_F_373_ACCGGATGAA	AATGATACGGCGACCACCGAGATCTACACACCGGATGAAGCTGGTGCTGCAGCTTATTA
s2_F_374_GACGGAAGAA	AATGATACGGCGACCACCGAGATCTACACGACGGAAGAAGCTGGTGCTGCAGCTTATTA
s2_F_375_GACGGAGTGA	AATGATACGGCGACCACCGAGATCTACACGACGGAGTGAGCTGGTGCTGCAGCTTATTA
s2_F_376_CTGCAGAGAT	AATGATACGGCGACCACCGAGATCTACACCTGCAGAGATGCTGGTGCTGCAGCTTATTA
s2_F_377_CATGCATTCT	AATGATACGGCGACCACCGAGATCTACACCATGCATTCTGCTGGTGCTGCAGCTTATTA
s2_F_378_ATGTGCTAGG	AATGATACGGCGACCACCGAGATCTACACATGTGCTAGGGCTGGTGCTGCAGCTTATTA
s2_F_379_CCGTGGTAGA	AATGATACGGCGACCACCGAGATCTACACCCGTGGTAGAGCTGGTGCTGCAGCTTATTA
s2_F_380_CTGTACACCG	AATGATACGGCGACCACCGAGATCTACACCTGTACACCGGCTGGTGCTGCAGCTTATTA
s2_F_381_GTACGGCTGA	AATGATACGGCGACCACCGAGATCTACACGTACGGCTGAGCTGGTGCTGCAGCTTATTA
s2_F_382_CACGGTCTGT	AATGATACGGCGACCACCGAGATCTACACCACGGTCTGTGCTGGTGCTGCAGCTTATTA
s2_F_383_CTGGTCAACT	AATGATACGGCGACCACCGAGATCTACACCTGGTCAACTGCTGGTGCTGCAGCTTATTA
s2_F_384_CTCAAGTACG	AATGATACGGCGACCACCGAGATCTACACCTCAAGTACGGCTGGTGCTGCAGCTTATTA
s2_F_385_CTGGAATGTA	AATGATACGGCGACCACCGAGATCTACACCTGGAATGTAGCTGGTGCTGCAGCTTATTA
s2_F_386_AACTTGCTGG	AATGATACGGCGACCACCGAGATCTACACAACTTGCTGGGCTGGTGCTGCAGCTTATTA
s2_F_387_AAGATCGGAC	AATGATACGGCGACCACCGAGATCTACACAAGATCGGACGCTGGTGCTGCAGCTTATTA
s2_F_388_CCGGTAGATA	AATGATACGGCGACCACCGAGATCTACACCCGGTAGATAGCTGGTGCTGCAGCTTATTA
s2_F_389_CGTGTGTAAG	AATGATACGGCGACCACCGAGATCTACACCGTGTGTAAGGCTGGTGCTGCAGCTTATTA
s2_F_390_AGGATCGATG	AATGATACGGCGACCACCGAGATCTACACAGGATCGATGGCTGGTGCTGCAGCTTATTA
s2_F_391_GCGCAATTAA	AATGATACGGCGACCACCGAGATCTACACGCGCAATTAAGCTGGTGCTGCAGCTTATTA
s2_F_392_CACTTGTGTT	AATGATACGGCGACCACCGAGATCTACACCACTTGTGTTGCTGGTGCTGCAGCTTATTA
s2_F_393_CAATGAGATG	AATGATACGGCGACCACCGAGATCTACACCAATGAGATGGCTGGTGCTGCAGCTTATTA
s2_F_394_CTGACTATCG	AATGATACGGCGACCACCGAGATCTACACCTGACTATCGGCTGGTGCTGCAGCTTATTA
s2_F_395_GTCATTCACG	AATGATACGGCGACCACCGAGATCTACACGTCATTCACGGCTGGTGCTGCAGCTTATTA
s2_F_396_CATTGAAGCG	AATGATACGGCGACCACCGAGATCTACACCATTGAAGCGGCTGGTGCTGCAGCTTATTA
s2_F_397_CGGATCTTGC	AATGATACGGCGACCACCGAGATCTACACCGGATCTTGCGCTGGTGCTGCAGCTTATTA
s2_F_398_GTATCCGCCA	AATGATACGGCGACCACCGAGATCTACACGTATCCGCCAGCTGGTGCTGCAGCTTATTA
s2_F_399_CGGAGAAGGT	AATGATACGGCGACCACCGAGATCTACACCGGAGAAGGTGCTGGTGCTGCAGCTTATTA
s2_F_400_TGAACAATCG	AATGATACGGCGACCACCGAGATCTACACTGAACAATCGGCTGGTGCTGCAGCTTATTA
s2_F_401_GCGCAACCTA	AATGATACGGCGACCACCGAGATCTACACGCGCAACCTAGCTGGTGCTGCAGCTTATTA
s2_F_402_CGACGGCTTA	AATGATACGGCGACCACCGAGATCTACACCGACGGCTTAGCTGGTGCTGCAGCTTATTA
s2_F_403_ATGGCAAGAT	AATGATACGGCGACCACCGAGATCTACACATGGCAAGATGCTGGTGCTGCAGCTTATTA
s2_F_404_AACGGACGGA	AATGATACGGCGACCACCGAGATCTACACAACGGACGGAGCTGGTGCTGCAGCTTATTA
s2_F_405_GCTAATACCG	AATGATACGGCGACCACCGAGATCTACACGCTAATACCGGCTGGTGCTGCAGCTTATTA
s2_F_406_TGCGGACATT	AATGATACGGCGACCACCGAGATCTACACTGCGGACATTGCTGGTGCTGCAGCTTATTA
s2_F_407_ACCTAGATCA	AATGATACGGCGACCACCGAGATCTACACACCTAGATCAGCTGGTGCTGCAGCTTATTA
s2_F_408_GTAGGATGGT	AATGATACGGCGACCACCGAGATCTACACGTAGGATGGTGCTGGTGCTGCAGCTTATTA
s2_F_409_CAAGAGATCT	AATGATACGGCGACCACCGAGATCTACACCAAGAGATCTGCTGGTGCTGCAGCTTATTA
s2_F_410_ATCACTTGCG	AATGATACGGCGACCACCGAGATCTACACATCACTTGCGGCTGGTGCTGCAGCTTATTA
s2_F_411_GTTGGAGTAG	AATGATACGGCGACCACCGAGATCTACACGTTGGAGTAGGCTGGTGCTGCAGCTTATTA
s2_F_412_ACGTCGGATG	AATGATACGGCGACCACCGAGATCTACACACGTCGGATGGCTGGTGCTGCAGCTTATTA
s2_F_413_AGCGCTTCTT	AATGATACGGCGACCACCGAGATCTACACAGCGCTTCTTGCTGGTGCTGCAGCTTATTA
s2_F_414_AGCGCAGATA	AATGATACGGCGACCACCGAGATCTACACAGCGCAGATAGCTGGTGCTGCAGCTTATTA
s2_F_415_CATTCGGATG	AATGATACGGCGACCACCGAGATCTACACCATTCGGATGGCTGGTGCTGCAGCTTATTA
s2_F_416_CGAGAACGTG	AATGATACGGCGACCACCGAGATCTACACCGAGAACGTGGCTGGTGCTGCAGCTTATTA
s2_F_417_GTAGAGTAAG	AATGATACGGCGACCACCGAGATCTACACGTAGAGTAAGGCTGGTGCTGCAGCTTATTA
s2_F_418_GATCCATGGT	AATGATACGGCGACCACCGAGATCTACACGATCCATGGTGCTGGTGCTGCAGCTTATTA
s2_F_419_CGGAAGATAC	AATGATACGGCGACCACCGAGATCTACACCGGAAGATACGCTGGTGCTGCAGCTTATTA
s2_F_420_ATGGTGTCGA	AATGATACGGCGACCACCGAGATCTACACATGGTGTCGAGCTGGTGCTGCAGCTTATTA
s2_F_421_GCCTAATGCG	AATGATACGGCGACCACCGAGATCTACACGCCTAATGCGGCTGGTGCTGCAGCTTATTA
s2_F_422_GAGGTATGGA	AATGATACGGCGACCACCGAGATCTACACGAGGTATGGAGCTGGTGCTGCAGCTTATTA
s2_F_423_ATCGCGTACG	AATGATACGGCGACCACCGAGATCTACACATCGCGTACGGCTGGTGCTGCAGCTTATTA
s2_F_424_AACGGTCAAT	AATGATACGGCGACCACCGAGATCTACACAACGGTCAATGCTGGTGCTGCAGCTTATTA
s2_F_425_GGATCGAGTA	AATGATACGGCGACCACCGAGATCTACACGGATCGAGTAGCTGGTGCTGCAGCTTATTA
s2_F_426_AGGATCCGAA	AATGATACGGCGACCACCGAGATCTACACAGGATCCGAAGCTGGTGCTGCAGCTTATTA
s2_F_427_GATACTATCG	AATGATACGGCGACCACCGAGATCTACACGATACTATCGGCTGGTGCTGCAGCTTATTA
s2_F_428_GAGATCCGTC	AATGATACGGCGACCACCGAGATCTACACGAGATCCGTCGCTGGTGCTGCAGCTTATTA
s2_F_429_ACTCACAGGT	AATGATACGGCGACCACCGAGATCTACACACTCACAGGTGCTGGTGCTGCAGCTTATTA
s2_F_430_CTTCGGCACA	AATGATACGGCGACCACCGAGATCTACACCTTCGGCACAGCTGGTGCTGCAGCTTATTA
s2_F_431_ATCACGACCG	AATGATACGGCGACCACCGAGATCTACACATCACGACCGGCTGGTGCTGCAGCTTATTA
s2_F_432_TGAGCTTCCG	AATGATACGGCGACCACCGAGATCTACACTGAGCTTCCGGCTGGTGCTGCAGCTTATTA
s2_F_433_CTAGGTTCAT	AATGATACGGCGACCACCGAGATCTACACCTAGGTTCATGCTGGTGCTGCAGCTTATTA
s2_F_434_CAGTTCAGGT	AATGATACGGCGACCACCGAGATCTACACCAGTTCAGGTGCTGGTGCTGCAGCTTATTA
s2_F_435_GCGTATACAA	AATGATACGGCGACCACCGAGATCTACACGCGTATACAAGCTGGTGCTGCAGCTTATTA
s2_F_436_AGATGATCGG	AATGATACGGCGACCACCGAGATCTACACAGATGATCGGGCTGGTGCTGCAGCTTATTA
s2_F_437_GGCCTAAGAG	AATGATACGGCGACCACCGAGATCTACACGGCCTAAGAGGCTGGTGCTGCAGCTTATTA
s2_F_438_GGCAATTCCA	AATGATACGGCGACCACCGAGATCTACACGGCAATTCCAGCTGGTGCTGCAGCTTATTA
s2_F_439_CATTGAGTAG	AATGATACGGCGACCACCGAGATCTACACCATTGAGTAGGCTGGTGCTGCAGCTTATTA
s2_F_440_GAGCACTCTT	AATGATACGGCGACCACCGAGATCTACACGAGCACTCTTGCTGGTGCTGCAGCTTATTA
s2_F_441_CGACTATGGC	AATGATACGGCGACCACCGAGATCTACACCGACTATGGCGCTGGTGCTGCAGCTTATTA
s2_F_442_GGTAATGCGT	AATGATACGGCGACCACCGAGATCTACACGGTAATGCGTGCTGGTGCTGCAGCTTATTA
s2_F_443_ATCGTGATTC	AATGATACGGCGACCACCGAGATCTACACATCGTGATTCGCTGGTGCTGCAGCTTATTA
s2_F_444_CTGTGGCGAA	AATGATACGGCGACCACCGAGATCTACACCTGTGGCGAAGCTGGTGCTGCAGCTTATTA
s2_F_445_ACGGATTGGA	AATGATACGGCGACCACCGAGATCTACACACGGATTGGAGCTGGTGCTGCAGCTTATTA
s2_F_446_GGCAATACGG	AATGATACGGCGACCACCGAGATCTACACGGCAATACGGGCTGGTGCTGCAGCTTATTA
s2_F_447_CGTCAGTGGT	AATGATACGGCGACCACCGAGATCTACACCGTCAGTGGTGCTGGTGCTGCAGCTTATTA
s2_F_448_GCTGCTGGAT	AATGATACGGCGACCACCGAGATCTACACGCTGCTGGATGCTGGTGCTGCAGCTTATTA
s2_F_449_ACGGAACTAG	AATGATACGGCGACCACCGAGATCTACACACGGAACTAGGCTGGTGCTGCAGCTTATTA
s2_F_450_ACGGAGTATT	AATGATACGGCGACCACCGAGATCTACACACGGAGTATTGCTGGTGCTGCAGCTTATTA
s2_F_451_ACGGATAGAT	AATGATACGGCGACCACCGAGATCTACACACGGATAGATGCTGGTGCTGCAGCTTATTA
s2_F_452_CCGGAATCAT	AATGATACGGCGACCACCGAGATCTACACCCGGAATCATGCTGGTGCTGCAGCTTATTA
s2_F_453_CCGGATTCTA	AATGATACGGCGACCACCGAGATCTACACCCGGATTCTAGCTGGTGCTGCAGCTTATTA
s2_F_454_GCGGAACAGT	AATGATACGGCGACCACCGAGATCTACACGCGGAACAGTGCTGGTGCTGCAGCTTATTA
s2_F_455_CCTGCATCGA	AATGATACGGCGACCACCGAGATCTACACCCTGCATCGAGCTGGTGCTGCAGCTTATTA
s2_F_456_GGAACAGATT	AATGATACGGCGACCACCGAGATCTACACGGAACAGATTGCTGGTGCTGCAGCTTATTA
s2_F_457_GGAACTTCCT	AATGATACGGCGACCACCGAGATCTACACGGAACTTCCTGCTGGTGCTGCAGCTTATTA
s2_F_458_GGAAGAATGA	AATGATACGGCGACCACCGAGATCTACACGGAAGAATGAGCTGGTGCTGCAGCTTATTA
s2_F_459_GGAAGCCTTA	AATGATACGGCGACCACCGAGATCTACACGGAAGCCTTAGCTGGTGCTGCAGCTTATTA
s2_F_460_GGAAGTACAA	AATGATACGGCGACCACCGAGATCTACACGGAAGTACAAGCTGGTGCTGCAGCTTATTA
s2_F_461_GGAATGCAAG	AATGATACGGCGACCACCGAGATCTACACGGAATGCAAGGCTGGTGCTGCAGCTTATTA
s2_F_462_GGAGTTCTCA	AATGATACGGCGACCACCGAGATCTACACGGAGTTCTCAGCTGGTGCTGCAGCTTATTA
s2_F_463_GGATACCAGA	AATGATACGGCGACCACCGAGATCTACACGGATACCAGAGCTGGTGCTGCAGCTTATTA
s2_F_464_GGATGTGATT	AATGATACGGCGACCACCGAGATCTACACGGATGTGATTGCTGGTGCTGCAGCTTATTA
s2_F_465_ACTCGAGGTA	AATGATACGGCGACCACCGAGATCTACACACTCGAGGTAGCTGGTGCTGCAGCTTATTA
s2_F_466_CGGAACACGA	AATGATACGGCGACCACCGAGATCTACACCGGAACACGAGCTGGTGCTGCAGCTTATTA
s2_F_467_CGGAACTTAA	AATGATACGGCGACCACCGAGATCTACACCGGAACTTAAGCTGGTGCTGCAGCTTATTA
s2_F_468_CGGATACTCA	AATGATACGGCGACCACCGAGATCTACACCGGATACTCAGCTGGTGCTGCAGCTTATTA
s2_F_469_GACAACAACG	AATGATACGGCGACCACCGAGATCTACACGACAACAACGGCTGGTGCTGCAGCTTATTA
s2_F_470_AGGCCACATC	AATGATACGGCGACCACCGAGATCTACACAGGCCACATCGCTGGTGCTGCAGCTTATTA
s2_F_471_ACTATGTGAC	AATGATACGGCGACCACCGAGATCTACACACTATGTGACGCTGGTGCTGCAGCTTATTA
s2_F_472_AGGTAGGACG	AATGATACGGCGACCACCGAGATCTACACAGGTAGGACGGCTGGTGCTGCAGCTTATTA
s2_F_473_CAGTGGTTGT	AATGATACGGCGACCACCGAGATCTACACCAGTGGTTGTGCTGGTGCTGCAGCTTATTA
s2_F_474_GCGTTATCAG	AATGATACGGCGACCACCGAGATCTACACGCGTTATCAGGCTGGTGCTGCAGCTTATTA
s2_F_475_GATAGGCCTA	AATGATACGGCGACCACCGAGATCTACACGATAGGCCTAGCTGGTGCTGCAGCTTATTA
s2_F_476_CCGGTAACAA	AATGATACGGCGACCACCGAGATCTACACCCGGTAACAAGCTGGTGCTGCAGCTTATTA
s2_F_477_CGGAGTGTGT	AATGATACGGCGACCACCGAGATCTACACCGGAGTGTGTGCTGGTGCTGCAGCTTATTA
s2_F_478_AGACACCGGA	AATGATACGGCGACCACCGAGATCTACACAGACACCGGAGCTGGTGCTGCAGCTTATTA
s2_F_479_AAGATGTGAG	AATGATACGGCGACCACCGAGATCTACACAAGATGTGAGGCTGGTGCTGCAGCTTATTA
s2_F_480_CACGCGGATT	AATGATACGGCGACCACCGAGATCTACACCACGCGGATTGCTGGTGCTGCAGCTTATTA
s2_F_481_GGAACAACGG	AATGATACGGCGACCACCGAGATCTACACGGAACAACGGGCTGGTGCTGCAGCTTATTA
s2_F_482_CAGGCCATCA	AATGATACGGCGACCACCGAGATCTACACCAGGCCATCAGCTGGTGCTGCAGCTTATTA
s2_F_483_CTGCCTATAA	AATGATACGGCGACCACCGAGATCTACACCTGCCTATAAGCTGGTGCTGCAGCTTATTA
s2_F_484_AGCTATGTGG	AATGATACGGCGACCACCGAGATCTACACAGCTATGTGGGCTGGTGCTGCAGCTTATTA
s2_F_485_ACACTGTGGT	AATGATACGGCGACCACCGAGATCTACACACACTGTGGTGCTGGTGCTGCAGCTTATTA
s2_F_486_GTCACAAGCG	AATGATACGGCGACCACCGAGATCTACACGTCACAAGCGGCTGGTGCTGCAGCTTATTA
s2_F_487_CTACGACTTG	AATGATACGGCGACCACCGAGATCTACACCTACGACTTGGCTGGTGCTGCAGCTTATTA
s2_F_488_TGGTTGAGTA	AATGATACGGCGACCACCGAGATCTACACTGGTTGAGTAGCTGGTGCTGCAGCTTATTA
s2_F_489_TGGAGGATCG	AATGATACGGCGACCACCGAGATCTACACTGGAGGATCGGCTGGTGCTGCAGCTTATTA
s2_F_490_TCAGTTGCCA	AATGATACGGCGACCACCGAGATCTACACTCAGTTGCCAGCTGGTGCTGCAGCTTATTA
s2_F_491_CCAGGAGTGT	AATGATACGGCGACCACCGAGATCTACACCCAGGAGTGTGCTGGTGCTGCAGCTTATTA
s2_F_492_ACATGGCCAA	AATGATACGGCGACCACCGAGATCTACACACATGGCCAAGCTGGTGCTGCAGCTTATTA
s2_F_493_GCGTTGCGAA	AATGATACGGCGACCACCGAGATCTACACGCGTTGCGAAGCTGGTGCTGCAGCTTATTA
s2_F_494_AAGGTTACCG	AATGATACGGCGACCACCGAGATCTACACAAGGTTACCGGCTGGTGCTGCAGCTTATTA
s2_F_495_ATACGGACAT	AATGATACGGCGACCACCGAGATCTACACATACGGACATGCTGGTGCTGCAGCTTATTA
s2_F_496_AGTGGCGAAG	AATGATACGGCGACCACCGAGATCTACACAGTGGCGAAGGCTGGTGCTGCAGCTTATTA
s2_F_497_GCGGTAATCA	AATGATACGGCGACCACCGAGATCTACACGCGGTAATCAGCTGGTGCTGCAGCTTATTA
s2_F_498_CAGACTGAGA	AATGATACGGCGACCACCGAGATCTACACCAGACTGAGAGCTGGTGCTGCAGCTTATTA
s2_F_499_TCTTGTTCCG	AATGATACGGCGACCACCGAGATCTACACTCTTGTTCCGGCTGGTGCTGCAGCTTATTA
s2_F_500_ACCAAGCTGG	AATGATACGGCGACCACCGAGATCTACACACCAAGCTGGGCTGGTGCTGCAGCTTATTA
s2_F_501_GGTTAGGAAT	AATGATACGGCGACCACCGAGATCTACACGGTTAGGAATGCTGGTGCTGCAGCTTATTA
s2_F_502_AAGTCGGTAG	AATGATACGGCGACCACCGAGATCTACACAAGTCGGTAGGCTGGTGCTGCAGCTTATTA
s2_F_503_CACGACTGTA	AATGATACGGCGACCACCGAGATCTACACCACGACTGTAGCTGGTGCTGCAGCTTATTA
s2_F_504_TCGATCCAGT	AATGATACGGCGACCACCGAGATCTACACTCGATCCAGTGCTGGTGCTGCAGCTTATTA
s2_F_505_GGACGAATTG	AATGATACGGCGACCACCGAGATCTACACGGACGAATTGGCTGGTGCTGCAGCTTATTA
s2_F_506_CGGACTAGAA	AATGATACGGCGACCACCGAGATCTACACCGGACTAGAAGCTGGTGCTGCAGCTTATTA
s2_F_507_GAAGCTTGTA	AATGATACGGCGACCACCGAGATCTACACGAAGCTTGTAGCTGGTGCTGCAGCTTATTA
s2_F_508_CAATACGGAA	AATGATACGGCGACCACCGAGATCTACACCAATACGGAAGCTGGTGCTGCAGCTTATTA
s2_F_509_GAACGAGAGA	AATGATACGGCGACCACCGAGATCTACACGAACGAGAGAGCTGGTGCTGCAGCTTATTA
s2_F_510_GACTTCGACG	AATGATACGGCGACCACCGAGATCTACACGACTTCGACGGCTGGTGCTGCAGCTTATTA
s2_F_511_GTACACTGGA	AATGATACGGCGACCACCGAGATCTACACGTACACTGGAGCTGGTGCTGCAGCTTATTA
s2_F_512_GTCGAGGATG	AATGATACGGCGACCACCGAGATCTACACGTCGAGGATGGCTGGTGCTGCAGCTTATTA
s2_F_513_CTCATGCTAT	AATGATACGGCGACCACCGAGATCTACACCTCATGCTATGCTGGTGCTGCAGCTTATTA
s2_F_514_CCTTGCGGAA	AATGATACGGCGACCACCGAGATCTACACCCTTGCGGAAGCTGGTGCTGCAGCTTATTA
s2_F_515_TGGAAGCACG	AATGATACGGCGACCACCGAGATCTACACTGGAAGCACGGCTGGTGCTGCAGCTTATTA
s2_F_516_AGCGTCCAAG	AATGATACGGCGACCACCGAGATCTACACAGCGTCCAAGGCTGGTGCTGCAGCTTATTA
s2_F_517_GCCATCTACG	AATGATACGGCGACCACCGAGATCTACACGCCATCTACGGCTGGTGCTGCAGCTTATTA
s2_F_518_GGAAGCTACT	AATGATACGGCGACCACCGAGATCTACACGGAAGCTACTGCTGGTGCTGCAGCTTATTA
s2_F_519_GGTTGACTAA	AATGATACGGCGACCACCGAGATCTACACGGTTGACTAAGCTGGTGCTGCAGCTTATTA
s2_F_520_TGCCACCGTA	AATGATACGGCGACCACCGAGATCTACACTGCCACCGTAGCTGGTGCTGCAGCTTATTA
s2_F_521_GATTATGTCG	AATGATACGGCGACCACCGAGATCTACACGATTATGTCGGCTGGTGCTGCAGCTTATTA
s2_F_522_ACCACTGTGA	AATGATACGGCGACCACCGAGATCTACACACCACTGTGAGCTGGTGCTGCAGCTTATTA
s2_F_523_GTTGCCTGGA	AATGATACGGCGACCACCGAGATCTACACGTTGCCTGGAGCTGGTGCTGCAGCTTATTA
s2_F_524_CGGTTCAAGG	AATGATACGGCGACCACCGAGATCTACACCGGTTCAAGGGCTGGTGCTGCAGCTTATTA
s2_F_525_GACTACCGTC	AATGATACGGCGACCACCGAGATCTACACGACTACCGTCGCTGGTGCTGCAGCTTATTA
s2_F_526_ATCTCTAGGT	AATGATACGGCGACCACCGAGATCTACACATCTCTAGGTGCTGGTGCTGCAGCTTATTA
s2_F_527_GCGAGTCACT	AATGATACGGCGACCACCGAGATCTACACGCGAGTCACTGCTGGTGCTGCAGCTTATTA
s2_F_528_CGAGGAGATT	AATGATACGGCGACCACCGAGATCTACACCGAGGAGATTGCTGGTGCTGCAGCTTATTA
s2_F_529_GCGAAGACTT	AATGATACGGCGACCACCGAGATCTACACGCGAAGACTTGCTGGTGCTGCAGCTTATTA
s2_F_530_ACGTGGTGAT	AATGATACGGCGACCACCGAGATCTACACACGTGGTGATGCTGGTGCTGCAGCTTATTA
s2_F_531_GTGATCTGGA	AATGATACGGCGACCACCGAGATCTACACGTGATCTGGAGCTGGTGCTGCAGCTTATTA
s2_F_532_CACCTACGTC	AATGATACGGCGACCACCGAGATCTACACCACCTACGTCGCTGGTGCTGCAGCTTATTA
s2_F_533_CTGGTCCGAA	AATGATACGGCGACCACCGAGATCTACACCTGGTCCGAAGCTGGTGCTGCAGCTTATTA
s2_F_534_TCACGGTAGG	AATGATACGGCGACCACCGAGATCTACACTCACGGTAGGGCTGGTGCTGCAGCTTATTA
s2_F_535_AAGCCTTGAA	AATGATACGGCGACCACCGAGATCTACACAAGCCTTGAAGCTGGTGCTGCAGCTTATTA
s2_F_536_GACGCATCTG	AATGATACGGCGACCACCGAGATCTACACGACGCATCTGGCTGGTGCTGCAGCTTATTA
s2_F_537_CACGTAGACT	AATGATACGGCGACCACCGAGATCTACACCACGTAGACTGCTGGTGCTGCAGCTTATTA
s2_F_538_CACGCAACTT	AATGATACGGCGACCACCGAGATCTACACCACGCAACTTGCTGGTGCTGCAGCTTATTA
s2_F_539_ACGTCCTAGA	AATGATACGGCGACCACCGAGATCTACACACGTCCTAGAGCTGGTGCTGCAGCTTATTA
s2_F_540_ACGCCTTACG	AATGATACGGCGACCACCGAGATCTACACACGCCTTACGGCTGGTGCTGCAGCTTATTA
s2_F_541_ACAATCTGTC	AATGATACGGCGACCACCGAGATCTACACACAATCTGTCGCTGGTGCTGCAGCTTATTA
s2_F_542_TAAGAATCGG	AATGATACGGCGACCACCGAGATCTACACTAAGAATCGGGCTGGTGCTGCAGCTTATTA
s2_F_543_AATAAGGTGG	AATGATACGGCGACCACCGAGATCTACACAATAAGGTGGGCTGGTGCTGCAGCTTATTA
s2_F_544_CAACCTCAGT	AATGATACGGCGACCACCGAGATCTACACCAACCTCAGTGCTGGTGCTGCAGCTTATTA
s2_F_545_GAAGATCAGA	AATGATACGGCGACCACCGAGATCTACACGAAGATCAGAGCTGGTGCTGCAGCTTATTA
s2_F_546_ATCCAAGGCG	AATGATACGGCGACCACCGAGATCTACACATCCAAGGCGGCTGGTGCTGCAGCTTATTA
s2_F_547_CAGATACTTG	AATGATACGGCGACCACCGAGATCTACACCAGATACTTGGCTGGTGCTGCAGCTTATTA
s2_F_548_ACGTAAGGAC	AATGATACGGCGACCACCGAGATCTACACACGTAAGGACGCTGGTGCTGCAGCTTATTA
s2_F_549_CGTATACTGT	AATGATACGGCGACCACCGAGATCTACACCGTATACTGTGCTGGTGCTGCAGCTTATTA
s2_F_550_GGAACACTCT	AATGATACGGCGACCACCGAGATCTACACGGAACACTCTGCTGGTGCTGCAGCTTATTA
s2_F_551_GTACAAGGTA	AATGATACGGCGACCACCGAGATCTACACGTACAAGGTAGCTGGTGCTGCAGCTTATTA
s2_F_552_GAATTAGCCG	AATGATACGGCGACCACCGAGATCTACACGAATTAGCCGGCTGGTGCTGCAGCTTATTA
s2_F_553_GTATTCCGGA	AATGATACGGCGACCACCGAGATCTACACGTATTCCGGAGCTGGTGCTGCAGCTTATTA
s2_F_554_AACGAAGTCG	AATGATACGGCGACCACCGAGATCTACACAACGAAGTCGGCTGGTGCTGCAGCTTATTA
s2_F_555_GTTAGCTTCG	AATGATACGGCGACCACCGAGATCTACACGTTAGCTTCGGCTGGTGCTGCAGCTTATTA
s2_F_556_TACACTCACG	AATGATACGGCGACCACCGAGATCTACACTACACTCACGGCTGGTGCTGCAGCTTATTA
s2_F_557_TACCTGCGTG	AATGATACGGCGACCACCGAGATCTACACTACCTGCGTGGCTGGTGCTGCAGCTTATTA
s2_F_558_TGGAGTACGG	AATGATACGGCGACCACCGAGATCTACACTGGAGTACGGGCTGGTGCTGCAGCTTATTA
s2_F_559_ACGCACTCAT	AATGATACGGCGACCACCGAGATCTACACACGCACTCATGCTGGTGCTGCAGCTTATTA
s2_F_560_ATCGTACGCT	AATGATACGGCGACCACCGAGATCTACACATCGTACGCTGCTGGTGCTGCAGCTTATTA
s2_F_561_GCATAAGGTT	AATGATACGGCGACCACCGAGATCTACACGCATAAGGTTGCTGGTGCTGCAGCTTATTA
s2_F_562_CGTGAGATAA	AATGATACGGCGACCACCGAGATCTACACCGTGAGATAAGCTGGTGCTGCAGCTTATTA
s2_F_563_ACAGACCGTG	AATGATACGGCGACCACCGAGATCTACACACAGACCGTGGCTGGTGCTGCAGCTTATTA
s2_F_564_GACCGTTAGG	AATGATACGGCGACCACCGAGATCTACACGACCGTTAGGGCTGGTGCTGCAGCTTATTA
s2_F_565_GGTACATCCA	AATGATACGGCGACCACCGAGATCTACACGGTACATCCAGCTGGTGCTGCAGCTTATTA
s2_F_566_CGTCGTACAT	AATGATACGGCGACCACCGAGATCTACACCGTCGTACATGCTGGTGCTGCAGCTTATTA
s2_F_567_AGTAGCCTAT	AATGATACGGCGACCACCGAGATCTACACAGTAGCCTATGCTGGTGCTGCAGCTTATTA
s2_F_568_CTACCGGATG	AATGATACGGCGACCACCGAGATCTACACCTACCGGATGGCTGGTGCTGCAGCTTATTA
s2_F_569_CTAGGCGAGA	AATGATACGGCGACCACCGAGATCTACACCTAGGCGAGAGCTGGTGCTGCAGCTTATTA
s2_F_570_TTAAGTCACG	AATGATACGGCGACCACCGAGATCTACACTTAAGTCACGGCTGGTGCTGCAGCTTATTA
s2_F_571_CGGATAGTTC	AATGATACGGCGACCACCGAGATCTACACCGGATAGTTCGCTGGTGCTGCAGCTTATTA
s2_F_572_CCATCAGCTG	AATGATACGGCGACCACCGAGATCTACACCCATCAGCTGGCTGGTGCTGCAGCTTATTA
s2_F_573_AGGCGGAGAT	AATGATACGGCGACCACCGAGATCTACACAGGCGGAGATGCTGGTGCTGCAGCTTATTA
s2_F_574_CAGACATCCT	AATGATACGGCGACCACCGAGATCTACACCAGACATCCTGCTGGTGCTGCAGCTTATTA
s2_F_575_ACGTAGAATC	AATGATACGGCGACCACCGAGATCTACACACGTAGAATCGCTGGTGCTGCAGCTTATTA
s2_F_576_GGCTAGACTG	AATGATACGGCGACCACCGAGATCTACACGGCTAGACTGGCTGGTGCTGCAGCTTATTA
s2_F_577_CAAGAGTAGA	AATGATACGGCGACCACCGAGATCTACACCAAGAGTAGAGCTGGTGCTGCAGCTTATTA
s2_F_578_GACAGGTCAA	AATGATACGGCGACCACCGAGATCTACACGACAGGTCAAGCTGGTGCTGCAGCTTATTA
s2_F_579_AATCCGATGG	AATGATACGGCGACCACCGAGATCTACACAATCCGATGGGCTGGTGCTGCAGCTTATTA
s2_F_580_TTACCTATCG	AATGATACGGCGACCACCGAGATCTACACTTACCTATCGGCTGGTGCTGCAGCTTATTA
s2_F_581_GACGTGATCA	AATGATACGGCGACCACCGAGATCTACACGACGTGATCAGCTGGTGCTGCAGCTTATTA
s2_F_582_GGTAATGATG	AATGATACGGCGACCACCGAGATCTACACGGTAATGATGGCTGGTGCTGCAGCTTATTA
s2_F_583_GCTTCGAGAA	AATGATACGGCGACCACCGAGATCTACACGCTTCGAGAAGCTGGTGCTGCAGCTTATTA
s2_F_584_GGAACCAGGT	AATGATACGGCGACCACCGAGATCTACACGGAACCAGGTGCTGGTGCTGCAGCTTATTA
s2_F_585_ACGATTCGAC	AATGATACGGCGACCACCGAGATCTACACACGATTCGACGCTGGTGCTGCAGCTTATTA
s2_F_586_GACATTGTGG	AATGATACGGCGACCACCGAGATCTACACGACATTGTGGGCTGGTGCTGCAGCTTATTA
s2_F_587_AGCAACCTTA	AATGATACGGCGACCACCGAGATCTACACAGCAACCTTAGCTGGTGCTGCAGCTTATTA
s2_F_588_TGATAGGTCT	AATGATACGGCGACCACCGAGATCTACACTGATAGGTCTGCTGGTGCTGCAGCTTATTA
s2_F_589_AACGTCATGT	AATGATACGGCGACCACCGAGATCTACACAACGTCATGTGCTGGTGCTGCAGCTTATTA
s2_F_590_CGTTGGTAGG	AATGATACGGCGACCACCGAGATCTACACCGTTGGTAGGGCTGGTGCTGCAGCTTATTA
s2_F_591_GTGGAATAGG	AATGATACGGCGACCACCGAGATCTACACGTGGAATAGGGCTGGTGCTGCAGCTTATTA
s2_F_592_GTTGATGTTG	AATGATACGGCGACCACCGAGATCTACACGTTGATGTTGGCTGGTGCTGCAGCTTATTA
s2_F_593_TATGAGATCG	AATGATACGGCGACCACCGAGATCTACACTATGAGATCGGCTGGTGCTGCAGCTTATTA
s2_F_594_CTAACATACG	AATGATACGGCGACCACCGAGATCTACACCTAACATACGGCTGGTGCTGCAGCTTATTA
s2_F_595_AACATCGGTT	AATGATACGGCGACCACCGAGATCTACACAACATCGGTTGCTGGTGCTGCAGCTTATTA
s2_F_596_GCATGGTTAT	AATGATACGGCGACCACCGAGATCTACACGCATGGTTATGCTGGTGCTGCAGCTTATTA
s2_F_597_GATAAGTGCG	AATGATACGGCGACCACCGAGATCTACACGATAAGTGCGGCTGGTGCTGCAGCTTATTA
s2_F_598_AATCGCGTAA	AATGATACGGCGACCACCGAGATCTACACAATCGCGTAAGCTGGTGCTGCAGCTTATTA
s2_F_599_AATGTTCGTC	AATGATACGGCGACCACCGAGATCTACACAATGTTCGTCGCTGGTGCTGCAGCTTATTA
s2_F_600_GGTACTTCAG	AATGATACGGCGACCACCGAGATCTACACGGTACTTCAGGCTGGTGCTGCAGCTTATTA
s2_F_601_GGAGCTCAAG	AATGATACGGCGACCACCGAGATCTACACGGAGCTCAAGGCTGGTGCTGCAGCTTATTA
s2_F_602_TCCTCAGTCT	AATGATACGGCGACCACCGAGATCTACACTCCTCAGTCTGCTGGTGCTGCAGCTTATTA
s2_F_603_GAGAGTAGAA	AATGATACGGCGACCACCGAGATCTACACGAGAGTAGAAGCTGGTGCTGCAGCTTATTA
s2_F_604_GGAATATCCG	AATGATACGGCGACCACCGAGATCTACACGGAATATCCGGCTGGTGCTGCAGCTTATTA
s2_F_605_ACGCGCATCA	AATGATACGGCGACCACCGAGATCTACACACGCGCATCAGCTGGTGCTGCAGCTTATTA
s2_F_606_GGCTCTAAGT	AATGATACGGCGACCACCGAGATCTACACGGCTCTAAGTGCTGGTGCTGCAGCTTATTA
s2_F_607_ACCAACCGTT	AATGATACGGCGACCACCGAGATCTACACACCAACCGTTGCTGGTGCTGCAGCTTATTA
s2_F_608_ACATCACGTC	AATGATACGGCGACCACCGAGATCTACACACATCACGTCGCTGGTGCTGCAGCTTATTA
s2_F_609_AATCCTGGAC	AATGATACGGCGACCACCGAGATCTACACAATCCTGGACGCTGGTGCTGCAGCTTATTA
s2_F_610_AATGCGGCTA	AATGATACGGCGACCACCGAGATCTACACAATGCGGCTAGCTGGTGCTGCAGCTTATTA
s2_F_611_AATGTCTGGC	AATGATACGGCGACCACCGAGATCTACACAATGTCTGGCGCTGGTGCTGCAGCTTATTA
s2_F_612_ACACGTCATC	AATGATACGGCGACCACCGAGATCTACACACACGTCATCGCTGGTGCTGCAGCTTATTA
s2_F_613_ACACTCGCGT	AATGATACGGCGACCACCGAGATCTACACACACTCGCGTGCTGGTGCTGCAGCTTATTA
s2_F_614_ACCATGCATC	AATGATACGGCGACCACCGAGATCTACACACCATGCATCGCTGGTGCTGCAGCTTATTA
s2_F_615_ACCGTACAGT	AATGATACGGCGACCACCGAGATCTACACACCGTACAGTGCTGGTGCTGCAGCTTATTA
s2_F_616_ACGATCTAGC	AATGATACGGCGACCACCGAGATCTACACACGATCTAGCGCTGGTGCTGCAGCTTATTA
s2_F_617_ACGGTCCTAT	AATGATACGGCGACCACCGAGATCTACACACGGTCCTATGCTGGTGCTGCAGCTTATTA
s2_F_618_ACTTAGCGTC	AATGATACGGCGACCACCGAGATCTACACACTTAGCGTCGCTGGTGCTGCAGCTTATTA
s2_F_619_AGGTTCTAAC	AATGATACGGCGACCACCGAGATCTACACAGGTTCTAACGCTGGTGCTGCAGCTTATTA
s2_F_620_ATATAGGCCT	AATGATACGGCGACCACCGAGATCTACACATATAGGCCTGCTGGTGCTGCAGCTTATTA
s2_F_621_ATGATTCGCG	AATGATACGGCGACCACCGAGATCTACACATGATTCGCGGCTGGTGCTGCAGCTTATTA
s2_F_622_ATGCTAGAGA	AATGATACGGCGACCACCGAGATCTACACATGCTAGAGAGCTGGTGCTGCAGCTTATTA
s2_F_623_CACGACATGC	AATGATACGGCGACCACCGAGATCTACACCACGACATGCGCTGGTGCTGCAGCTTATTA
s2_F_624_CACGGTAATT	AATGATACGGCGACCACCGAGATCTACACCACGGTAATTGCTGGTGCTGCAGCTTATTA
s2_F_625_CAGAACCACG	AATGATACGGCGACCACCGAGATCTACACCAGAACCACGGCTGGTGCTGCAGCTTATTA
s2_F_626_CCACAACGTC	AATGATACGGCGACCACCGAGATCTACACCCACAACGTCGCTGGTGCTGCAGCTTATTA
s2_F_627_CCACAATAGA	AATGATACGGCGACCACCGAGATCTACACCCACAATAGAGCTGGTGCTGCAGCTTATTA
s2_F_628_CCGAGTCGAT	AATGATACGGCGACCACCGAGATCTACACCCGAGTCGATGCTGGTGCTGCAGCTTATTA
s2_F_629_CCGCGACTAA	AATGATACGGCGACCACCGAGATCTACACCCGCGACTAAGCTGGTGCTGCAGCTTATTA
s2_F_630_CCGGACCAAT	AATGATACGGCGACCACCGAGATCTACACCCGGACCAATGCTGGTGCTGCAGCTTATTA
s2_F_631_CCGTATAGAC	AATGATACGGCGACCACCGAGATCTACACCCGTATAGACGCTGGTGCTGCAGCTTATTA
s2_F_632_CCTAGCGTGA	AATGATACGGCGACCACCGAGATCTACACCCTAGCGTGAGCTGGTGCTGCAGCTTATTA
s2_F_633_CGATGTGAGA	AATGATACGGCGACCACCGAGATCTACACCGATGTGAGAGCTGGTGCTGCAGCTTATTA
s2_F_634_CGCAGTCAGT	AATGATACGGCGACCACCGAGATCTACACCGCAGTCAGTGCTGGTGCTGCAGCTTATTA
s2_F_635_CGGAAGTGAG	AATGATACGGCGACCACCGAGATCTACACCGGAAGTGAGGCTGGTGCTGCAGCTTATTA
s2_F_636_CGGACCATGT	AATGATACGGCGACCACCGAGATCTACACCGGACCATGTGCTGGTGCTGCAGCTTATTA
s2_F_637_CGTAACAGTT	AATGATACGGCGACCACCGAGATCTACACCGTAACAGTTGCTGGTGCTGCAGCTTATTA
s2_F_638_CGTAGAACTT	AATGATACGGCGACCACCGAGATCTACACCGTAGAACTTGCTGGTGCTGCAGCTTATTA
s2_F_639_CTCTGCGGTT	AATGATACGGCGACCACCGAGATCTACACCTCTGCGGTTGCTGGTGCTGCAGCTTATTA
s2_F_640_CTGTAGATGG	AATGATACGGCGACCACCGAGATCTACACCTGTAGATGGGCTGGTGCTGCAGCTTATTA
s2_F_641_CTGTTAAGCG	AATGATACGGCGACCACCGAGATCTACACCTGTTAAGCGGCTGGTGCTGCAGCTTATTA
s2_F_642_CTTACTGGCG	AATGATACGGCGACCACCGAGATCTACACCTTACTGGCGGCTGGTGCTGCAGCTTATTA
s2_F_643_GAACGTACGT	AATGATACGGCGACCACCGAGATCTACACGAACGTACGTGCTGGTGCTGCAGCTTATTA
s2_F_644_GAACTCGAGG	AATGATACGGCGACCACCGAGATCTACACGAACTCGAGGGCTGGTGCTGCAGCTTATTA
s2_F_645_GAAGATATCC	AATGATACGGCGACCACCGAGATCTACACGAAGATATCCGCTGGTGCTGCAGCTTATTA
s2_F_646_GAAGTTGATG	AATGATACGGCGACCACCGAGATCTACACGAAGTTGATGGCTGGTGCTGCAGCTTATTA
s2_F_647_GACGATGGAT	AATGATACGGCGACCACCGAGATCTACACGACGATGGATGCTGGTGCTGCAGCTTATTA
s2_F_648_GACTCGTCAG	AATGATACGGCGACCACCGAGATCTACACGACTCGTCAGGCTGGTGCTGCAGCTTATTA
s2_F_649_GACTGATAGA	AATGATACGGCGACCACCGAGATCTACACGACTGATAGAGCTGGTGCTGCAGCTTATTA
s2_F_650_GAGACCTCTG	AATGATACGGCGACCACCGAGATCTACACGAGACCTCTGGCTGGTGCTGCAGCTTATTA
s2_F_651_GAGGCGGTAA	AATGATACGGCGACCACCGAGATCTACACGAGGCGGTAAGCTGGTGCTGCAGCTTATTA
s2_F_652_GAGGTCAATG	AATGATACGGCGACCACCGAGATCTACACGAGGTCAATGGCTGGTGCTGCAGCTTATTA
s2_F_653_GATGAACACG	AATGATACGGCGACCACCGAGATCTACACGATGAACACGGCTGGTGCTGCAGCTTATTA
s2_F_654_GATGAAGCGG	AATGATACGGCGACCACCGAGATCTACACGATGAAGCGGGCTGGTGCTGCAGCTTATTA
s2_F_655_GCAAGACGGA	AATGATACGGCGACCACCGAGATCTACACGCAAGACGGAGCTGGTGCTGCAGCTTATTA
s2_F_656_GCATTGGTGT	AATGATACGGCGACCACCGAGATCTACACGCATTGGTGTGCTGGTGCTGCAGCTTATTA
s2_F_657_GCCAGATATG	AATGATACGGCGACCACCGAGATCTACACGCCAGATATGGCTGGTGCTGCAGCTTATTA
s2_F_658_GCGAAGAGAG	AATGATACGGCGACCACCGAGATCTACACGCGAAGAGAGGCTGGTGCTGCAGCTTATTA
s2_F_659_GCGGTTAACT	AATGATACGGCGACCACCGAGATCTACACGCGGTTAACTGCTGGTGCTGCAGCTTATTA
s2_F_660_GCGTCACCAA	AATGATACGGCGACCACCGAGATCTACACGCGTCACCAAGCTGGTGCTGCAGCTTATTA
s2_F_661_GCGTCACGTT	AATGATACGGCGACCACCGAGATCTACACGCGTCACGTTGCTGGTGCTGCAGCTTATTA
s2_F_662_GCTTGTCATG	AATGATACGGCGACCACCGAGATCTACACGCTTGTCATGGCTGGTGCTGCAGCTTATTA
s2_F_663_GGACACTACG	AATGATACGGCGACCACCGAGATCTACACGGACACTACGGCTGGTGCTGCAGCTTATTA
s2_F_664_GGACCATACA	AATGATACGGCGACCACCGAGATCTACACGGACCATACAGCTGGTGCTGCAGCTTATTA
s2_F_665_GGACCTTGAA	AATGATACGGCGACCACCGAGATCTACACGGACCTTGAAGCTGGTGCTGCAGCTTATTA
s2_F_666_GGACGTAGGA	AATGATACGGCGACCACCGAGATCTACACGGACGTAGGAGCTGGTGCTGCAGCTTATTA
s2_F_667_GGACTGACGT	AATGATACGGCGACCACCGAGATCTACACGGACTGACGTGCTGGTGCTGCAGCTTATTA
s2_F_668_GGAGAGTTAT	AATGATACGGCGACCACCGAGATCTACACGGAGAGTTATGCTGGTGCTGCAGCTTATTA
s2_F_669_GGAGCACGTA	AATGATACGGCGACCACCGAGATCTACACGGAGCACGTAGCTGGTGCTGCAGCTTATTA
s2_F_670_GGCAACAGTA	AATGATACGGCGACCACCGAGATCTACACGGCAACAGTAGCTGGTGCTGCAGCTTATTA
s2_F_671_GGCTTCTTGG	AATGATACGGCGACCACCGAGATCTACACGGCTTCTTGGGCTGGTGCTGCAGCTTATTA
s2_F_672_GGTAGTATTG	AATGATACGGCGACCACCGAGATCTACACGGTAGTATTGGCTGGTGCTGCAGCTTATTA
s2_F_673_GGTATTCACT	AATGATACGGCGACCACCGAGATCTACACGGTATTCACTGCTGGTGCTGCAGCTTATTA
s2_F_674_GTACTGCGTA	AATGATACGGCGACCACCGAGATCTACACGTACTGCGTAGCTGGTGCTGCAGCTTATTA
s2_F_675_GTCAGTTGGA	AATGATACGGCGACCACCGAGATCTACACGTCAGTTGGAGCTGGTGCTGCAGCTTATTA
s2_F_676_GTCATCTCTT	AATGATACGGCGACCACCGAGATCTACACGTCATCTCTTGCTGGTGCTGCAGCTTATTA
s2_F_677_GTCTTAACGG	AATGATACGGCGACCACCGAGATCTACACGTCTTAACGGGCTGGTGCTGCAGCTTATTA
s2_F_678_GTGCCTACCT	AATGATACGGCGACCACCGAGATCTACACGTGCCTACCTGCTGGTGCTGCAGCTTATTA
s2_F_679_GTGGCATCCA	AATGATACGGCGACCACCGAGATCTACACGTGGCATCCAGCTGGTGCTGCAGCTTATTA
s2_F_680_GTGGCCTTAG	AATGATACGGCGACCACCGAGATCTACACGTGGCCTTAGGCTGGTGCTGCAGCTTATTA
s2_F_681_GTTCTCAGTT	AATGATACGGCGACCACCGAGATCTACACGTTCTCAGTTGCTGGTGCTGCAGCTTATTA
s2_F_682_TATGGCCACA	AATGATACGGCGACCACCGAGATCTACACTATGGCCACAGCTGGTGCTGCAGCTTATTA
s2_F_683_TCCACAGTGG	AATGATACGGCGACCACCGAGATCTACACTCCACAGTGGGCTGGTGCTGCAGCTTATTA
s2_F_684_TCCATTAACG	AATGATACGGCGACCACCGAGATCTACACTCCATTAACGGCTGGTGCTGCAGCTTATTA
s2_F_685_TCCTGATAAG	AATGATACGGCGACCACCGAGATCTACACTCCTGATAAGGCTGGTGCTGCAGCTTATTA
s2_F_686_TGCAAGATTG	AATGATACGGCGACCACCGAGATCTACACTGCAAGATTGGCTGGTGCTGCAGCTTATTA
s2_F_687_TGCGAATCGA	AATGATACGGCGACCACCGAGATCTACACTGCGAATCGAGCTGGTGCTGCAGCTTATTA
s2_F_688_TGCTGTCCGA	AATGATACGGCGACCACCGAGATCTACACTGCTGTCCGAGCTGGTGCTGCAGCTTATTA
s2_F_689_GGCAACCTGT	AATGATACGGCGACCACCGAGATCTACACGGCAACCTGTGCTGGTGCTGCAGCTTATTA
s2_F_690_CTTGGAGTGA	AATGATACGGCGACCACCGAGATCTACACCTTGGAGTGAGCTGGTGCTGCAGCTTATTA
s2_F_691_CATGTGGTAT	AATGATACGGCGACCACCGAGATCTACACCATGTGGTATGCTGGTGCTGCAGCTTATTA
s2_F_692_TAGAGACACG	AATGATACGGCGACCACCGAGATCTACACTAGAGACACGGCTGGTGCTGCAGCTTATTA
s2_F_693_CTCACATAGT	AATGATACGGCGACCACCGAGATCTACACCTCACATAGTGCTGGTGCTGCAGCTTATTA
s2_F_694_ACAGTCGAGG	AATGATACGGCGACCACCGAGATCTACACACAGTCGAGGGCTGGTGCTGCAGCTTATTA
s2_F_695_TAGTGGCTGG	AATGATACGGCGACCACCGAGATCTACACTAGTGGCTGGGCTGGTGCTGCAGCTTATTA
s2_F_696_AAGCTACAGT	AATGATACGGCGACCACCGAGATCTACACAAGCTACAGTGCTGGTGCTGCAGCTTATTA
s2_F_697_AGAACGGCAT	AATGATACGGCGACCACCGAGATCTACACAGAACGGCATGCTGGTGCTGCAGCTTATTA
s2_F_698_GAACCTTGGC	AATGATACGGCGACCACCGAGATCTACACGAACCTTGGCGCTGGTGCTGCAGCTTATTA
s2_F_699_CGATAGAGTC	AATGATACGGCGACCACCGAGATCTACACCGATAGAGTCGCTGGTGCTGCAGCTTATTA
s2_F_700_GACGTTGTAA	AATGATACGGCGACCACCGAGATCTACACGACGTTGTAAGCTGGTGCTGCAGCTTATTA
s2_F_701_CCTTGACAAG	AATGATACGGCGACCACCGAGATCTACACCCTTGACAAGGCTGGTGCTGCAGCTTATTA
s2_F_702_GGCATAGTTG	AATGATACGGCGACCACCGAGATCTACACGGCATAGTTGGCTGGTGCTGCAGCTTATTA
s2_F_703_CACATCATGA	AATGATACGGCGACCACCGAGATCTACACCACATCATGAGCTGGTGCTGCAGCTTATTA
s2_F_704_CGTGGTAATA	AATGATACGGCGACCACCGAGATCTACACCGTGGTAATAGCTGGTGCTGCAGCTTATTA
s2_F_705_GAGCAATAGA	AATGATACGGCGACCACCGAGATCTACACGAGCAATAGAGCTGGTGCTGCAGCTTATTA
s2_F_706_GAGCTCCTCA	AATGATACGGCGACCACCGAGATCTACACGAGCTCCTCAGCTGGTGCTGCAGCTTATTA
s2_F_707_TCGCGATCCT	AATGATACGGCGACCACCGAGATCTACACTCGCGATCCTGCTGGTGCTGCAGCTTATTA
s2_F_708_ATGCTGACTT	AATGATACGGCGACCACCGAGATCTACACATGCTGACTTGCTGGTGCTGCAGCTTATTA
s2_F_709_TCAACGACTT	AATGATACGGCGACCACCGAGATCTACACTCAACGACTTGCTGGTGCTGCAGCTTATTA
s2_F_710_CCTCTGAACG	AATGATACGGCGACCACCGAGATCTACACCCTCTGAACGGCTGGTGCTGCAGCTTATTA
s2_F_711_CGTAGCATCG	AATGATACGGCGACCACCGAGATCTACACCGTAGCATCGGCTGGTGCTGCAGCTTATTA
s2_F_712_GCGGACTAAG	AATGATACGGCGACCACCGAGATCTACACGCGGACTAAGGCTGGTGCTGCAGCTTATTA
s2_F_713_CTGGAGTATG	AATGATACGGCGACCACCGAGATCTACACCTGGAGTATGGCTGGTGCTGCAGCTTATTA
s2_F_714_GGCCACACTT	AATGATACGGCGACCACCGAGATCTACACGGCCACACTTGCTGGTGCTGCAGCTTATTA
s2_F_715_GTACATGACG	AATGATACGGCGACCACCGAGATCTACACGTACATGACGGCTGGTGCTGCAGCTTATTA
s2_F_716_CCTGCGCATT	AATGATACGGCGACCACCGAGATCTACACCCTGCGCATTGCTGGTGCTGCAGCTTATTA
s2_F_717_GCGGCATGAA	AATGATACGGCGACCACCGAGATCTACACGCGGCATGAAGCTGGTGCTGCAGCTTATTA
s2_F_718_CTCTGCGACA	AATGATACGGCGACCACCGAGATCTACACCTCTGCGACAGCTGGTGCTGCAGCTTATTA
s2_F_719_GGATCAGCGA	AATGATACGGCGACCACCGAGATCTACACGGATCAGCGAGCTGGTGCTGCAGCTTATTA
s2_F_720_TCGCATTCGA	AATGATACGGCGACCACCGAGATCTACACTCGCATTCGAGCTGGTGCTGCAGCTTATTA
s2_F_721_GTCGTTGAGC	AATGATACGGCGACCACCGAGATCTACACGTCGTTGAGCGCTGGTGCTGCAGCTTATTA
s2_F_722_GTGACGTACC	AATGATACGGCGACCACCGAGATCTACACGTGACGTACCGCTGGTGCTGCAGCTTATTA
s2_F_723_ACTGATCTCC	AATGATACGGCGACCACCGAGATCTACACACTGATCTCCGCTGGTGCTGCAGCTTATTA
s2_F_724_CAGAATTCAG	AATGATACGGCGACCACCGAGATCTACACCAGAATTCAGGCTGGTGCTGCAGCTTATTA
s2_F_725_CCACGAAGGT	AATGATACGGCGACCACCGAGATCTACACCCACGAAGGTGCTGGTGCTGCAGCTTATTA
s2_F_726_CTTAGGTCAA	AATGATACGGCGACCACCGAGATCTACACCTTAGGTCAAGCTGGTGCTGCAGCTTATTA
s2_F_727_CGACGTCAAT	AATGATACGGCGACCACCGAGATCTACACCGACGTCAATGCTGGTGCTGCAGCTTATTA
s2_F_728_GACGCGACAT	AATGATACGGCGACCACCGAGATCTACACGACGCGACATGCTGGTGCTGCAGCTTATTA
s2_F_729_GTGCTATGTA	AATGATACGGCGACCACCGAGATCTACACGTGCTATGTAGCTGGTGCTGCAGCTTATTA
s2_F_730_GTATGATCAG	AATGATACGGCGACCACCGAGATCTACACGTATGATCAGGCTGGTGCTGCAGCTTATTA
s2_F_731_CGTTATGGTT	AATGATACGGCGACCACCGAGATCTACACCGTTATGGTTGCTGGTGCTGCAGCTTATTA
s2_F_732_TCCAGCTAGG	AATGATACGGCGACCACCGAGATCTACACTCCAGCTAGGGCTGGTGCTGCAGCTTATTA
s2_F_733_AGCGAACGTA	AATGATACGGCGACCACCGAGATCTACACAGCGAACGTAGCTGGTGCTGCAGCTTATTA
s2_F_734_CGGAATCCGT	AATGATACGGCGACCACCGAGATCTACACCGGAATCCGTGCTGGTGCTGCAGCTTATTA
s2_F_735_GCGGTTAGTA	AATGATACGGCGACCACCGAGATCTACACGCGGTTAGTAGCTGGTGCTGCAGCTTATTA
s2_F_736_GTAGGTTCGG	AATGATACGGCGACCACCGAGATCTACACGTAGGTTCGGGCTGGTGCTGCAGCTTATTA
s2_F_737_CGACTCCAGA	AATGATACGGCGACCACCGAGATCTACACCGACTCCAGAGCTGGTGCTGCAGCTTATTA
s2_F_738_CTGTCAAGGT	AATGATACGGCGACCACCGAGATCTACACCTGTCAAGGTGCTGGTGCTGCAGCTTATTA
s2_F_739_CTAGCTACTT	AATGATACGGCGACCACCGAGATCTACACCTAGCTACTTGCTGGTGCTGCAGCTTATTA
s2_F_740_CATAGCTAGA	AATGATACGGCGACCACCGAGATCTACACCATAGCTAGAGCTGGTGCTGCAGCTTATTA
s2_F_741_AGGTCATCGA	AATGATACGGCGACCACCGAGATCTACACAGGTCATCGAGCTGGTGCTGCAGCTTATTA
s2_F_742_AACATGTGTC	AATGATACGGCGACCACCGAGATCTACACAACATGTGTCGCTGGTGCTGCAGCTTATTA
s2_F_743_CGCATTACCT	AATGATACGGCGACCACCGAGATCTACACCGCATTACCTGCTGGTGCTGCAGCTTATTA
s2_F_744_TGGCGTTCGT	AATGATACGGCGACCACCGAGATCTACACTGGCGTTCGTGCTGGTGCTGCAGCTTATTA
s2_F_745_TGTAATCGAG	AATGATACGGCGACCACCGAGATCTACACTGTAATCGAGGCTGGTGCTGCAGCTTATTA
s2_F_746_AAGTAGTTCG	AATGATACGGCGACCACCGAGATCTACACAAGTAGTTCGGCTGGTGCTGCAGCTTATTA
s2_F_747_AGGCCATGAC	AATGATACGGCGACCACCGAGATCTACACAGGCCATGACGCTGGTGCTGCAGCTTATTA
s2_F_748_GTTGGTAACG	AATGATACGGCGACCACCGAGATCTACACGTTGGTAACGGCTGGTGCTGCAGCTTATTA
s2_F_749_GTAGACCATG	AATGATACGGCGACCACCGAGATCTACACGTAGACCATGGCTGGTGCTGCAGCTTATTA
s2_F_750_ATCATGACGT	AATGATACGGCGACCACCGAGATCTACACATCATGACGTGCTGGTGCTGCAGCTTATTA
s2_F_751_GGCACTCCAT	AATGATACGGCGACCACCGAGATCTACACGGCACTCCATGCTGGTGCTGCAGCTTATTA
s2_F_752_CGTGTCGGTA	AATGATACGGCGACCACCGAGATCTACACCGTGTCGGTAGCTGGTGCTGCAGCTTATTA
s2_F_753_GGCCATAGAT	AATGATACGGCGACCACCGAGATCTACACGGCCATAGATGCTGGTGCTGCAGCTTATTA
s2_F_754_GTTGCCAAGC	AATGATACGGCGACCACCGAGATCTACACGTTGCCAAGCGCTGGTGCTGCAGCTTATTA
s2_F_755_ACCGAAGTGT	AATGATACGGCGACCACCGAGATCTACACACCGAAGTGTGCTGGTGCTGCAGCTTATTA
s2_F_756_CGGTACCACA	AATGATACGGCGACCACCGAGATCTACACCGGTACCACAGCTGGTGCTGCAGCTTATTA
s2_F_757_CGGAAGACTG	AATGATACGGCGACCACCGAGATCTACACCGGAAGACTGGCTGGTGCTGCAGCTTATTA
s2_F_758_GATTCGAACA	AATGATACGGCGACCACCGAGATCTACACGATTCGAACAGCTGGTGCTGCAGCTTATTA
s2_F_759_ATTGTCGAAC	AATGATACGGCGACCACCGAGATCTACACATTGTCGAACGCTGGTGCTGCAGCTTATTA
s2_F_760_TAGACGTGGT	AATGATACGGCGACCACCGAGATCTACACTAGACGTGGTGCTGGTGCTGCAGCTTATTA
s2_F_761_CGTTCCAGAG	AATGATACGGCGACCACCGAGATCTACACCGTTCCAGAGGCTGGTGCTGCAGCTTATTA
s2_F_762_ATTGGCCATC	AATGATACGGCGACCACCGAGATCTACACATTGGCCATCGCTGGTGCTGCAGCTTATTA
s2_F_763_GGTCAACATG	AATGATACGGCGACCACCGAGATCTACACGGTCAACATGGCTGGTGCTGCAGCTTATTA
s2_F_764_AGACAGAACT	AATGATACGGCGACCACCGAGATCTACACAGACAGAACTGCTGGTGCTGCAGCTTATTA
s2_F_765_CTTACGCACG	AATGATACGGCGACCACCGAGATCTACACCTTACGCACGGCTGGTGCTGCAGCTTATTA
s2_F_766_AGTGTCCTTC	AATGATACGGCGACCACCGAGATCTACACAGTGTCCTTCGCTGGTGCTGCAGCTTATTA
s2_F_767_ACTGTTGTGT	AATGATACGGCGACCACCGAGATCTACACACTGTTGTGTGCTGGTGCTGCAGCTTATTA
s2_F_768_CGGAGCGATT	AATGATACGGCGACCACCGAGATCTACACCGGAGCGATTGCTGGTGCTGCAGCTTATTA
s2_F_769_CGCAACTACT	AATGATACGGCGACCACCGAGATCTACACCGCAACTACTGCTGGTGCTGCAGCTTATTA
s2_F_770_CTACTGAGAG	AATGATACGGCGACCACCGAGATCTACACCTACTGAGAGGCTGGTGCTGCAGCTTATTA
s2_F_771_AAGGTGTTCC	AATGATACGGCGACCACCGAGATCTACACAAGGTGTTCCGCTGGTGCTGCAGCTTATTA
s2_F_772_ACCGCGAAGT	AATGATACGGCGACCACCGAGATCTACACACCGCGAAGTGCTGGTGCTGCAGCTTATTA
s2_F_773_CGATAGATAG	AATGATACGGCGACCACCGAGATCTACACCGATAGATAGGCTGGTGCTGCAGCTTATTA
s2_F_774_CGTTATCCGG	AATGATACGGCGACCACCGAGATCTACACCGTTATCCGGGCTGGTGCTGCAGCTTATTA
s2_F_775_AAGCGCTAAT	AATGATACGGCGACCACCGAGATCTACACAAGCGCTAATGCTGGTGCTGCAGCTTATTA
s2_F_776_GCAAGAGTCG	AATGATACGGCGACCACCGAGATCTACACGCAAGAGTCGGCTGGTGCTGCAGCTTATTA
s2_F_777_TCTGGCCAAT	AATGATACGGCGACCACCGAGATCTACACTCTGGCCAATGCTGGTGCTGCAGCTTATTA
s2_F_778_TACGCTGCCT	AATGATACGGCGACCACCGAGATCTACACTACGCTGCCTGCTGGTGCTGCAGCTTATTA
s2_F_779_CGAGTGCTTC	AATGATACGGCGACCACCGAGATCTACACCGAGTGCTTCGCTGGTGCTGCAGCTTATTA
s2_F_780_TAACTAGCGG	AATGATACGGCGACCACCGAGATCTACACTAACTAGCGGGCTGGTGCTGCAGCTTATTA
s2_F_781_GGTTCACAGT	AATGATACGGCGACCACCGAGATCTACACGGTTCACAGTGCTGGTGCTGCAGCTTATTA
s2_F_782_CTCAGCTTCT	AATGATACGGCGACCACCGAGATCTACACCTCAGCTTCTGCTGGTGCTGCAGCTTATTA
s2_F_783_ACCGGTTCAT	AATGATACGGCGACCACCGAGATCTACACACCGGTTCATGCTGGTGCTGCAGCTTATTA
s2_F_784_GAGGTAACGG	AATGATACGGCGACCACCGAGATCTACACGAGGTAACGGGCTGGTGCTGCAGCTTATTA
s2_F_785_CGGTATGGAG	AATGATACGGCGACCACCGAGATCTACACCGGTATGGAGGCTGGTGCTGCAGCTTATTA
s2_F_786_GGTAAGTGAA	AATGATACGGCGACCACCGAGATCTACACGGTAAGTGAAGCTGGTGCTGCAGCTTATTA
s2_F_787_GGACTTAACG	AATGATACGGCGACCACCGAGATCTACACGGACTTAACGGCTGGTGCTGCAGCTTATTA
s2_F_788_TGTTAGTACG	AATGATACGGCGACCACCGAGATCTACACTGTTAGTACGGCTGGTGCTGCAGCTTATTA
s2_F_789_TACCGTAGGA	AATGATACGGCGACCACCGAGATCTACACTACCGTAGGAGCTGGTGCTGCAGCTTATTA
s2_F_790_CAACTCGTGC	AATGATACGGCGACCACCGAGATCTACACCAACTCGTGCGCTGGTGCTGCAGCTTATTA
s2_F_791_CGGAGTAAGA	AATGATACGGCGACCACCGAGATCTACACCGGAGTAAGAGCTGGTGCTGCAGCTTATTA
s2_F_792_GGTCCTATAT	AATGATACGGCGACCACCGAGATCTACACGGTCCTATATGCTGGTGCTGCAGCTTATTA
s2_F_793_AGAATCGTGT	AATGATACGGCGACCACCGAGATCTACACAGAATCGTGTGCTGGTGCTGCAGCTTATTA
s2_F_794_GGTTAGCGAG	AATGATACGGCGACCACCGAGATCTACACGGTTAGCGAGGCTGGTGCTGCAGCTTATTA
s2_F_795_CATGGTCTAG	AATGATACGGCGACCACCGAGATCTACACCATGGTCTAGGCTGGTGCTGCAGCTTATTA
s2_F_796_TCGCGTAGGT	AATGATACGGCGACCACCGAGATCTACACTCGCGTAGGTGCTGGTGCTGCAGCTTATTA
s2_F_797_CCGAGAGTAC	AATGATACGGCGACCACCGAGATCTACACCCGAGAGTACGCTGGTGCTGCAGCTTATTA
s2_F_798_GGCATATAAG	AATGATACGGCGACCACCGAGATCTACACGGCATATAAGGCTGGTGCTGCAGCTTATTA
s2_F_799_AAGCCTACTT	AATGATACGGCGACCACCGAGATCTACACAAGCCTACTTGCTGGTGCTGCAGCTTATTA
s2_F_800_CAAGCGCGAT	AATGATACGGCGACCACCGAGATCTACACCAAGCGCGATGCTGGTGCTGCAGCTTATTA
s2_F_801_GGACACCATT	AATGATACGGCGACCACCGAGATCTACACGGACACCATTGCTGGTGCTGCAGCTTATTA
s2_F_802_GAGCTCACAA	AATGATACGGCGACCACCGAGATCTACACGAGCTCACAAGCTGGTGCTGCAGCTTATTA
s2_F_803_GCGAACAATG	AATGATACGGCGACCACCGAGATCTACACGCGAACAATGGCTGGTGCTGCAGCTTATTA
s2_F_804_GCGATTGCTG	AATGATACGGCGACCACCGAGATCTACACGCGATTGCTGGCTGGTGCTGCAGCTTATTA
s2_F_805_GTCGACTCAA	AATGATACGGCGACCACCGAGATCTACACGTCGACTCAAGCTGGTGCTGCAGCTTATTA
s2_F_806_ACTCGTATCG	AATGATACGGCGACCACCGAGATCTACACACTCGTATCGGCTGGTGCTGCAGCTTATTA
s2_F_807_GCAGAGTGGT	AATGATACGGCGACCACCGAGATCTACACGCAGAGTGGTGCTGGTGCTGCAGCTTATTA
s2_F_808_GTCCTTAGCG	AATGATACGGCGACCACCGAGATCTACACGTCCTTAGCGGCTGGTGCTGCAGCTTATTA
s2_F_809_TAGTAAGCCA	AATGATACGGCGACCACCGAGATCTACACTAGTAAGCCAGCTGGTGCTGCAGCTTATTA
s2_F_810_TGAACGTTGG	AATGATACGGCGACCACCGAGATCTACACTGAACGTTGGGCTGGTGCTGCAGCTTATTA
s2_F_811_GGCTCATAGC	AATGATACGGCGACCACCGAGATCTACACGGCTCATAGCGCTGGTGCTGCAGCTTATTA
s2_F_812_CGTACGCAGA	AATGATACGGCGACCACCGAGATCTACACCGTACGCAGAGCTGGTGCTGCAGCTTATTA
s2_F_813_GCAAGCAAGC	AATGATACGGCGACCACCGAGATCTACACGCAAGCAAGCGCTGGTGCTGCAGCTTATTA
s2_F_814_CATGGAAGGA	AATGATACGGCGACCACCGAGATCTACACCATGGAAGGAGCTGGTGCTGCAGCTTATTA
s2_F_815_ATAGTGCGTC	AATGATACGGCGACCACCGAGATCTACACATAGTGCGTCGCTGGTGCTGCAGCTTATTA
s2_F_816_AGCAGATCTT	AATGATACGGCGACCACCGAGATCTACACAGCAGATCTTGCTGGTGCTGCAGCTTATTA
s2_F_817_GCTGGACACT	AATGATACGGCGACCACCGAGATCTACACGCTGGACACTGCTGGTGCTGCAGCTTATTA
s2_F_818_TAGGAAGGCG	AATGATACGGCGACCACCGAGATCTACACTAGGAAGGCGGCTGGTGCTGCAGCTTATTA
s2_F_819_GGACACACAA	AATGATACGGCGACCACCGAGATCTACACGGACACACAAGCTGGTGCTGCAGCTTATTA
s2_F_820_TCCGCAACCA	AATGATACGGCGACCACCGAGATCTACACTCCGCAACCAGCTGGTGCTGCAGCTTATTA
s2_F_821_GCTTCATGTA	AATGATACGGCGACCACCGAGATCTACACGCTTCATGTAGCTGGTGCTGCAGCTTATTA
s2_F_822_CGCATGATGT	AATGATACGGCGACCACCGAGATCTACACCGCATGATGTGCTGGTGCTGCAGCTTATTA
s2_F_823_GCGGAAGTAT	AATGATACGGCGACCACCGAGATCTACACGCGGAAGTATGCTGGTGCTGCAGCTTATTA
s2_F_824_GTGCTACTAT	AATGATACGGCGACCACCGAGATCTACACGTGCTACTATGCTGGTGCTGCAGCTTATTA
s2_F_825_TCAGTGTCAA	AATGATACGGCGACCACCGAGATCTACACTCAGTGTCAAGCTGGTGCTGCAGCTTATTA
s2_F_826_AACGCGTATC	AATGATACGGCGACCACCGAGATCTACACAACGCGTATCGCTGGTGCTGCAGCTTATTA
s2_F_827_ACCAACGCAT	AATGATACGGCGACCACCGAGATCTACACACCAACGCATGCTGGTGCTGCAGCTTATTA
s2_F_828_TCTCAGCGTG	AATGATACGGCGACCACCGAGATCTACACTCTCAGCGTGGCTGGTGCTGCAGCTTATTA
s2_F_829_CTTAAGAGCG	AATGATACGGCGACCACCGAGATCTACACCTTAAGAGCGGCTGGTGCTGCAGCTTATTA
s2_F_830_GGCTTGATCC	AATGATACGGCGACCACCGAGATCTACACGGCTTGATCCGCTGGTGCTGCAGCTTATTA
s2_F_831_GCGTAGGTTG	AATGATACGGCGACCACCGAGATCTACACGCGTAGGTTGGCTGGTGCTGCAGCTTATTA
s2_F_832_AACGTTGTCT	AATGATACGGCGACCACCGAGATCTACACAACGTTGTCTGCTGGTGCTGCAGCTTATTA
s2_F_833_CCGGTGTGAT	AATGATACGGCGACCACCGAGATCTACACCCGGTGTGATGCTGGTGCTGCAGCTTATTA
s2_F_834_ACGAGGAGTC	AATGATACGGCGACCACCGAGATCTACACACGAGGAGTCGCTGGTGCTGCAGCTTATTA
s2_F_835_TGGCCTGTTG	AATGATACGGCGACCACCGAGATCTACACTGGCCTGTTGGCTGGTGCTGCAGCTTATTA
s2_F_836_CGTCCTGAAG	AATGATACGGCGACCACCGAGATCTACACCGTCCTGAAGGCTGGTGCTGCAGCTTATTA
s2_F_837_GTACGTCCAT	AATGATACGGCGACCACCGAGATCTACACGTACGTCCATGCTGGTGCTGCAGCTTATTA
s2_F_838_AATTGCGGAT	AATGATACGGCGACCACCGAGATCTACACAATTGCGGATGCTGGTGCTGCAGCTTATTA
s2_F_839_ACACACGTGG	AATGATACGGCGACCACCGAGATCTACACACACACGTGGGCTGGTGCTGCAGCTTATTA
s2_F_840_CCAGCTGTAT	AATGATACGGCGACCACCGAGATCTACACCCAGCTGTATGCTGGTGCTGCAGCTTATTA
s2_F_841_AGCCAGAATC	AATGATACGGCGACCACCGAGATCTACACAGCCAGAATCGCTGGTGCTGCAGCTTATTA
s2_F_842_GTCGGACCTA	AATGATACGGCGACCACCGAGATCTACACGTCGGACCTAGCTGGTGCTGCAGCTTATTA
s2_F_843_TGCTAAGCGG	AATGATACGGCGACCACCGAGATCTACACTGCTAAGCGGGCTGGTGCTGCAGCTTATTA
s2_F_844_GTACAGACTT	AATGATACGGCGACCACCGAGATCTACACGTACAGACTTGCTGGTGCTGCAGCTTATTA
s2_F_845_AACCTGCTCA	AATGATACGGCGACCACCGAGATCTACACAACCTGCTCAGCTGGTGCTGCAGCTTATTA
s2_F_846_AGATTGTGGC	AATGATACGGCGACCACCGAGATCTACACAGATTGTGGCGCTGGTGCTGCAGCTTATTA
s2_F_847_GAGAATGGCT	AATGATACGGCGACCACCGAGATCTACACGAGAATGGCTGCTGGTGCTGCAGCTTATTA
s2_F_848_CGGAGGAGTA	AATGATACGGCGACCACCGAGATCTACACCGGAGGAGTAGCTGGTGCTGCAGCTTATTA
s2_F_849_ACATCGATGC	AATGATACGGCGACCACCGAGATCTACACACATCGATGCGCTGGTGCTGCAGCTTATTA
s2_F_850_GAATATTGCC	AATGATACGGCGACCACCGAGATCTACACGAATATTGCCGCTGGTGCTGCAGCTTATTA
s2_F_851_GCGGACGATA	AATGATACGGCGACCACCGAGATCTACACGCGGACGATAGCTGGTGCTGCAGCTTATTA
s2_F_852_AGCTATCGTC	AATGATACGGCGACCACCGAGATCTACACAGCTATCGTCGCTGGTGCTGCAGCTTATTA
s2_F_853_AATTCGGAGC	AATGATACGGCGACCACCGAGATCTACACAATTCGGAGCGCTGGTGCTGCAGCTTATTA
s2_F_854_AGCTGTTCAA	AATGATACGGCGACCACCGAGATCTACACAGCTGTTCAAGCTGGTGCTGCAGCTTATTA
s2_F_855_AGGCAACACA	AATGATACGGCGACCACCGAGATCTACACAGGCAACACAGCTGGTGCTGCAGCTTATTA
s2_F_856_AGTAACCGCT	AATGATACGGCGACCACCGAGATCTACACAGTAACCGCTGCTGGTGCTGCAGCTTATTA
s2_F_857_ACTGGCATGC	AATGATACGGCGACCACCGAGATCTACACACTGGCATGCGCTGGTGCTGCAGCTTATTA
s2_F_858_TGATTGAGCG	AATGATACGGCGACCACCGAGATCTACACTGATTGAGCGGCTGGTGCTGCAGCTTATTA
s2_F_859_GGCATGATTA	AATGATACGGCGACCACCGAGATCTACACGGCATGATTAGCTGGTGCTGCAGCTTATTA
s2_F_860_AGCCTCAGTT	AATGATACGGCGACCACCGAGATCTACACAGCCTCAGTTGCTGGTGCTGCAGCTTATTA
s2_F_861_GGCAATAACT	AATGATACGGCGACCACCGAGATCTACACGGCAATAACTGCTGGTGCTGCAGCTTATTA
s2_F_862_TAATGATGCG	AATGATACGGCGACCACCGAGATCTACACTAATGATGCGGCTGGTGCTGCAGCTTATTA
s2_F_863_CTGTACGTAG	AATGATACGGCGACCACCGAGATCTACACCTGTACGTAGGCTGGTGCTGCAGCTTATTA
s2_F_864_AAGGACCGTC	AATGATACGGCGACCACCGAGATCTACACAAGGACCGTCGCTGGTGCTGCAGCTTATTA
s2_F_865_AGCCTCCTAA	AATGATACGGCGACCACCGAGATCTACACAGCCTCCTAAGCTGGTGCTGCAGCTTATTA
s2_F_866_GACTAGTCTT	AATGATACGGCGACCACCGAGATCTACACGACTAGTCTTGCTGGTGCTGCAGCTTATTA
s2_F_867_AAGGCCGGTT	AATGATACGGCGACCACCGAGATCTACACAAGGCCGGTTGCTGGTGCTGCAGCTTATTA
s2_F_868_GGTTACTCGA	AATGATACGGCGACCACCGAGATCTACACGGTTACTCGAGCTGGTGCTGCAGCTTATTA
s2_F_869_TCTGATCCGG	AATGATACGGCGACCACCGAGATCTACACTCTGATCCGGGCTGGTGCTGCAGCTTATTA
s2_F_870_CCATAAGCCA	AATGATACGGCGACCACCGAGATCTACACCCATAAGCCAGCTGGTGCTGCAGCTTATTA
s2_F_871_CCGTATAAGG	AATGATACGGCGACCACCGAGATCTACACCCGTATAAGGGCTGGTGCTGCAGCTTATTA
s2_F_872_GGTTCCTACG	AATGATACGGCGACCACCGAGATCTACACGGTTCCTACGGCTGGTGCTGCAGCTTATTA
s2_F_873_ATAGAGTGGC	AATGATACGGCGACCACCGAGATCTACACATAGAGTGGCGCTGGTGCTGCAGCTTATTA
s2_F_874_GCGATACTTA	AATGATACGGCGACCACCGAGATCTACACGCGATACTTAGCTGGTGCTGCAGCTTATTA
s2_F_875_ATGCGGAACA	AATGATACGGCGACCACCGAGATCTACACATGCGGAACAGCTGGTGCTGCAGCTTATTA
s2_F_876_ATTCGAACGT	AATGATACGGCGACCACCGAGATCTACACATTCGAACGTGCTGGTGCTGCAGCTTATTA
s2_F_877_AGGTACCATC	AATGATACGGCGACCACCGAGATCTACACAGGTACCATCGCTGGTGCTGCAGCTTATTA
s2_F_878_CGCTGATGAC	AATGATACGGCGACCACCGAGATCTACACCGCTGATGACGCTGGTGCTGCAGCTTATTA
s2_F_879_TCCGGTCCTT	AATGATACGGCGACCACCGAGATCTACACTCCGGTCCTTGCTGGTGCTGCAGCTTATTA
s2_F_880_GGAGTTAGTT	AATGATACGGCGACCACCGAGATCTACACGGAGTTAGTTGCTGGTGCTGCAGCTTATTA
s2_F_881_GGATGAAGTT	AATGATACGGCGACCACCGAGATCTACACGGATGAAGTTGCTGGTGCTGCAGCTTATTA
s2_F_882_CGTACTCGAC	AATGATACGGCGACCACCGAGATCTACACCGTACTCGACGCTGGTGCTGCAGCTTATTA
s2_F_883_CTCAGACAGA	AATGATACGGCGACCACCGAGATCTACACCTCAGACAGAGCTGGTGCTGCAGCTTATTA
s2_F_884_TGCGTTCACG	AATGATACGGCGACCACCGAGATCTACACTGCGTTCACGGCTGGTGCTGCAGCTTATTA
s2_F_885_AATGAGGCCG	AATGATACGGCGACCACCGAGATCTACACAATGAGGCCGGCTGGTGCTGCAGCTTATTA
s2_F_886_GACGAACGTT	AATGATACGGCGACCACCGAGATCTACACGACGAACGTTGCTGGTGCTGCAGCTTATTA
s2_F_887_GACGAATAAG	AATGATACGGCGACCACCGAGATCTACACGACGAATAAGGCTGGTGCTGCAGCTTATTA
s2_F_888_GACGAGCCAA	AATGATACGGCGACCACCGAGATCTACACGACGAGCCAAGCTGGTGCTGCAGCTTATTA
s2_F_889_GACGAGTTCT	AATGATACGGCGACCACCGAGATCTACACGACGAGTTCTGCTGGTGCTGCAGCTTATTA
s2_F_890_GACGATATGG	AATGATACGGCGACCACCGAGATCTACACGACGATATGGGCTGGTGCTGCAGCTTATTA
s2_F_891_ACGTGAATGT	AATGATACGGCGACCACCGAGATCTACACACGTGAATGTGCTGGTGCTGCAGCTTATTA
s2_F_892_GTTAGAGGTA	AATGATACGGCGACCACCGAGATCTACACGTTAGAGGTAGCTGGTGCTGCAGCTTATTA
s2_F_893_AGAGACTGTA	AATGATACGGCGACCACCGAGATCTACACAGAGACTGTAGCTGGTGCTGCAGCTTATTA
s2_F_894_CGGTTGTATG	AATGATACGGCGACCACCGAGATCTACACCGGTTGTATGGCTGGTGCTGCAGCTTATTA
s2_F_895_GACGAGCAGT	AATGATACGGCGACCACCGAGATCTACACGACGAGCAGTGCTGGTGCTGCAGCTTATTA
s2_F_896_CTCTGGTGAT	AATGATACGGCGACCACCGAGATCTACACCTCTGGTGATGCTGGTGCTGCAGCTTATTA
s2_F_897_CTTATGCATC	AATGATACGGCGACCACCGAGATCTACACCTTATGCATCGCTGGTGCTGCAGCTTATTA
s2_F_898_CGTGGACGTA	AATGATACGGCGACCACCGAGATCTACACCGTGGACGTAGCTGGTGCTGCAGCTTATTA
s2_F_899_ACGACACTTC	AATGATACGGCGACCACCGAGATCTACACACGACACTTCGCTGGTGCTGCAGCTTATTA
s2_F_900_GCGTCCATTG	AATGATACGGCGACCACCGAGATCTACACGCGTCCATTGGCTGGTGCTGCAGCTTATTA
s2_F_901_GAAGGACTCG	AATGATACGGCGACCACCGAGATCTACACGAAGGACTCGGCTGGTGCTGCAGCTTATTA
s2_F_902_GCGCCTGTTA	AATGATACGGCGACCACCGAGATCTACACGCGCCTGTTAGCTGGTGCTGCAGCTTATTA
s2_F_903_ACCGCATCCT	AATGATACGGCGACCACCGAGATCTACACACCGCATCCTGCTGGTGCTGCAGCTTATTA
s2_F_904_GTCGATACCT	AATGATACGGCGACCACCGAGATCTACACGTCGATACCTGCTGGTGCTGCAGCTTATTA
s2_F_905_AGCTCAACGT	AATGATACGGCGACCACCGAGATCTACACAGCTCAACGTGCTGGTGCTGCAGCTTATTA
s2_F_906_CGAACGTCGA	AATGATACGGCGACCACCGAGATCTACACCGAACGTCGAGCTGGTGCTGCAGCTTATTA
s2_F_907_GTACCTTAGA	AATGATACGGCGACCACCGAGATCTACACGTACCTTAGAGCTGGTGCTGCAGCTTATTA
s2_F_908_ACGTCGATAT	AATGATACGGCGACCACCGAGATCTACACACGTCGATATGCTGGTGCTGCAGCTTATTA
s2_F_909_CGACCGTAAG	AATGATACGGCGACCACCGAGATCTACACCGACCGTAAGGCTGGTGCTGCAGCTTATTA
s2_F_910_ATGGCCTGTC	AATGATACGGCGACCACCGAGATCTACACATGGCCTGTCGCTGGTGCTGCAGCTTATTA
s2_F_911_GGTTGTTACT	AATGATACGGCGACCACCGAGATCTACACGGTTGTTACTGCTGGTGCTGCAGCTTATTA
s2_F_912_CTTGTCCGCT	AATGATACGGCGACCACCGAGATCTACACCTTGTCCGCTGCTGGTGCTGCAGCTTATTA
s2_F_913_GACGTACTCT	AATGATACGGCGACCACCGAGATCTACACGACGTACTCTGCTGGTGCTGCAGCTTATTA
s2_F_914_AGCTGTATGT	AATGATACGGCGACCACCGAGATCTACACAGCTGTATGTGCTGGTGCTGCAGCTTATTA
s2_F_915_AATCACGCCT	AATGATACGGCGACCACCGAGATCTACACAATCACGCCTGCTGGTGCTGCAGCTTATTA
s2_F_916_ACGGACAGTA	AATGATACGGCGACCACCGAGATCTACACACGGACAGTAGCTGGTGCTGCAGCTTATTA
s2_F_917_CGACAACGCT	AATGATACGGCGACCACCGAGATCTACACCGACAACGCTGCTGGTGCTGCAGCTTATTA
s2_F_918_GTGGAGCTAA	AATGATACGGCGACCACCGAGATCTACACGTGGAGCTAAGCTGGTGCTGCAGCTTATTA
s2_F_919_AGTGGACATG	AATGATACGGCGACCACCGAGATCTACACAGTGGACATGGCTGGTGCTGCAGCTTATTA
s2_F_920_AGTGGATTGG	AATGATACGGCGACCACCGAGATCTACACAGTGGATTGGGCTGGTGCTGCAGCTTATTA
s2_F_921_ATTCCTTGGT	AATGATACGGCGACCACCGAGATCTACACATTCCTTGGTGCTGGTGCTGCAGCTTATTA
s2_F_922_AGTCGTGTCA	AATGATACGGCGACCACCGAGATCTACACAGTCGTGTCAGCTGGTGCTGCAGCTTATTA
s2_F_923_GAAGACGTCT	AATGATACGGCGACCACCGAGATCTACACGAAGACGTCTGCTGGTGCTGCAGCTTATTA
s2_F_924_AGTACAGTTC	AATGATACGGCGACCACCGAGATCTACACAGTACAGTTCGCTGGTGCTGCAGCTTATTA
s2_F_925_AGAACGCACA	AATGATACGGCGACCACCGAGATCTACACAGAACGCACAGCTGGTGCTGCAGCTTATTA
s2_F_926_GACGACAATC	AATGATACGGCGACCACCGAGATCTACACGACGACAATCGCTGGTGCTGCAGCTTATTA
s2_F_927_ACAGACTCAC	AATGATACGGCGACCACCGAGATCTACACACAGACTCACGCTGGTGCTGCAGCTTATTA
s2_F_928_GCTTGTACTA	AATGATACGGCGACCACCGAGATCTACACGCTTGTACTAGCTGGTGCTGCAGCTTATTA
s2_F_929_GCGATAACCG	AATGATACGGCGACCACCGAGATCTACACGCGATAACCGGCTGGTGCTGCAGCTTATTA
s2_F_930_TAAGATCGCT	AATGATACGGCGACCACCGAGATCTACACTAAGATCGCTGCTGGTGCTGCAGCTTATTA
s2_F_931_CGACCTCTGA	AATGATACGGCGACCACCGAGATCTACACCGACCTCTGAGCTGGTGCTGCAGCTTATTA
s2_F_932_ACGAGTGATG	AATGATACGGCGACCACCGAGATCTACACACGAGTGATGGCTGGTGCTGCAGCTTATTA
s2_F_933_GCTGAAGATG	AATGATACGGCGACCACCGAGATCTACACGCTGAAGATGGCTGGTGCTGCAGCTTATTA
s2_F_934_GCTGAATGCT	AATGATACGGCGACCACCGAGATCTACACGCTGAATGCTGCTGGTGCTGCAGCTTATTA
s2_F_935_GGTATGGCTG	AATGATACGGCGACCACCGAGATCTACACGGTATGGCTGGCTGGTGCTGCAGCTTATTA
s2_F_936_CAATGGCGAG	AATGATACGGCGACCACCGAGATCTACACCAATGGCGAGGCTGGTGCTGCAGCTTATTA
s2_F_937_CCGCCTAAGA	AATGATACGGCGACCACCGAGATCTACACCCGCCTAAGAGCTGGTGCTGCAGCTTATTA
s2_F_938_AGGTAATCAC	AATGATACGGCGACCACCGAGATCTACACAGGTAATCACGCTGGTGCTGCAGCTTATTA
s2_F_939_TCAACCTCCG	AATGATACGGCGACCACCGAGATCTACACTCAACCTCCGGCTGGTGCTGCAGCTTATTA
s2_F_940_GAACCACGCT	AATGATACGGCGACCACCGAGATCTACACGAACCACGCTGCTGGTGCTGCAGCTTATTA
s2_F_941_GCCTACCACT	AATGATACGGCGACCACCGAGATCTACACGCCTACCACTGCTGGTGCTGCAGCTTATTA
s2_F_942_GCCTCCACAA	AATGATACGGCGACCACCGAGATCTACACGCCTCCACAAGCTGGTGCTGCAGCTTATTA
s2_F_943_GCCTCTGATG	AATGATACGGCGACCACCGAGATCTACACGCCTCTGATGGCTGGTGCTGCAGCTTATTA
s2_F_944_GCCTGATGAT	AATGATACGGCGACCACCGAGATCTACACGCCTGATGATGCTGGTGCTGCAGCTTATTA
s2_F_945_GCCTGTTATT	AATGATACGGCGACCACCGAGATCTACACGCCTGTTATTGCTGGTGCTGCAGCTTATTA
s2_F_946_GCCTTGGAAT	AATGATACGGCGACCACCGAGATCTACACGCCTTGGAATGCTGGTGCTGCAGCTTATTA
s2_F_947_GCCTTGTTAA	AATGATACGGCGACCACCGAGATCTACACGCCTTGTTAAGCTGGTGCTGCAGCTTATTA
s2_F_948_GCCTCTACTT	AATGATACGGCGACCACCGAGATCTACACGCCTCTACTTGCTGGTGCTGCAGCTTATTA
s2_F_949_AAGCCATACA	AATGATACGGCGACCACCGAGATCTACACAAGCCATACAGCTGGTGCTGCAGCTTATTA
s2_F_950_GCGACCAGTT	AATGATACGGCGACCACCGAGATCTACACGCGACCAGTTGCTGGTGCTGCAGCTTATTA
s2_F_951_ATGAGCTCTA	AATGATACGGCGACCACCGAGATCTACACATGAGCTCTAGCTGGTGCTGCAGCTTATTA
s2_F_952_AAGGTTCGCT	AATGATACGGCGACCACCGAGATCTACACAAGGTTCGCTGCTGGTGCTGCAGCTTATTA
s2_F_953_CATGGCATTA	AATGATACGGCGACCACCGAGATCTACACCATGGCATTAGCTGGTGCTGCAGCTTATTA
s2_F_954_TCCTGGATCG	AATGATACGGCGACCACCGAGATCTACACTCCTGGATCGGCTGGTGCTGCAGCTTATTA
s2_F_955_ACATCGCACT	AATGATACGGCGACCACCGAGATCTACACACATCGCACTGCTGGTGCTGCAGCTTATTA
s2_F_956_GTTGTTCAGA	AATGATACGGCGACCACCGAGATCTACACGTTGTTCAGAGCTGGTGCTGCAGCTTATTA
s2_F_957_ATCGAGCCAC	AATGATACGGCGACCACCGAGATCTACACATCGAGCCACGCTGGTGCTGCAGCTTATTA
s2_F_958_ATCCGTTGTC	AATGATACGGCGACCACCGAGATCTACACATCCGTTGTCGCTGGTGCTGCAGCTTATTA
s2_F_959_ACGTCGTCCT	AATGATACGGCGACCACCGAGATCTACACACGTCGTCCTGCTGGTGCTGCAGCTTATTA
s2_F_960_GTCGATTAGA	AATGATACGGCGACCACCGAGATCTACACGTCGATTAGAGCTGGTGCTGCAGCTTATTA
s2_F_961_AGGTGTCACC	AATGATACGGCGACCACCGAGATCTACACAGGTGTCACCGCTGGTGCTGCAGCTTATTA
s2_F_962_GGTCTCGTTA	AATGATACGGCGACCACCGAGATCTACACGGTCTCGTTAGCTGGTGCTGCAGCTTATTA
s2_F_963_GAGTGGAACG	AATGATACGGCGACCACCGAGATCTACACGAGTGGAACGGCTGGTGCTGCAGCTTATTA
s2_F_964_GGACACTGAT	AATGATACGGCGACCACCGAGATCTACACGGACACTGATGCTGGTGCTGCAGCTTATTA
s2_F_965_CGTTGGATAT	AATGATACGGCGACCACCGAGATCTACACCGTTGGATATGCTGGTGCTGCAGCTTATTA
s2_F_966_TTCGATGACG	AATGATACGGCGACCACCGAGATCTACACTTCGATGACGGCTGGTGCTGCAGCTTATTA
s2_F_967_GTATCACTGC	AATGATACGGCGACCACCGAGATCTACACGTATCACTGCGCTGGTGCTGCAGCTTATTA
s2_F_968_ACTTCAGCGA	AATGATACGGCGACCACCGAGATCTACACACTTCAGCGAGCTGGTGCTGCAGCTTATTA
s2_F_969_ACCGCACGAT	AATGATACGGCGACCACCGAGATCTACACACCGCACGATGCTGGTGCTGCAGCTTATTA
s2_F_970_ACTCTTGCTG	AATGATACGGCGACCACCGAGATCTACACACTCTTGCTGGCTGGTGCTGCAGCTTATTA
s2_F_971_CTGGAGACCT	AATGATACGGCGACCACCGAGATCTACACCTGGAGACCTGCTGGTGCTGCAGCTTATTA
s2_F_972_GGCCTTATGC	AATGATACGGCGACCACCGAGATCTACACGGCCTTATGCGCTGGTGCTGCAGCTTATTA
s2_F_973_CTAGCTGTTA	AATGATACGGCGACCACCGAGATCTACACCTAGCTGTTAGCTGGTGCTGCAGCTTATTA
s2_F_974_ATCCAGCTAA	AATGATACGGCGACCACCGAGATCTACACATCCAGCTAAGCTGGTGCTGCAGCTTATTA
s2_F_975_CCGCACAATA	AATGATACGGCGACCACCGAGATCTACACCCGCACAATAGCTGGTGCTGCAGCTTATTA
s2_F_976_AGTGGCCTCA	AATGATACGGCGACCACCGAGATCTACACAGTGGCCTCAGCTGGTGCTGCAGCTTATTA
s2_F_977_CACGTTCAAC	AATGATACGGCGACCACCGAGATCTACACCACGTTCAACGCTGGTGCTGCAGCTTATTA
s2_F_978_CATTCCATGG	AATGATACGGCGACCACCGAGATCTACACCATTCCATGGGCTGGTGCTGCAGCTTATTA
s2_F_979_ACGTGTCGTT	AATGATACGGCGACCACCGAGATCTACACACGTGTCGTTGCTGGTGCTGCAGCTTATTA
s2_F_980_CGAACTTATC	AATGATACGGCGACCACCGAGATCTACACCGAACTTATCGCTGGTGCTGCAGCTTATTA
s2_F_981_CACGCCTTAT	AATGATACGGCGACCACCGAGATCTACACCACGCCTTATGCTGGTGCTGCAGCTTATTA
s2_F_982_CAATATCGAC	AATGATACGGCGACCACCGAGATCTACACCAATATCGACGCTGGTGCTGCAGCTTATTA
s2_F_983_GAGACGATCA	AATGATACGGCGACCACCGAGATCTACACGAGACGATCAGCTGGTGCTGCAGCTTATTA
s2_F_984_ACCGTTGCTA	AATGATACGGCGACCACCGAGATCTACACACCGTTGCTAGCTGGTGCTGCAGCTTATTA
s2_F_985_CGTCACTAGG	AATGATACGGCGACCACCGAGATCTACACCGTCACTAGGGCTGGTGCTGCAGCTTATTA
s2_F_986_AAGTCGAACT	AATGATACGGCGACCACCGAGATCTACACAAGTCGAACTGCTGGTGCTGCAGCTTATTA
s2_F_987_GCCTAGAATT	AATGATACGGCGACCACCGAGATCTACACGCCTAGAATTGCTGGTGCTGCAGCTTATTA
s2_F_988_AACACTCGAT	AATGATACGGCGACCACCGAGATCTACACAACACTCGATGCTGGTGCTGCAGCTTATTA
s2_F_989_GCCTTCGGTT	AATGATACGGCGACCACCGAGATCTACACGCCTTCGGTTGCTGGTGCTGCAGCTTATTA
s2_F_990_GGCTAGCTTA	AATGATACGGCGACCACCGAGATCTACACGGCTAGCTTAGCTGGTGCTGCAGCTTATTA
s2_F_991_ACTCTAGAGG	AATGATACGGCGACCACCGAGATCTACACACTCTAGAGGGCTGGTGCTGCAGCTTATTA
s2_F_992_ATACATCGCT	AATGATACGGCGACCACCGAGATCTACACATACATCGCTGCTGGTGCTGCAGCTTATTA
s2_F_993_TCGAATAGGA	AATGATACGGCGACCACCGAGATCTACACTCGAATAGGAGCTGGTGCTGCAGCTTATTA
s2_F_994_ACCACTCGTC	AATGATACGGCGACCACCGAGATCTACACACCACTCGTCGCTGGTGCTGCAGCTTATTA
s2_F_995_CGCCAACTAA	AATGATACGGCGACCACCGAGATCTACACCGCCAACTAAGCTGGTGCTGCAGCTTATTA
s2_F_996_GTCGTGCGAT	AATGATACGGCGACCACCGAGATCTACACGTCGTGCGATGCTGGTGCTGCAGCTTATTA
s2_F_997_AGTGTGCATT	AATGATACGGCGACCACCGAGATCTACACAGTGTGCATTGCTGGTGCTGCAGCTTATTA
s2_F_998_ACTAACGTGT	AATGATACGGCGACCACCGAGATCTACACACTAACGTGTGCTGGTGCTGCAGCTTATTA
s2_F_999_CGAGACATTG	AATGATACGGCGACCACCGAGATCTACACCGAGACATTGGCTGGTGCTGCAGCTTATTA
s2_F_1000_CTAGCCAACA	AATGATACGGCGACCACCGAGATCTACACCTAGCCAACAGCTGGTGCTGCAGCTTATTA
s2_F_1001_CGTGAGGTTC	AATGATACGGCGACCACCGAGATCTACACCGTGAGGTTCGCTGGTGCTGCAGCTTATTA
s2_F_1002_TGGCAACAAC	AATGATACGGCGACCACCGAGATCTACACTGGCAACAACGCTGGTGCTGCAGCTTATTA
s2_F_1003_GCTGAGCAGA	AATGATACGGCGACCACCGAGATCTACACGCTGAGCAGAGCTGGTGCTGCAGCTTATTA
s2_F_1004_GATTCGCAAG	AATGATACGGCGACCACCGAGATCTACACGATTCGCAAGGCTGGTGCTGCAGCTTATTA
s2_F_1005_ACCTTCTCCG	AATGATACGGCGACCACCGAGATCTACACACCTTCTCCGGCTGGTGCTGCAGCTTATTA
s2_F_1006_CTATCTCAGC	AATGATACGGCGACCACCGAGATCTACACCTATCTCAGCGCTGGTGCTGCAGCTTATTA
s2_F_1007_ACCAGATGTC	AATGATACGGCGACCACCGAGATCTACACACCAGATGTCGCTGGTGCTGCAGCTTATTA
s2_F_1008_AATTGGATCC	AATGATACGGCGACCACCGAGATCTACACAATTGGATCCGCTGGTGCTGCAGCTTATTA
s2_F_1009_ATACAGATCC	AATGATACGGCGACCACCGAGATCTACACATACAGATCCGCTGGTGCTGCAGCTTATTA
s2_F_1010_AGCCACACGA	AATGATACGGCGACCACCGAGATCTACACAGCCACACGAGCTGGTGCTGCAGCTTATTA
s2_F_1011_CGACACAAGT	AATGATACGGCGACCACCGAGATCTACACCGACACAAGTGCTGGTGCTGCAGCTTATTA
s2_F_1012_AAGGCGTGAT	AATGATACGGCGACCACCGAGATCTACACAAGGCGTGATGCTGGTGCTGCAGCTTATTA
s2_F_1013_GAAGCGCCTT	AATGATACGGCGACCACCGAGATCTACACGAAGCGCCTTGCTGGTGCTGCAGCTTATTA
s2_F_1014_ATGGCCTTGA	AATGATACGGCGACCACCGAGATCTACACATGGCCTTGAGCTGGTGCTGCAGCTTATTA
s2_F_1015_GTTAAGACGT	AATGATACGGCGACCACCGAGATCTACACGTTAAGACGTGCTGGTGCTGCAGCTTATTA
s2_F_1016_GAGCTTAACA	AATGATACGGCGACCACCGAGATCTACACGAGCTTAACAGCTGGTGCTGCAGCTTATTA
s2_F_1017_AACAAGGCGT	AATGATACGGCGACCACCGAGATCTACACAACAAGGCGTGCTGGTGCTGCAGCTTATTA
s2_F_1018_AGGTTGCTAT	AATGATACGGCGACCACCGAGATCTACACAGGTTGCTATGCTGGTGCTGCAGCTTATTA
s2_F_1019_GCAAGCGATG	AATGATACGGCGACCACCGAGATCTACACGCAAGCGATGGCTGGTGCTGCAGCTTATTA
s2_F_1020_AGATGTGTCG	AATGATACGGCGACCACCGAGATCTACACAGATGTGTCGGCTGGTGCTGCAGCTTATTA
s2_F_1021_CAAGTCTGAC	AATGATACGGCGACCACCGAGATCTACACCAAGTCTGACGCTGGTGCTGCAGCTTATTA
s2_F_1022_AAGTACCTAG	AATGATACGGCGACCACCGAGATCTACACAAGTACCTAGGCTGGTGCTGCAGCTTATTA
s2_F_1023_CCGTATCTAA	AATGATACGGCGACCACCGAGATCTACACCCGTATCTAAGCTGGTGCTGCAGCTTATTA
s2_F_1024_AGGACTCGCT	AATGATACGGCGACCACCGAGATCTACACAGGACTCGCTGCTGGTGCTGCAGCTTATTA
s2_F_1025_CGAGCATCAT	AATGATACGGCGACCACCGAGATCTACACCGAGCATCATGCTGGTGCTGCAGCTTATTA
s2_F_1026_CGCAAGAGCT	AATGATACGGCGACCACCGAGATCTACACCGCAAGAGCTGCTGGTGCTGCAGCTTATTA
s2_F_1027_TCGAGGCTAT	AATGATACGGCGACCACCGAGATCTACACTCGAGGCTATGCTGGTGCTGCAGCTTATTA
s2_F_1028_GTCGAAGACC	AATGATACGGCGACCACCGAGATCTACACGTCGAAGACCGCTGGTGCTGCAGCTTATTA
s2_F_1029_CACGATAGTC	AATGATACGGCGACCACCGAGATCTACACCACGATAGTCGCTGGTGCTGCAGCTTATTA
s2_F_1030_AGATAACTCG	AATGATACGGCGACCACCGAGATCTACACAGATAACTCGGCTGGTGCTGCAGCTTATTA
s2_F_1031_AACTCACGGC	AATGATACGGCGACCACCGAGATCTACACAACTCACGGCGCTGGTGCTGCAGCTTATTA
s2_F_1032_CCAGCCAGTT	AATGATACGGCGACCACCGAGATCTACACCCAGCCAGTTGCTGGTGCTGCAGCTTATTA
s2_F_1033_AGGAAGTATC	AATGATACGGCGACCACCGAGATCTACACAGGAAGTATCGCTGGTGCTGCAGCTTATTA
s2_F_1034_TCACTCCGTC	AATGATACGGCGACCACCGAGATCTACACTCACTCCGTCGCTGGTGCTGCAGCTTATTA
s2_F_1035_GCTGTTGTTA	AATGATACGGCGACCACCGAGATCTACACGCTGTTGTTAGCTGGTGCTGCAGCTTATTA
s2_F_1036_TGGCTGTTCA	AATGATACGGCGACCACCGAGATCTACACTGGCTGTTCAGCTGGTGCTGCAGCTTATTA
s2_F_1037_ATGAGGCGAG	AATGATACGGCGACCACCGAGATCTACACATGAGGCGAGGCTGGTGCTGCAGCTTATTA
s2_F_1038_TATAGGCGAA	AATGATACGGCGACCACCGAGATCTACACTATAGGCGAAGCTGGTGCTGCAGCTTATTA
s2_F_1039_ATTCGCAACC	AATGATACGGCGACCACCGAGATCTACACATTCGCAACCGCTGGTGCTGCAGCTTATTA
s2_F_1040_CGACACATCC	AATGATACGGCGACCACCGAGATCTACACCGACACATCCGCTGGTGCTGCAGCTTATTA
s2_F_1041_CGCGTAGTAA	AATGATACGGCGACCACCGAGATCTACACCGCGTAGTAAGCTGGTGCTGCAGCTTATTA
s2_F_1042_ATGGCTTCAG	AATGATACGGCGACCACCGAGATCTACACATGGCTTCAGGCTGGTGCTGCAGCTTATTA
s2_F_1043_CCGCTGGAAT	AATGATACGGCGACCACCGAGATCTACACCCGCTGGAATGCTGGTGCTGCAGCTTATTA
s2_F_1044_CGTCGAATAC	AATGATACGGCGACCACCGAGATCTACACCGTCGAATACGCTGGTGCTGCAGCTTATTA
s2_F_1045_CGTCGAGAGT	AATGATACGGCGACCACCGAGATCTACACCGTCGAGAGTGCTGGTGCTGCAGCTTATTA
s2_F_1046_AACCTCGGAA	AATGATACGGCGACCACCGAGATCTACACAACCTCGGAAGCTGGTGCTGCAGCTTATTA
s2_F_1047_GGTATACCTA	AATGATACGGCGACCACCGAGATCTACACGGTATACCTAGCTGGTGCTGCAGCTTATTA
s2_F_1048_AGTCTACGGC	AATGATACGGCGACCACCGAGATCTACACAGTCTACGGCGCTGGTGCTGCAGCTTATTA
s2_F_1049_TCTAACCGTC	AATGATACGGCGACCACCGAGATCTACACTCTAACCGTCGCTGGTGCTGCAGCTTATTA
s2_F_1050_AAGGTCACAC	AATGATACGGCGACCACCGAGATCTACACAAGGTCACACGCTGGTGCTGCAGCTTATTA
s2_F_1051_AACTACGGTA	AATGATACGGCGACCACCGAGATCTACACAACTACGGTAGCTGGTGCTGCAGCTTATTA
s2_F_1052_ACAATAAGGC	AATGATACGGCGACCACCGAGATCTACACACAATAAGGCGCTGGTGCTGCAGCTTATTA
s2_F_1053_AGCTATATCC	AATGATACGGCGACCACCGAGATCTACACAGCTATATCCGCTGGTGCTGCAGCTTATTA
s2_F_1054_CCATCGCTAA	AATGATACGGCGACCACCGAGATCTACACCCATCGCTAAGCTGGTGCTGCAGCTTATTA
s2_F_1055_CTGGAGATTC	AATGATACGGCGACCACCGAGATCTACACCTGGAGATTCGCTGGTGCTGCAGCTTATTA
s2_F_1056_GAGTGTACTG	AATGATACGGCGACCACCGAGATCTACACGAGTGTACTGGCTGGTGCTGCAGCTTATTA
s2_F_1057_GCATAGATCC	AATGATACGGCGACCACCGAGATCTACACGCATAGATCCGCTGGTGCTGCAGCTTATTA
s2_F_1058_GCTTGCAATC	AATGATACGGCGACCACCGAGATCTACACGCTTGCAATCGCTGGTGCTGCAGCTTATTA
s2_F_1059_GGAGAAGTAA	AATGATACGGCGACCACCGAGATCTACACGGAGAAGTAAGCTGGTGCTGCAGCTTATTA
s2_F_1060_GGAGCTATTA	AATGATACGGCGACCACCGAGATCTACACGGAGCTATTAGCTGGTGCTGCAGCTTATTA
s2_F_1061_GTAAGAGCAT	AATGATACGGCGACCACCGAGATCTACACGTAAGAGCATGCTGGTGCTGCAGCTTATTA
s2_F_1062_GTCAGTGACT	AATGATACGGCGACCACCGAGATCTACACGTCAGTGACTGCTGGTGCTGCAGCTTATTA
s2_F_1063_GTGACAGTAA	AATGATACGGCGACCACCGAGATCTACACGTGACAGTAAGCTGGTGCTGCAGCTTATTA
s2_F_1064_GTGACCAGAG	AATGATACGGCGACCACCGAGATCTACACGTGACCAGAGGCTGGTGCTGCAGCTTATTA
s2_F_1065_TAATACCGGA	AATGATACGGCGACCACCGAGATCTACACTAATACCGGAGCTGGTGCTGCAGCTTATTA
s2_F_1066_TAGAGGTCTA	AATGATACGGCGACCACCGAGATCTACACTAGAGGTCTAGCTGGTGCTGCAGCTTATTA
s2_F_1067_TCATTGAGGA	AATGATACGGCGACCACCGAGATCTACACTCATTGAGGAGCTGGTGCTGCAGCTTATTA
s2_F_1068_TCCAGGAGTA	AATGATACGGCGACCACCGAGATCTACACTCCAGGAGTAGCTGGTGCTGCAGCTTATTA
s2_F_1069_TCTTCGGAGG	AATGATACGGCGACCACCGAGATCTACACTCTTCGGAGGGCTGGTGCTGCAGCTTATTA
s2_F_1070_TGCGTACGTG	AATGATACGGCGACCACCGAGATCTACACTGCGTACGTGGCTGGTGCTGCAGCTTATTA
s2_F_1071_TGGAGGTAAT	AATGATACGGCGACCACCGAGATCTACACTGGAGGTAATGCTGGTGCTGCAGCTTATTA
s2_F_1072_TGGCCATATA	AATGATACGGCGACCACCGAGATCTACACTGGCCATATAGCTGGTGCTGCAGCTTATTA
s2_F_1073_ATTAGCGGTT	AATGATACGGCGACCACCGAGATCTACACATTAGCGGTTGCTGGTGCTGCAGCTTATTA
s2_F_1074_ATCAGTGAAC	AATGATACGGCGACCACCGAGATCTACACATCAGTGAACGCTGGTGCTGCAGCTTATTA
s2_F_1075_AAGTACTCTC	AATGATACGGCGACCACCGAGATCTACACAAGTACTCTCGCTGGTGCTGCAGCTTATTA
s2_F_1076_AAGAGCTATC	AATGATACGGCGACCACCGAGATCTACACAAGAGCTATCGCTGGTGCTGCAGCTTATTA
s2_F_1077_GATGTAGCTT	AATGATACGGCGACCACCGAGATCTACACGATGTAGCTTGCTGGTGCTGCAGCTTATTA
s2_F_1078_TCTACGACGA	AATGATACGGCGACCACCGAGATCTACACTCTACGACGAGCTGGTGCTGCAGCTTATTA
s2_F_1079_GAACTGATCC	AATGATACGGCGACCACCGAGATCTACACGAACTGATCCGCTGGTGCTGCAGCTTATTA
s2_F_1080_GCAACCTGAG	AATGATACGGCGACCACCGAGATCTACACGCAACCTGAGGCTGGTGCTGCAGCTTATTA
s2_F_1081_TAGCCTCTCA	AATGATACGGCGACCACCGAGATCTACACTAGCCTCTCAGCTGGTGCTGCAGCTTATTA
s2_F_1082_GACTACGTGA	AATGATACGGCGACCACCGAGATCTACACGACTACGTGAGCTGGTGCTGCAGCTTATTA
s2_F_1083_AGGCTTGGAG	AATGATACGGCGACCACCGAGATCTACACAGGCTTGGAGGCTGGTGCTGCAGCTTATTA
s2_F_1084_TGGCGACACT	AATGATACGGCGACCACCGAGATCTACACTGGCGACACTGCTGGTGCTGCAGCTTATTA
s2_F_1085_GCGAATATCA	AATGATACGGCGACCACCGAGATCTACACGCGAATATCAGCTGGTGCTGCAGCTTATTA
s2_F_1086_GCGATGATAT	AATGATACGGCGACCACCGAGATCTACACGCGATGATATGCTGGTGCTGCAGCTTATTA
s2_F_1087_ATATCCGGAT	AATGATACGGCGACCACCGAGATCTACACATATCCGGATGCTGGTGCTGCAGCTTATTA
s2_F_1088_GCCTATGCTA	AATGATACGGCGACCACCGAGATCTACACGCCTATGCTAGCTGGTGCTGCAGCTTATTA
s2_F_1089_AGTCATTGTC	AATGATACGGCGACCACCGAGATCTACACAGTCATTGTCGCTGGTGCTGCAGCTTATTA
s2_F_1090_GACAGCGTTA	AATGATACGGCGACCACCGAGATCTACACGACAGCGTTAGCTGGTGCTGCAGCTTATTA
s2_F_1091_GTACCAAGTC	AATGATACGGCGACCACCGAGATCTACACGTACCAAGTCGCTGGTGCTGCAGCTTATTA
s2_F_1092_GCCAACTCAG	AATGATACGGCGACCACCGAGATCTACACGCCAACTCAGGCTGGTGCTGCAGCTTATTA
s2_F_1093_GCCAAGTAAT	AATGATACGGCGACCACCGAGATCTACACGCCAAGTAATGCTGGTGCTGCAGCTTATTA
s2_F_1094_GCCAATCCTT	AATGATACGGCGACCACCGAGATCTACACGCCAATCCTTGCTGGTGCTGCAGCTTATTA
s2_F_1095_GCCACCAATA	AATGATACGGCGACCACCGAGATCTACACGCCACCAATAGCTGGTGCTGCAGCTTATTA
s2_F_1096_GCCACGAGAT	AATGATACGGCGACCACCGAGATCTACACGCCACGAGATGCTGGTGCTGCAGCTTATTA
s2_F_1097_GCCACGTACA	AATGATACGGCGACCACCGAGATCTACACGCCACGTACAGCTGGTGCTGCAGCTTATTA
s2_F_1098_GCCACTCTCA	AATGATACGGCGACCACCGAGATCTACACGCCACTCTCAGCTGGTGCTGCAGCTTATTA
s2_F_1099_GCCAGTAACC	AATGATACGGCGACCACCGAGATCTACACGCCAGTAACCGCTGGTGCTGCAGCTTATTA
s2_F_1100_GCCAGTAGGT	AATGATACGGCGACCACCGAGATCTACACGCCAGTAGGTGCTGGTGCTGCAGCTTATTA
s2_F_1101_GCCAGTGAAG	AATGATACGGCGACCACCGAGATCTACACGCCAGTGAAGGCTGGTGCTGCAGCTTATTA
s2_F_1102_GCCATACCTG	AATGATACGGCGACCACCGAGATCTACACGCCATACCTGGCTGGTGCTGCAGCTTATTA
s2_F_1103_GCCATAGAGG	AATGATACGGCGACCACCGAGATCTACACGCCATAGAGGGCTGGTGCTGCAGCTTATTA
s2_F_1104_GCCATCCGAA	AATGATACGGCGACCACCGAGATCTACACGCCATCCGAAGCTGGTGCTGCAGCTTATTA
s2_F_1105_GCCATTCAAT	AATGATACGGCGACCACCGAGATCTACACGCCATTCAATGCTGGTGCTGCAGCTTATTA
s2_F_1106_TAGCAGCTAG	AATGATACGGCGACCACCGAGATCTACACTAGCAGCTAGGCTGGTGCTGCAGCTTATTA
s2_F_1107_ACAGTGATCC	AATGATACGGCGACCACCGAGATCTACACACAGTGATCCGCTGGTGCTGCAGCTTATTA
s2_F_1108_GTTGACGTGC	AATGATACGGCGACCACCGAGATCTACACGTTGACGTGCGCTGGTGCTGCAGCTTATTA
s2_F_1109_ACGTGTCTGG	AATGATACGGCGACCACCGAGATCTACACACGTGTCTGGGCTGGTGCTGCAGCTTATTA
s2_F_1110_AAGTTGCAAG	AATGATACGGCGACCACCGAGATCTACACAAGTTGCAAGGCTGGTGCTGCAGCTTATTA
s2_F_1111_ATCCGGAAGC	AATGATACGGCGACCACCGAGATCTACACATCCGGAAGCGCTGGTGCTGCAGCTTATTA
s2_F_1112_CAACTTGGAC	AATGATACGGCGACCACCGAGATCTACACCAACTTGGACGCTGGTGCTGCAGCTTATTA
s2_F_1113_AGTCGGACAC	AATGATACGGCGACCACCGAGATCTACACAGTCGGACACGCTGGTGCTGCAGCTTATTA
s2_F_1114_GTGAGCACTG	AATGATACGGCGACCACCGAGATCTACACGTGAGCACTGGCTGGTGCTGCAGCTTATTA
s2_F_1115_AACCGCACAG	AATGATACGGCGACCACCGAGATCTACACAACCGCACAGGCTGGTGCTGCAGCTTATTA
s2_F_1116_TGAACTGTGA	AATGATACGGCGACCACCGAGATCTACACTGAACTGTGAGCTGGTGCTGCAGCTTATTA
s2_F_1117_ATGTAACGGC	AATGATACGGCGACCACCGAGATCTACACATGTAACGGCGCTGGTGCTGCAGCTTATTA
s2_F_1118_CGGCATGATC	AATGATACGGCGACCACCGAGATCTACACCGGCATGATCGCTGGTGCTGCAGCTTATTA
s2_F_1119_TGTCCGACGT	AATGATACGGCGACCACCGAGATCTACACTGTCCGACGTGCTGGTGCTGCAGCTTATTA
s2_F_1120_GCCTACAGGA	AATGATACGGCGACCACCGAGATCTACACGCCTACAGGAGCTGGTGCTGCAGCTTATTA
s2_F_1121_AGGCTGCCAA	AATGATACGGCGACCACCGAGATCTACACAGGCTGCCAAGCTGGTGCTGCAGCTTATTA
s2_F_1122_GAGTGGTTAA	AATGATACGGCGACCACCGAGATCTACACGAGTGGTTAAGCTGGTGCTGCAGCTTATTA
s2_F_1123_AGTCCACCGT	AATGATACGGCGACCACCGAGATCTACACAGTCCACCGTGCTGGTGCTGCAGCTTATTA
s2_F_1124_ATCGCTAACA	AATGATACGGCGACCACCGAGATCTACACATCGCTAACAGCTGGTGCTGCAGCTTATTA
s2_F_1125_CATGAGACGA	AATGATACGGCGACCACCGAGATCTACACCATGAGACGAGCTGGTGCTGCAGCTTATTA
s2_F_1126_CTAAGAGCTA	AATGATACGGCGACCACCGAGATCTACACCTAAGAGCTAGCTGGTGCTGCAGCTTATTA
s2_F_1127_CAGTAGGCGA	AATGATACGGCGACCACCGAGATCTACACCAGTAGGCGAGCTGGTGCTGCAGCTTATTA
s2_F_1128_AGCTTCCTCC	AATGATACGGCGACCACCGAGATCTACACAGCTTCCTCCGCTGGTGCTGCAGCTTATTA
s2_F_1129_ACCGACGTTA	AATGATACGGCGACCACCGAGATCTACACACCGACGTTAGCTGGTGCTGCAGCTTATTA
s2_F_1130_ACAGGAGATG	AATGATACGGCGACCACCGAGATCTACACACAGGAGATGGCTGGTGCTGCAGCTTATTA
s2_F_1131_AGGCTCTGTA	AATGATACGGCGACCACCGAGATCTACACAGGCTCTGTAGCTGGTGCTGCAGCTTATTA
s2_F_1132_AACTGGCGTA	AATGATACGGCGACCACCGAGATCTACACAACTGGCGTAGCTGGTGCTGCAGCTTATTA
s2_F_1133_ACCACCATCC	AATGATACGGCGACCACCGAGATCTACACACCACCATCCGCTGGTGCTGCAGCTTATTA
s2_F_1134_ATCGCATTAG	AATGATACGGCGACCACCGAGATCTACACATCGCATTAGGCTGGTGCTGCAGCTTATTA
s2_F_1135_AACACGCTGA	AATGATACGGCGACCACCGAGATCTACACAACACGCTGAGCTGGTGCTGCAGCTTATTA
s2_F_1136_ATCCATGATG	AATGATACGGCGACCACCGAGATCTACACATCCATGATGGCTGGTGCTGCAGCTTATTA
s2_F_1137_AAGTAGATGC	AATGATACGGCGACCACCGAGATCTACACAAGTAGATGCGCTGGTGCTGCAGCTTATTA
s2_F_1138_ACGACGCCTA	AATGATACGGCGACCACCGAGATCTACACACGACGCCTAGCTGGTGCTGCAGCTTATTA
s2_F_1139_GAGTTGCACA	AATGATACGGCGACCACCGAGATCTACACGAGTTGCACAGCTGGTGCTGCAGCTTATTA
s2_F_1140_AATCTGCATG	AATGATACGGCGACCACCGAGATCTACACAATCTGCATGGCTGGTGCTGCAGCTTATTA
s2_F_1141_AACCGTCAGC	AATGATACGGCGACCACCGAGATCTACACAACCGTCAGCGCTGGTGCTGCAGCTTATTA
s2_F_1142_ACTGCATGAG	AATGATACGGCGACCACCGAGATCTACACACTGCATGAGGCTGGTGCTGCAGCTTATTA
s2_F_1143_GGTACAAGTT	AATGATACGGCGACCACCGAGATCTACACGGTACAAGTTGCTGGTGCTGCAGCTTATTA
s2_F_1144_ATCCGACGAA	AATGATACGGCGACCACCGAGATCTACACATCCGACGAAGCTGGTGCTGCAGCTTATTA
s2_F_1145_AGCTGGACTA	AATGATACGGCGACCACCGAGATCTACACAGCTGGACTAGCTGGTGCTGCAGCTTATTA
s2_F_1146_AACTGCCAAG	AATGATACGGCGACCACCGAGATCTACACAACTGCCAAGGCTGGTGCTGCAGCTTATTA
s2_F_1147_TGCGCCTGAA	AATGATACGGCGACCACCGAGATCTACACTGCGCCTGAAGCTGGTGCTGCAGCTTATTA
s2_F_1148_CTGAAGGTGT	AATGATACGGCGACCACCGAGATCTACACCTGAAGGTGTGCTGGTGCTGCAGCTTATTA
s2_F_1149_AAGACACTGT	AATGATACGGCGACCACCGAGATCTACACAAGACACTGTGCTGGTGCTGCAGCTTATTA
s2_F_1150_CGAAGCGCAA	AATGATACGGCGACCACCGAGATCTACACCGAAGCGCAAGCTGGTGCTGCAGCTTATTA
s2_F_1151_AGAGATGTTC	AATGATACGGCGACCACCGAGATCTACACAGAGATGTTCGCTGGTGCTGCAGCTTATTA
s2_F_1152_TTAAGGTCGG	AATGATACGGCGACCACCGAGATCTACACTTAAGGTCGGGCTGGTGCTGCAGCTTATTA
s2_F_1153_AAGCTAGCAA	AATGATACGGCGACCACCGAGATCTACACAAGCTAGCAAGCTGGTGCTGCAGCTTATTA
s2_F_1154_GGCAGACATC	AATGATACGGCGACCACCGAGATCTACACGGCAGACATCGCTGGTGCTGCAGCTTATTA
s2_F_1155_TCTCGACATG	AATGATACGGCGACCACCGAGATCTACACTCTCGACATGGCTGGTGCTGCAGCTTATTA
s2_F_1156_GCAGTGATGA	AATGATACGGCGACCACCGAGATCTACACGCAGTGATGAGCTGGTGCTGCAGCTTATTA
s2_F_1157_AGAGGAGCTA	AATGATACGGCGACCACCGAGATCTACACAGAGGAGCTAGCTGGTGCTGCAGCTTATTA
s2_F_1158_CTGGAGGCTA	AATGATACGGCGACCACCGAGATCTACACCTGGAGGCTAGCTGGTGCTGCAGCTTATTA
s2_F_1159_AGGAGATTAG	AATGATACGGCGACCACCGAGATCTACACAGGAGATTAGGCTGGTGCTGCAGCTTATTA
s2_F_1160_GCTGTGAATT	AATGATACGGCGACCACCGAGATCTACACGCTGTGAATTGCTGGTGCTGCAGCTTATTA
s2_F_1161_CATTCGTTAC	AATGATACGGCGACCACCGAGATCTACACCATTCGTTACGCTGGTGCTGCAGCTTATTA
s2_F_1162_CCACAGCTCA	AATGATACGGCGACCACCGAGATCTACACCCACAGCTCAGCTGGTGCTGCAGCTTATTA
s2_F_1163_GCACTCAATT	AATGATACGGCGACCACCGAGATCTACACGCACTCAATTGCTGGTGCTGCAGCTTATTA
s2_F_1164_AGCTAAGACT	AATGATACGGCGACCACCGAGATCTACACAGCTAAGACTGCTGGTGCTGCAGCTTATTA
s2_F_1165_AGTCAGACTG	AATGATACGGCGACCACCGAGATCTACACAGTCAGACTGGCTGGTGCTGCAGCTTATTA
s2_F_1166_ACATGCTTGT	AATGATACGGCGACCACCGAGATCTACACACATGCTTGTGCTGGTGCTGCAGCTTATTA
s2_F_1167_AGATGGAACA	AATGATACGGCGACCACCGAGATCTACACAGATGGAACAGCTGGTGCTGCAGCTTATTA
s2_F_1168_AATGTAGACG	AATGATACGGCGACCACCGAGATCTACACAATGTAGACGGCTGGTGCTGCAGCTTATTA
s2_F_1169_CCTCGCCTTA	AATGATACGGCGACCACCGAGATCTACACCCTCGCCTTAGCTGGTGCTGCAGCTTATTA
s2_F_1170_CAGACTCGTT	AATGATACGGCGACCACCGAGATCTACACCAGACTCGTTGCTGGTGCTGCAGCTTATTA
s2_F_1171_GTATCGCTTG	AATGATACGGCGACCACCGAGATCTACACGTATCGCTTGGCTGGTGCTGCAGCTTATTA
s2_F_1172_GAATGGACTT	AATGATACGGCGACCACCGAGATCTACACGAATGGACTTGCTGGTGCTGCAGCTTATTA
s2_F_1173_TATACAACCG	AATGATACGGCGACCACCGAGATCTACACTATACAACCGGCTGGTGCTGCAGCTTATTA
s2_F_1174_CGGTTGGTGT	AATGATACGGCGACCACCGAGATCTACACCGGTTGGTGTGCTGGTGCTGCAGCTTATTA
s2_F_1175_CACGGACACA	AATGATACGGCGACCACCGAGATCTACACCACGGACACAGCTGGTGCTGCAGCTTATTA
s2_F_1176_ACACAAGGAG	AATGATACGGCGACCACCGAGATCTACACACACAAGGAGGCTGGTGCTGCAGCTTATTA
s2_F_1177_AGATTAGGAG	AATGATACGGCGACCACCGAGATCTACACAGATTAGGAGGCTGGTGCTGCAGCTTATTA
s2_F_1178_ATCAGAGGAG	AATGATACGGCGACCACCGAGATCTACACATCAGAGGAGGCTGGTGCTGCAGCTTATTA
s2_F_1179_CCGATAGGAG	AATGATACGGCGACCACCGAGATCTACACCCGATAGGAGGCTGGTGCTGCAGCTTATTA
s2_F_1180_CTAGAAGGAG	AATGATACGGCGACCACCGAGATCTACACCTAGAAGGAGGCTGGTGCTGCAGCTTATTA
s2_F_1181_ATAGATCTGC	AATGATACGGCGACCACCGAGATCTACACATAGATCTGCGCTGGTGCTGCAGCTTATTA
s2_F_1182_CCACGGATAC	AATGATACGGCGACCACCGAGATCTACACCCACGGATACGCTGGTGCTGCAGCTTATTA
s2_F_1183_TCGAGAACAG	AATGATACGGCGACCACCGAGATCTACACTCGAGAACAGGCTGGTGCTGCAGCTTATTA
s2_F_1184_CCAGACTACA	AATGATACGGCGACCACCGAGATCTACACCCAGACTACAGCTGGTGCTGCAGCTTATTA
s2_F_1185_CGAACCTACA	AATGATACGGCGACCACCGAGATCTACACCGAACCTACAGCTGGTGCTGCAGCTTATTA
s2_F_1186_CGACAGTACA	AATGATACGGCGACCACCGAGATCTACACCGACAGTACAGCTGGTGCTGCAGCTTATTA
s2_F_1187_GAGAGTTACA	AATGATACGGCGACCACCGAGATCTACACGAGAGTTACAGCTGGTGCTGCAGCTTATTA
s2_F_1188_ATGCGTGGAC	AATGATACGGCGACCACCGAGATCTACACATGCGTGGACGCTGGTGCTGCAGCTTATTA
s2_F_1189_AGATGCCTAG	AATGATACGGCGACCACCGAGATCTACACAGATGCCTAGGCTGGTGCTGCAGCTTATTA
s2_F_1190_GTGACACACT	AATGATACGGCGACCACCGAGATCTACACGTGACACACTGCTGGTGCTGCAGCTTATTA
s2_F_1191_CGCCTCTATA	AATGATACGGCGACCACCGAGATCTACACCGCCTCTATAGCTGGTGCTGCAGCTTATTA
s2_F_1192_TACTTCACAG	AATGATACGGCGACCACCGAGATCTACACTACTTCACAGGCTGGTGCTGCAGCTTATTA
s2_F_1193_TTCCACACAG	AATGATACGGCGACCACCGAGATCTACACTTCCACACAGGCTGGTGCTGCAGCTTATTA
s2_F_1194_GGACGGCTAT	AATGATACGGCGACCACCGAGATCTACACGGACGGCTATGCTGGTGCTGCAGCTTATTA
s2_F_1195_GGAATTGTCC	AATGATACGGCGACCACCGAGATCTACACGGAATTGTCCGCTGGTGCTGCAGCTTATTA
s2_F_1196_CAGAGCTTCG	AATGATACGGCGACCACCGAGATCTACACCAGAGCTTCGGCTGGTGCTGCAGCTTATTA
s2_F_1197_TCAAGCTTAG	AATGATACGGCGACCACCGAGATCTACACTCAAGCTTAGGCTGGTGCTGCAGCTTATTA
s2_F_1198_ATAGCAGTCA	AATGATACGGCGACCACCGAGATCTACACATAGCAGTCAGCTGGTGCTGCAGCTTATTA
s2_F_1199_AATCGGTTAC	AATGATACGGCGACCACCGAGATCTACACAATCGGTTACGCTGGTGCTGCAGCTTATTA
s2_F_1200_AGAACCTCAC	AATGATACGGCGACCACCGAGATCTACACAGAACCTCACGCTGGTGCTGCAGCTTATTA
s2_F_1201_CACCAAGATC	AATGATACGGCGACCACCGAGATCTACACCACCAAGATCGCTGGTGCTGCAGCTTATTA
s2_F_1202_CGAGCAGTTC	AATGATACGGCGACCACCGAGATCTACACCGAGCAGTTCGCTGGTGCTGCAGCTTATTA
s2_F_1203_CATAGACTCG	AATGATACGGCGACCACCGAGATCTACACCATAGACTCGGCTGGTGCTGCAGCTTATTA
s2_F_1204_CGTCAGAGAC	AATGATACGGCGACCACCGAGATCTACACCGTCAGAGACGCTGGTGCTGCAGCTTATTA
s2_F_1205_AGTGAAGCTG	AATGATACGGCGACCACCGAGATCTACACAGTGAAGCTGGCTGGTGCTGCAGCTTATTA
s2_F_1206_GCAACTGCCA	AATGATACGGCGACCACCGAGATCTACACGCAACTGCCAGCTGGTGCTGCAGCTTATTA
s2_F_1207_GGACGTCATG	AATGATACGGCGACCACCGAGATCTACACGGACGTCATGGCTGGTGCTGCAGCTTATTA
s2_F_1208_AACGAGAACC	AATGATACGGCGACCACCGAGATCTACACAACGAGAACCGCTGGTGCTGCAGCTTATTA
s2_F_1209_CTGATTGTGG	AATGATACGGCGACCACCGAGATCTACACCTGATTGTGGGCTGGTGCTGCAGCTTATTA
s2_F_1210_TTGAAGCTGA	AATGATACGGCGACCACCGAGATCTACACTTGAAGCTGAGCTGGTGCTGCAGCTTATTA
s2_F_1211_TGCACTCGAA	AATGATACGGCGACCACCGAGATCTACACTGCACTCGAAGCTGGTGCTGCAGCTTATTA
s2_F_1212_CAGAGGCTCA	AATGATACGGCGACCACCGAGATCTACACCAGAGGCTCAGCTGGTGCTGCAGCTTATTA
s2_F_1213_ACTACGGATC	AATGATACGGCGACCACCGAGATCTACACACTACGGATCGCTGGTGCTGCAGCTTATTA
s2_F_1214_GATAACGCCA	AATGATACGGCGACCACCGAGATCTACACGATAACGCCAGCTGGTGCTGCAGCTTATTA
s2_F_1215_GACTGAAGTC	AATGATACGGCGACCACCGAGATCTACACGACTGAAGTCGCTGGTGCTGCAGCTTATTA
s2_F_1216_AGGAGTCTCG	AATGATACGGCGACCACCGAGATCTACACAGGAGTCTCGGCTGGTGCTGCAGCTTATTA
s2_F_1217_CACAGTACTG	AATGATACGGCGACCACCGAGATCTACACCACAGTACTGGCTGGTGCTGCAGCTTATTA
s2_F_1218_ACCTGTAGTC	AATGATACGGCGACCACCGAGATCTACACACCTGTAGTCGCTGGTGCTGCAGCTTATTA
s2_F_1219_ACTCGTCGAA	AATGATACGGCGACCACCGAGATCTACACACTCGTCGAAGCTGGTGCTGCAGCTTATTA
s2_F_1220_CGATTCCTCG	AATGATACGGCGACCACCGAGATCTACACCGATTCCTCGGCTGGTGCTGCAGCTTATTA
s2_F_1221_ACACCACCAT	AATGATACGGCGACCACCGAGATCTACACACACCACCATGCTGGTGCTGCAGCTTATTA
s2_F_1222_CGAGACAGAT	AATGATACGGCGACCACCGAGATCTACACCGAGACAGATGCTGGTGCTGCAGCTTATTA
s2_F_1223_ATTGACACAG	AATGATACGGCGACCACCGAGATCTACACATTGACACAGGCTGGTGCTGCAGCTTATTA
s2_F_1224_AGGATGATCC	AATGATACGGCGACCACCGAGATCTACACAGGATGATCCGCTGGTGCTGCAGCTTATTA
s2_F_1225_CGTCAACGGA	AATGATACGGCGACCACCGAGATCTACACCGTCAACGGAGCTGGTGCTGCAGCTTATTA
s2_F_1226_CACACACCGT	AATGATACGGCGACCACCGAGATCTACACCACACACCGTGCTGGTGCTGCAGCTTATTA
s2_F_1227_TACACTGCAA	AATGATACGGCGACCACCGAGATCTACACTACACTGCAAGCTGGTGCTGCAGCTTATTA
s2_F_1228_AACAGACGAC	AATGATACGGCGACCACCGAGATCTACACAACAGACGACGCTGGTGCTGCAGCTTATTA
s2_F_1229_GCTATCCTAG	AATGATACGGCGACCACCGAGATCTACACGCTATCCTAGGCTGGTGCTGCAGCTTATTA
s2_F_1230_ATATCCAGTC	AATGATACGGCGACCACCGAGATCTACACATATCCAGTCGCTGGTGCTGCAGCTTATTA
s2_F_1231_CATTGTGACA	AATGATACGGCGACCACCGAGATCTACACCATTGTGACAGCTGGTGCTGCAGCTTATTA
s2_F_1232_GGATCTAACC	AATGATACGGCGACCACCGAGATCTACACGGATCTAACCGCTGGTGCTGCAGCTTATTA
s2_F_1233_AGGATCACGG	AATGATACGGCGACCACCGAGATCTACACAGGATCACGGGCTGGTGCTGCAGCTTATTA
s2_F_1234_GTAATAGAGC	AATGATACGGCGACCACCGAGATCTACACGTAATAGAGCGCTGGTGCTGCAGCTTATTA
s2_F_1235_ATAGGACCAC	AATGATACGGCGACCACCGAGATCTACACATAGGACCACGCTGGTGCTGCAGCTTATTA
s2_F_1236_GCCTATATAG	AATGATACGGCGACCACCGAGATCTACACGCCTATATAGGCTGGTGCTGCAGCTTATTA
s2_F_1237_AACGCGGACA	AATGATACGGCGACCACCGAGATCTACACAACGCGGACAGCTGGTGCTGCAGCTTATTA
s2_F_1238_ACGGAATAAC	AATGATACGGCGACCACCGAGATCTACACACGGAATAACGCTGGTGCTGCAGCTTATTA
s2_F_1239_AGAGAACGGC	AATGATACGGCGACCACCGAGATCTACACAGAGAACGGCGCTGGTGCTGCAGCTTATTA
s2_F_1240_CAACGAGTCA	AATGATACGGCGACCACCGAGATCTACACCAACGAGTCAGCTGGTGCTGCAGCTTATTA
s2_F_1241_ACGGCTTATC	AATGATACGGCGACCACCGAGATCTACACACGGCTTATCGCTGGTGCTGCAGCTTATTA
s2_F_1242_AGCCAAGTTA	AATGATACGGCGACCACCGAGATCTACACAGCCAAGTTAGCTGGTGCTGCAGCTTATTA
s2_F_1243_AGCTCCTTCG	AATGATACGGCGACCACCGAGATCTACACAGCTCCTTCGGCTGGTGCTGCAGCTTATTA
s2_F_1244_CCATGAACAG	AATGATACGGCGACCACCGAGATCTACACCCATGAACAGGCTGGTGCTGCAGCTTATTA
s2_F_1245_GATGGTGCTA	AATGATACGGCGACCACCGAGATCTACACGATGGTGCTAGCTGGTGCTGCAGCTTATTA
s2_F_1246_GAATTGCGGC	AATGATACGGCGACCACCGAGATCTACACGAATTGCGGCGCTGGTGCTGCAGCTTATTA
s2_F_1247_AAGAAGCCAC	AATGATACGGCGACCACCGAGATCTACACAAGAAGCCACGCTGGTGCTGCAGCTTATTA
s2_F_1248_GAGAGACTTC	AATGATACGGCGACCACCGAGATCTACACGAGAGACTTCGCTGGTGCTGCAGCTTATTA
s2_F_1249_AGTAAGAACC	AATGATACGGCGACCACCGAGATCTACACAGTAAGAACCGCTGGTGCTGCAGCTTATTA
s2_F_1250_AGTCGAAGTT	AATGATACGGCGACCACCGAGATCTACACAGTCGAAGTTGCTGGTGCTGCAGCTTATTA
s2_F_1251_AGGTGTAGCT	AATGATACGGCGACCACCGAGATCTACACAGGTGTAGCTGCTGGTGCTGCAGCTTATTA
s2_F_1252_AGCTTAAGGC	AATGATACGGCGACCACCGAGATCTACACAGCTTAAGGCGCTGGTGCTGCAGCTTATTA
s2_F_1253_GAAGGTACAG	AATGATACGGCGACCACCGAGATCTACACGAAGGTACAGGCTGGTGCTGCAGCTTATTA
s2_F_1254_CTAGAGGTCG	AATGATACGGCGACCACCGAGATCTACACCTAGAGGTCGGCTGGTGCTGCAGCTTATTA
s2_F_1255_AGCACGTATA	AATGATACGGCGACCACCGAGATCTACACAGCACGTATAGCTGGTGCTGCAGCTTATTA
s2_F_1256_AAGGCTCGGA	AATGATACGGCGACCACCGAGATCTACACAAGGCTCGGAGCTGGTGCTGCAGCTTATTA
s2_F_1257_ACAACGCCAG	AATGATACGGCGACCACCGAGATCTACACACAACGCCAGGCTGGTGCTGCAGCTTATTA
s2_F_1258_AAGCGCCTGA	AATGATACGGCGACCACCGAGATCTACACAAGCGCCTGAGCTGGTGCTGCAGCTTATTA
s2_F_1259_ACGCCAACAG	AATGATACGGCGACCACCGAGATCTACACACGCCAACAGGCTGGTGCTGCAGCTTATTA
s2_F_1260_ACGCCACGTA	AATGATACGGCGACCACCGAGATCTACACACGCCACGTAGCTGGTGCTGCAGCTTATTA
s2_F_1261_CAAGGACGAC	AATGATACGGCGACCACCGAGATCTACACCAAGGACGACGCTGGTGCTGCAGCTTATTA
s2_F_1262_ATGCTCACAG	AATGATACGGCGACCACCGAGATCTACACATGCTCACAGGCTGGTGCTGCAGCTTATTA
s2_F_1263_AATTGACTGC	AATGATACGGCGACCACCGAGATCTACACAATTGACTGCGCTGGTGCTGCAGCTTATTA
s2_F_1264_AGTGAACACC	AATGATACGGCGACCACCGAGATCTACACAGTGAACACCGCTGGTGCTGCAGCTTATTA
s2_F_1265_AGTGAGGAAC	AATGATACGGCGACCACCGAGATCTACACAGTGAGGAACGCTGGTGCTGCAGCTTATTA
s2_F_1266_ACTGCTTACA	AATGATACGGCGACCACCGAGATCTACACACTGCTTACAGCTGGTGCTGCAGCTTATTA
s2_F_1267_ATGCACATGG	AATGATACGGCGACCACCGAGATCTACACATGCACATGGGCTGGTGCTGCAGCTTATTA
s2_F_1268_GAACACTCGG	AATGATACGGCGACCACCGAGATCTACACGAACACTCGGGCTGGTGCTGCAGCTTATTA
s2_F_1269_TACTACTCGG	AATGATACGGCGACCACCGAGATCTACACTACTACTCGGGCTGGTGCTGCAGCTTATTA
s2_F_1270_ACGGATATGC	AATGATACGGCGACCACCGAGATCTACACACGGATATGCGCTGGTGCTGCAGCTTATTA
s2_F_1271_GGACAGGTTG	AATGATACGGCGACCACCGAGATCTACACGGACAGGTTGGCTGGTGCTGCAGCTTATTA
s2_F_1272_CAGAAGCAGA	AATGATACGGCGACCACCGAGATCTACACCAGAAGCAGAGCTGGTGCTGCAGCTTATTA
s2_F_1273_AACCGAGGTT	AATGATACGGCGACCACCGAGATCTACACAACCGAGGTTGCTGGTGCTGCAGCTTATTA
s2_F_1274_CCATGGTACC	AATGATACGGCGACCACCGAGATCTACACCCATGGTACCGCTGGTGCTGCAGCTTATTA
s2_F_1275_ATAACGGCGG	AATGATACGGCGACCACCGAGATCTACACATAACGGCGGGCTGGTGCTGCAGCTTATTA
s2_F_1276_CATTAGCCAG	AATGATACGGCGACCACCGAGATCTACACCATTAGCCAGGCTGGTGCTGCAGCTTATTA
s2_F_1277_CTCTAATGGC	AATGATACGGCGACCACCGAGATCTACACCTCTAATGGCGCTGGTGCTGCAGCTTATTA
s2_F_1278_ACGATGAGCT	AATGATACGGCGACCACCGAGATCTACACACGATGAGCTGCTGGTGCTGCAGCTTATTA
s2_F_1279_AAGACCGAGC	AATGATACGGCGACCACCGAGATCTACACAAGACCGAGCGCTGGTGCTGCAGCTTATTA
s2_F_1280_TGCACTGTAT	AATGATACGGCGACCACCGAGATCTACACTGCACTGTATGCTGGTGCTGCAGCTTATTA
s2_F_1281_AGCACATCAA	AATGATACGGCGACCACCGAGATCTACACAGCACATCAAGCTGGTGCTGCAGCTTATTA
s2_F_1282_ACTAGGCTCG	AATGATACGGCGACCACCGAGATCTACACACTAGGCTCGGCTGGTGCTGCAGCTTATTA
s2_F_1283_GCGCAGTGAT	AATGATACGGCGACCACCGAGATCTACACGCGCAGTGATGCTGGTGCTGCAGCTTATTA
s2_F_1284_CGGATATACG	AATGATACGGCGACCACCGAGATCTACACCGGATATACGGCTGGTGCTGCAGCTTATTA
s2_F_1285_GACAAGGTTC	AATGATACGGCGACCACCGAGATCTACACGACAAGGTTCGCTGGTGCTGCAGCTTATTA
s2_F_1286_GATCACATGA	AATGATACGGCGACCACCGAGATCTACACGATCACATGAGCTGGTGCTGCAGCTTATTA
s2_F_1287_GTCAAGCTCG	AATGATACGGCGACCACCGAGATCTACACGTCAAGCTCGGCTGGTGCTGCAGCTTATTA
s2_F_1288_CCTTCGAAGA	AATGATACGGCGACCACCGAGATCTACACCCTTCGAAGAGCTGGTGCTGCAGCTTATTA
s2_F_1289_CAAGCGTACC	AATGATACGGCGACCACCGAGATCTACACCAAGCGTACCGCTGGTGCTGCAGCTTATTA
s2_F_1290_CCTTCAGGCT	AATGATACGGCGACCACCGAGATCTACACCCTTCAGGCTGCTGGTGCTGCAGCTTATTA
s2_F_1291_ACGCCTGGTT	AATGATACGGCGACCACCGAGATCTACACACGCCTGGTTGCTGGTGCTGCAGCTTATTA
s2_F_1292_ATATCGGTCG	AATGATACGGCGACCACCGAGATCTACACATATCGGTCGGCTGGTGCTGCAGCTTATTA
s2_F_1293_CATCACGCTA	AATGATACGGCGACCACCGAGATCTACACCATCACGCTAGCTGGTGCTGCAGCTTATTA
s2_F_1294_GAAGTCTTCG	AATGATACGGCGACCACCGAGATCTACACGAAGTCTTCGGCTGGTGCTGCAGCTTATTA
s2_F_1295_AGAGTGGCTG	AATGATACGGCGACCACCGAGATCTACACAGAGTGGCTGGCTGGTGCTGCAGCTTATTA
s2_F_1296_CAGGAGCATC	AATGATACGGCGACCACCGAGATCTACACCAGGAGCATCGCTGGTGCTGCAGCTTATTA
s2_F_1297_GCCAGACGTT	AATGATACGGCGACCACCGAGATCTACACGCCAGACGTTGCTGGTGCTGCAGCTTATTA
s2_F_1298_CATGGCAACC	AATGATACGGCGACCACCGAGATCTACACCATGGCAACCGCTGGTGCTGCAGCTTATTA
s2_F_1299_ACCAGGTTCC	AATGATACGGCGACCACCGAGATCTACACACCAGGTTCCGCTGGTGCTGCAGCTTATTA
s2_F_1300_AGCCTGAGAC	AATGATACGGCGACCACCGAGATCTACACAGCCTGAGACGCTGGTGCTGCAGCTTATTA
s2_F_1301_ACAGCCAGAG	AATGATACGGCGACCACCGAGATCTACACACAGCCAGAGGCTGGTGCTGCAGCTTATTA
s2_F_1302_AGCATGTACC	AATGATACGGCGACCACCGAGATCTACACAGCATGTACCGCTGGTGCTGCAGCTTATTA
s2_F_1303_CTAGACAAGC	AATGATACGGCGACCACCGAGATCTACACCTAGACAAGCGCTGGTGCTGCAGCTTATTA
s2_F_1304_AGAGATGACA	AATGATACGGCGACCACCGAGATCTACACAGAGATGACAGCTGGTGCTGCAGCTTATTA
s2_F_1305_ATGGTTAGTC	AATGATACGGCGACCACCGAGATCTACACATGGTTAGTCGCTGGTGCTGCAGCTTATTA
s2_F_1306_AGTACTGAAC	AATGATACGGCGACCACCGAGATCTACACAGTACTGAACGCTGGTGCTGCAGCTTATTA
s2_F_1307_CTCAGAGTCA	AATGATACGGCGACCACCGAGATCTACACCTCAGAGTCAGCTGGTGCTGCAGCTTATTA
s2_F_1308_AACAAGACTG	AATGATACGGCGACCACCGAGATCTACACAACAAGACTGGCTGGTGCTGCAGCTTATTA
s2_F_1309_GTTATGCTCC	AATGATACGGCGACCACCGAGATCTACACGTTATGCTCCGCTGGTGCTGCAGCTTATTA
s2_F_1310_TACGTGCTCG	AATGATACGGCGACCACCGAGATCTACACTACGTGCTCGGCTGGTGCTGCAGCTTATTA
s2_F_1311_TCGATAGACT	AATGATACGGCGACCACCGAGATCTACACTCGATAGACTGCTGGTGCTGCAGCTTATTA
s2_F_1312_CATAATCAGC	AATGATACGGCGACCACCGAGATCTACACCATAATCAGCGCTGGTGCTGCAGCTTATTA
s2_F_1313_ATCTATGGAG	AATGATACGGCGACCACCGAGATCTACACATCTATGGAGGCTGGTGCTGCAGCTTATTA
s2_F_1314_GATAATGGAG	AATGATACGGCGACCACCGAGATCTACACGATAATGGAGGCTGGTGCTGCAGCTTATTA
s2_F_1315_CATGACGAGC	AATGATACGGCGACCACCGAGATCTACACCATGACGAGCGCTGGTGCTGCAGCTTATTA
s2_F_1316_CCGTAGCAAC	AATGATACGGCGACCACCGAGATCTACACCCGTAGCAACGCTGGTGCTGCAGCTTATTA
s2_F_1317_CAAGAATGGC	AATGATACGGCGACCACCGAGATCTACACCAAGAATGGCGCTGGTGCTGCAGCTTATTA
s2_F_1318_ATGATGGACC	AATGATACGGCGACCACCGAGATCTACACATGATGGACCGCTGGTGCTGCAGCTTATTA
s2_F_1319_ACTCGTACTT	AATGATACGGCGACCACCGAGATCTACACACTCGTACTTGCTGGTGCTGCAGCTTATTA
s2_F_1320_CGAACAGCGT	AATGATACGGCGACCACCGAGATCTACACCGAACAGCGTGCTGGTGCTGCAGCTTATTA
s2_F_1321_ACATCTGACC	AATGATACGGCGACCACCGAGATCTACACACATCTGACCGCTGGTGCTGCAGCTTATTA
s2_F_1322_AGTTACGACC	AATGATACGGCGACCACCGAGATCTACACAGTTACGACCGCTGGTGCTGCAGCTTATTA
s2_F_1323_AGGATCAGTC	AATGATACGGCGACCACCGAGATCTACACAGGATCAGTCGCTGGTGCTGCAGCTTATTA
s2_F_1324_GCCTGTACAC	AATGATACGGCGACCACCGAGATCTACACGCCTGTACACGCTGGTGCTGCAGCTTATTA
s2_F_1325_CATCCTCGTG	AATGATACGGCGACCACCGAGATCTACACCATCCTCGTGGCTGGTGCTGCAGCTTATTA
s2_F_1326_AACCAGCCTA	AATGATACGGCGACCACCGAGATCTACACAACCAGCCTAGCTGGTGCTGCAGCTTATTA
s2_F_1327_AAGCATTAGC	AATGATACGGCGACCACCGAGATCTACACAAGCATTAGCGCTGGTGCTGCAGCTTATTA
s2_F_1328_CAGACCAGTC	AATGATACGGCGACCACCGAGATCTACACCAGACCAGTCGCTGGTGCTGCAGCTTATTA
s2_F_1329_AGGACGCAAT	AATGATACGGCGACCACCGAGATCTACACAGGACGCAATGCTGGTGCTGCAGCTTATTA
s2_F_1330_CCGGAGAACA	AATGATACGGCGACCACCGAGATCTACACCCGGAGAACAGCTGGTGCTGCAGCTTATTA
s2_F_1331_AGCGGTTACA	AATGATACGGCGACCACCGAGATCTACACAGCGGTTACAGCTGGTGCTGCAGCTTATTA
s2_F_1332_AGCTTCTACA	AATGATACGGCGACCACCGAGATCTACACAGCTTCTACAGCTGGTGCTGCAGCTTATTA
s2_F_1333_AAGGCGACTG	AATGATACGGCGACCACCGAGATCTACACAAGGCGACTGGCTGGTGCTGCAGCTTATTA
s2_F_1334_ACGTCTACGT	AATGATACGGCGACCACCGAGATCTACACACGTCTACGTGCTGGTGCTGCAGCTTATTA
s2_F_1335_GCCTACTTGT	AATGATACGGCGACCACCGAGATCTACACGCCTACTTGTGCTGGTGCTGCAGCTTATTA
s2_F_1336_CAGGAAGACC	AATGATACGGCGACCACCGAGATCTACACCAGGAAGACCGCTGGTGCTGCAGCTTATTA
s2_F_1337_CTATACGACC	AATGATACGGCGACCACCGAGATCTACACCTATACGACCGCTGGTGCTGCAGCTTATTA
s2_F_1338_AACTCTACAG	AATGATACGGCGACCACCGAGATCTACACAACTCTACAGGCTGGTGCTGCAGCTTATTA
s2_F_1339_AGGCATACAG	AATGATACGGCGACCACCGAGATCTACACAGGCATACAGGCTGGTGCTGCAGCTTATTA
s2_F_1340_CCTAGTACAG	AATGATACGGCGACCACCGAGATCTACACCCTAGTACAGGCTGGTGCTGCAGCTTATTA
s2_F_1341_ACAGTGCCAC	AATGATACGGCGACCACCGAGATCTACACACAGTGCCACGCTGGTGCTGCAGCTTATTA
s2_F_1342_ATAGCGGCAA	AATGATACGGCGACCACCGAGATCTACACATAGCGGCAAGCTGGTGCTGCAGCTTATTA
s2_F_1343_ACAACCTACC	AATGATACGGCGACCACCGAGATCTACACACAACCTACCGCTGGTGCTGCAGCTTATTA
s2_F_1344_ACGAATTACC	AATGATACGGCGACCACCGAGATCTACACACGAATTACCGCTGGTGCTGCAGCTTATTA
s2_F_1345_ACTCGATACC	AATGATACGGCGACCACCGAGATCTACACACTCGATACCGCTGGTGCTGCAGCTTATTA
s2_F_1346_AGTCCGTACC	AATGATACGGCGACCACCGAGATCTACACAGTCCGTACCGCTGGTGCTGCAGCTTATTA
s2_F_1347_AGTGCATATC	AATGATACGGCGACCACCGAGATCTACACAGTGCATATCGCTGGTGCTGCAGCTTATTA
s2_F_1348_AATCTCACTC	AATGATACGGCGACCACCGAGATCTACACAATCTCACTCGCTGGTGCTGCAGCTTATTA
s2_F_1349_CATGAAGTAC	AATGATACGGCGACCACCGAGATCTACACCATGAAGTACGCTGGTGCTGCAGCTTATTA
s2_F_1350_AATCAGCTTC	AATGATACGGCGACCACCGAGATCTACACAATCAGCTTCGCTGGTGCTGCAGCTTATTA
s2_F_1351_CGCCATTAGC	AATGATACGGCGACCACCGAGATCTACACCGCCATTAGCGCTGGTGCTGCAGCTTATTA
s2_F_1352_AGCAAGCTAT	AATGATACGGCGACCACCGAGATCTACACAGCAAGCTATGCTGGTGCTGCAGCTTATTA
s2_F_1353_AACCACCGTG	AATGATACGGCGACCACCGAGATCTACACAACCACCGTGGCTGGTGCTGCAGCTTATTA
s2_F_1354_CAGGAGAGAA	AATGATACGGCGACCACCGAGATCTACACCAGGAGAGAAGCTGGTGCTGCAGCTTATTA
s2_F_1355_CTAAGCCATC	AATGATACGGCGACCACCGAGATCTACACCTAAGCCATCGCTGGTGCTGCAGCTTATTA
s2_F_1356_AACAAGCTCC	AATGATACGGCGACCACCGAGATCTACACAACAAGCTCCGCTGGTGCTGCAGCTTATTA
s2_F_1357_AAGCCGGAAC	AATGATACGGCGACCACCGAGATCTACACAAGCCGGAACGCTGGTGCTGCAGCTTATTA
s2_F_1358_GATGTCGTTG	AATGATACGGCGACCACCGAGATCTACACGATGTCGTTGGCTGGTGCTGCAGCTTATTA
s2_F_1359_CGTGCTACAG	AATGATACGGCGACCACCGAGATCTACACCGTGCTACAGGCTGGTGCTGCAGCTTATTA
s2_F_1360_CAGTCACTCG	AATGATACGGCGACCACCGAGATCTACACCAGTCACTCGGCTGGTGCTGCAGCTTATTA
s2_F_1361_TACCGACTCG	AATGATACGGCGACCACCGAGATCTACACTACCGACTCGGCTGGTGCTGCAGCTTATTA
s2_F_1362_AGCTTAACCG	AATGATACGGCGACCACCGAGATCTACACAGCTTAACCGGCTGGTGCTGCAGCTTATTA
s2_F_1363_AGGTCAGAAC	AATGATACGGCGACCACCGAGATCTACACAGGTCAGAACGCTGGTGCTGCAGCTTATTA
s2_F_1364_AGAATGCTGC	AATGATACGGCGACCACCGAGATCTACACAGAATGCTGCGCTGGTGCTGCAGCTTATTA
s2_F_1365_ACCGGACATC	AATGATACGGCGACCACCGAGATCTACACACCGGACATCGCTGGTGCTGCAGCTTATTA
s2_F_1366_ACGCGGTAAC	AATGATACGGCGACCACCGAGATCTACACACGCGGTAACGCTGGTGCTGCAGCTTATTA
s2_F_1367_ACCGTTAATC	AATGATACGGCGACCACCGAGATCTACACACCGTTAATCGCTGGTGCTGCAGCTTATTA
s2_F_1368_CCACTGAAGC	AATGATACGGCGACCACCGAGATCTACACCCACTGAAGCGCTGGTGCTGCAGCTTATTA
s2_F_1369_GCTAGTGGTT	AATGATACGGCGACCACCGAGATCTACACGCTAGTGGTTGCTGGTGCTGCAGCTTATTA
s2_F_1370_AGACAATACC	AATGATACGGCGACCACCGAGATCTACACAGACAATACCGCTGGTGCTGCAGCTTATTA
s2_F_1371_ATCGACGGAC	AATGATACGGCGACCACCGAGATCTACACATCGACGGACGCTGGTGCTGCAGCTTATTA
s2_F_1372_ACGGTCTGAC	AATGATACGGCGACCACCGAGATCTACACACGGTCTGACGCTGGTGCTGCAGCTTATTA
s2_F_1373_TGCGCTGCTA	AATGATACGGCGACCACCGAGATCTACACTGCGCTGCTAGCTGGTGCTGCAGCTTATTA
s2_F_1374_GTGAGGTCGA	AATGATACGGCGACCACCGAGATCTACACGTGAGGTCGAGCTGGTGCTGCAGCTTATTA
s2_F_1375_AAGAGGCTGC	AATGATACGGCGACCACCGAGATCTACACAAGAGGCTGCGCTGGTGCTGCAGCTTATTA
s2_F_1376_AGCAAGATGC	AATGATACGGCGACCACCGAGATCTACACAGCAAGATGCGCTGGTGCTGCAGCTTATTA
s2_F_1377_ACACGAGTAC	AATGATACGGCGACCACCGAGATCTACACACACGAGTACGCTGGTGCTGCAGCTTATTA
s2_F_1378_CACAACGACC	AATGATACGGCGACCACCGAGATCTACACCACAACGACCGCTGGTGCTGCAGCTTATTA
s2_F_1379_CATCAATACC	AATGATACGGCGACCACCGAGATCTACACCATCAATACCGCTGGTGCTGCAGCTTATTA
s2_F_1380_CGAGAATTCC	AATGATACGGCGACCACCGAGATCTACACCGAGAATTCCGCTGGTGCTGCAGCTTATTA
s2_F_1381_CGAGGTTACC	AATGATACGGCGACCACCGAGATCTACACCGAGGTTACCGCTGGTGCTGCAGCTTATTA
s2_F_1382_CTTAGGTACC	AATGATACGGCGACCACCGAGATCTACACCTTAGGTACCGCTGGTGCTGCAGCTTATTA
s2_F_1383_GATATAGACC	AATGATACGGCGACCACCGAGATCTACACGATATAGACCGCTGGTGCTGCAGCTTATTA
s2_F_1384_GCAGAACTCC	AATGATACGGCGACCACCGAGATCTACACGCAGAACTCCGCTGGTGCTGCAGCTTATTA
s2_F_1385_ACTCGCCTAG	AATGATACGGCGACCACCGAGATCTACACACTCGCCTAGGCTGGTGCTGCAGCTTATTA
s2_F_1386_AATTCGCCTG	AATGATACGGCGACCACCGAGATCTACACAATTCGCCTGGCTGGTGCTGCAGCTTATTA
s2_F_1387_CATTAGAACC	AATGATACGGCGACCACCGAGATCTACACCATTAGAACCGCTGGTGCTGCAGCTTATTA
s2_F_1388_AAGATACACC	AATGATACGGCGACCACCGAGATCTACACAAGATACACCGCTGGTGCTGCAGCTTATTA
s2_F_1389_ACCTTACACC	AATGATACGGCGACCACCGAGATCTACACACCTTACACCGCTGGTGCTGCAGCTTATTA
s2_F_1390_ACGCTGCTTC	AATGATACGGCGACCACCGAGATCTACACACGCTGCTTCGCTGGTGCTGCAGCTTATTA
s2_F_1391_AACGAATCAC	AATGATACGGCGACCACCGAGATCTACACAACGAATCACGCTGGTGCTGCAGCTTATTA
s2_F_1392_TAGATCGCAA	AATGATACGGCGACCACCGAGATCTACACTAGATCGCAAGCTGGTGCTGCAGCTTATTA
s2_F_1393_AACATCCTAG	AATGATACGGCGACCACCGAGATCTACACAACATCCTAGGCTGGTGCTGCAGCTTATTA
s2_F_1394_CACATGCTGC	AATGATACGGCGACCACCGAGATCTACACCACATGCTGCGCTGGTGCTGCAGCTTATTA
s2_F_1395_AGGCACTCTG	AATGATACGGCGACCACCGAGATCTACACAGGCACTCTGGCTGGTGCTGCAGCTTATTA
s2_F_1396_AACTCCTCAC	AATGATACGGCGACCACCGAGATCTACACAACTCCTCACGCTGGTGCTGCAGCTTATTA
s2_F_1397_AAGGTGAATC	AATGATACGGCGACCACCGAGATCTACACAAGGTGAATCGCTGGTGCTGCAGCTTATTA
s2_F_1398_AACCAGTCCG	AATGATACGGCGACCACCGAGATCTACACAACCAGTCCGGCTGGTGCTGCAGCTTATTA
s2_F_1399_GAGGACACAG	AATGATACGGCGACCACCGAGATCTACACGAGGACACAGGCTGGTGCTGCAGCTTATTA
s2_F_1400_AGAAGACTCC	AATGATACGGCGACCACCGAGATCTACACAGAAGACTCCGCTGGTGCTGCAGCTTATTA
s2_F_1401_ATCCGAGATC	AATGATACGGCGACCACCGAGATCTACACATCCGAGATCGCTGGTGCTGCAGCTTATTA
s2_F_1402_CTTAAGCCGG	AATGATACGGCGACCACCGAGATCTACACCTTAAGCCGGGCTGGTGCTGCAGCTTATTA
s2_F_1403_GAACAGTATC	AATGATACGGCGACCACCGAGATCTACACGAACAGTATCGCTGGTGCTGCAGCTTATTA
s2_F_1404_AAGAGCGGCT	AATGATACGGCGACCACCGAGATCTACACAAGAGCGGCTGCTGGTGCTGCAGCTTATTA
s2_F_1405_TAGTGAGACC	AATGATACGGCGACCACCGAGATCTACACTAGTGAGACCGCTGGTGCTGCAGCTTATTA
s2_F_1406_ATACCGAGCT	AATGATACGGCGACCACCGAGATCTACACATACCGAGCTGCTGGTGCTGCAGCTTATTA
s2_F_1407_AATACCGACA	AATGATACGGCGACCACCGAGATCTACACAATACCGACAGCTGGTGCTGCAGCTTATTA
s2_F_1408_CAACACGACA	AATGATACGGCGACCACCGAGATCTACACCAACACGACAGCTGGTGCTGCAGCTTATTA
s2_F_1409_CTAGTAAGAC	AATGATACGGCGACCACCGAGATCTACACCTAGTAAGACGCTGGTGCTGCAGCTTATTA
s2_F_1410_CCGGATTAGC	AATGATACGGCGACCACCGAGATCTACACCCGGATTAGCGCTGGTGCTGCAGCTTATTA
s2_F_1411_CTACGTTCTC	AATGATACGGCGACCACCGAGATCTACACCTACGTTCTCGCTGGTGCTGCAGCTTATTA
s2_F_1412_CCTTCTTACC	AATGATACGGCGACCACCGAGATCTACACCCTTCTTACCGCTGGTGCTGCAGCTTATTA
s2_F_1413_GGCACAATCC	AATGATACGGCGACCACCGAGATCTACACGGCACAATCCGCTGGTGCTGCAGCTTATTA
s2_F_1414_GTTAGCCACC	AATGATACGGCGACCACCGAGATCTACACGTTAGCCACCGCTGGTGCTGCAGCTTATTA
s2_F_1415_CACTGCATCC	AATGATACGGCGACCACCGAGATCTACACCACTGCATCCGCTGGTGCTGCAGCTTATTA
s2_F_1416_AGGACTTAGC	AATGATACGGCGACCACCGAGATCTACACAGGACTTAGCGCTGGTGCTGCAGCTTATTA
s2_F_1417_AGTTCTCAGC	AATGATACGGCGACCACCGAGATCTACACAGTTCTCAGCGCTGGTGCTGCAGCTTATTA
s2_F_1418_ACATTGAGAC	AATGATACGGCGACCACCGAGATCTACACACATTGAGACGCTGGTGCTGCAGCTTATTA
s2_F_1419_ATAACGAGAC	AATGATACGGCGACCACCGAGATCTACACATAACGAGACGCTGGTGCTGCAGCTTATTA
s2_F_1420_AACGTCCGAC	AATGATACGGCGACCACCGAGATCTACACAACGTCCGACGCTGGTGCTGCAGCTTATTA
s2_F_1421_AGAGAATCTC	AATGATACGGCGACCACCGAGATCTACACAGAGAATCTCGCTGGTGCTGCAGCTTATTA
s2_F_1422_ATGAGTCAGC	AATGATACGGCGACCACCGAGATCTACACATGAGTCAGCGCTGGTGCTGCAGCTTATTA
s2_F_1423_GAATGTCAGC	AATGATACGGCGACCACCGAGATCTACACGAATGTCAGCGCTGGTGCTGCAGCTTATTA
s2_F_1424_GAGTACAAGC	AATGATACGGCGACCACCGAGATCTACACGAGTACAAGCGCTGGTGCTGCAGCTTATTA
s2_F_1425_GAGTCTGAGC	AATGATACGGCGACCACCGAGATCTACACGAGTCTGAGCGCTGGTGCTGCAGCTTATTA
s2_F_1426_AGTATGGAGC	AATGATACGGCGACCACCGAGATCTACACAGTATGGAGCGCTGGTGCTGCAGCTTATTA
s2_F_1427_GAACGCCAAT	AATGATACGGCGACCACCGAGATCTACACGAACGCCAATGCTGGTGCTGCAGCTTATTA
s2_F_1428_TAACGCCACG	AATGATACGGCGACCACCGAGATCTACACTAACGCCACGGCTGGTGCTGCAGCTTATTA
s2_F_1429_TTGAGACGTC	AATGATACGGCGACCACCGAGATCTACACTTGAGACGTCGCTGGTGCTGCAGCTTATTA
s2_F_1430_ATCTCAAGTG	AATGATACGGCGACCACCGAGATCTACACATCTCAAGTGGCTGGTGCTGCAGCTTATTA
s2_F_1431_ACACTATCAC	AATGATACGGCGACCACCGAGATCTACACACACTATCACGCTGGTGCTGCAGCTTATTA
s2_F_1432_GTCATGAATC	AATGATACGGCGACCACCGAGATCTACACGTCATGAATCGCTGGTGCTGCAGCTTATTA
s2_F_1433_CGACCTAGAC	AATGATACGGCGACCACCGAGATCTACACCGACCTAGACGCTGGTGCTGCAGCTTATTA
s2_F_1434_CAGTCCTCAT	AATGATACGGCGACCACCGAGATCTACACCAGTCCTCATGCTGGTGCTGCAGCTTATTA
s2_F_1435_CCTTAACAGC	AATGATACGGCGACCACCGAGATCTACACCCTTAACAGCGCTGGTGCTGCAGCTTATTA
s2_F_1436_ACTACTAGAC	AATGATACGGCGACCACCGAGATCTACACACTACTAGACGCTGGTGCTGCAGCTTATTA
s2_F_1437_AGGAACTGAC	AATGATACGGCGACCACCGAGATCTACACAGGAACTGACGCTGGTGCTGCAGCTTATTA
s2_F_1438_AAGCACGATC	AATGATACGGCGACCACCGAGATCTACACAAGCACGATCGCTGGTGCTGCAGCTTATTA
s2_F_1439_TATGGCACGT	AATGATACGGCGACCACCGAGATCTACACTATGGCACGTGCTGGTGCTGCAGCTTATTA
s2_F_1440_ACATAGGACA	AATGATACGGCGACCACCGAGATCTACACACATAGGACAGCTGGTGCTGCAGCTTATTA
s2_F_1441_CGTTAGGACA	AATGATACGGCGACCACCGAGATCTACACCGTTAGGACAGCTGGTGCTGCAGCTTATTA
s2_F_1442_GATGAGGACA	AATGATACGGCGACCACCGAGATCTACACGATGAGGACAGCTGGTGCTGCAGCTTATTA
s2_F_1443_GCGATGGACA	AATGATACGGCGACCACCGAGATCTACACGCGATGGACAGCTGGTGCTGCAGCTTATTA
s2_F_1444_GAAGAGCAAC	AATGATACGGCGACCACCGAGATCTACACGAAGAGCAACGCTGGTGCTGCAGCTTATTA
s2_F_1445_ATCCACAGTC	AATGATACGGCGACCACCGAGATCTACACATCCACAGTCGCTGGTGCTGCAGCTTATTA
s2_F_1446_ACTGCGAGCT	AATGATACGGCGACCACCGAGATCTACACACTGCGAGCTGCTGGTGCTGCAGCTTATTA
s2_F_1447_ACTTGGTCGG	AATGATACGGCGACCACCGAGATCTACACACTTGGTCGGGCTGGTGCTGCAGCTTATTA
s2_F_1448_AAGGTCGTGC	AATGATACGGCGACCACCGAGATCTACACAAGGTCGTGCGCTGGTGCTGCAGCTTATTA
s2_F_1449_AAGCTAGGTC	AATGATACGGCGACCACCGAGATCTACACAAGCTAGGTCGCTGGTGCTGCAGCTTATTA
s2_F_1450_GTTACTGACA	AATGATACGGCGACCACCGAGATCTACACGTTACTGACAGCTGGTGCTGCAGCTTATTA
s2_F_1451_ACGCATTCTC	AATGATACGGCGACCACCGAGATCTACACACGCATTCTCGCTGGTGCTGCAGCTTATTA
s2_F_1452_GCTGCCATAG	AATGATACGGCGACCACCGAGATCTACACGCTGCCATAGGCTGGTGCTGCAGCTTATTA
s2_F_1453_GCTGTTATCC	AATGATACGGCGACCACCGAGATCTACACGCTGTTATCCGCTGGTGCTGCAGCTTATTA
s2_F_1454_CGCGCCAATT	AATGATACGGCGACCACCGAGATCTACACCGCGCCAATTGCTGGTGCTGCAGCTTATTA
s2_F_1455_ACCAGGTGAG	AATGATACGGCGACCACCGAGATCTACACACCAGGTGAGGCTGGTGCTGCAGCTTATTA
s2_F_1456_CAGGCACTAC	AATGATACGGCGACCACCGAGATCTACACCAGGCACTACGCTGGTGCTGCAGCTTATTA
s2_F_1457_GCGCTAATTG	AATGATACGGCGACCACCGAGATCTACACGCGCTAATTGGCTGGTGCTGCAGCTTATTA
s2_F_1458_AGTGCAAGGC	AATGATACGGCGACCACCGAGATCTACACAGTGCAAGGCGCTGGTGCTGCAGCTTATTA
s2_F_1459_TAAGCACGGC	AATGATACGGCGACCACCGAGATCTACACTAAGCACGGCGCTGGTGCTGCAGCTTATTA
s2_F_1460_ACTCCAGACA	AATGATACGGCGACCACCGAGATCTACACACTCCAGACAGCTGGTGCTGCAGCTTATTA
s2_F_1461_CAGTCAGACA	AATGATACGGCGACCACCGAGATCTACACCAGTCAGACAGCTGGTGCTGCAGCTTATTA
s2_F_1462_TAACCAGACA	AATGATACGGCGACCACCGAGATCTACACTAACCAGACAGCTGGTGCTGCAGCTTATTA
s2_F_1463_CACAGCAATC	AATGATACGGCGACCACCGAGATCTACACCACAGCAATCGCTGGTGCTGCAGCTTATTA
s2_F_1464_AAGTCAGCTA	AATGATACGGCGACCACCGAGATCTACACAAGTCAGCTAGCTGGTGCTGCAGCTTATTA
s2_F_1465_AACAACACAC	AATGATACGGCGACCACCGAGATCTACACAACAACACACGCTGGTGCTGCAGCTTATTA
s2_F_1466_ACCGTAACAC	AATGATACGGCGACCACCGAGATCTACACACCGTAACACGCTGGTGCTGCAGCTTATTA
s2_F_1467_ATAATCCACC	AATGATACGGCGACCACCGAGATCTACACATAATCCACCGCTGGTGCTGCAGCTTATTA
s2_F_1468_CCTAACCACC	AATGATACGGCGACCACCGAGATCTACACCCTAACCACCGCTGGTGCTGCAGCTTATTA
s2_F_1469_AACCGGTCTC	AATGATACGGCGACCACCGAGATCTACACAACCGGTCTCGCTGGTGCTGCAGCTTATTA
s2_F_1470_AAGAGAGAAC	AATGATACGGCGACCACCGAGATCTACACAAGAGAGAACGCTGGTGCTGCAGCTTATTA
s2_F_1471_AATCCAACAC	AATGATACGGCGACCACCGAGATCTACACAATCCAACACGCTGGTGCTGCAGCTTATTA
s2_F_1472_ACCAAGAGAC	AATGATACGGCGACCACCGAGATCTACACACCAAGAGACGCTGGTGCTGCAGCTTATTA
s2_F_1473_AGACATGGAC	AATGATACGGCGACCACCGAGATCTACACAGACATGGACGCTGGTGCTGCAGCTTATTA
s2_F_1474_AGTCAACCAC	AATGATACGGCGACCACCGAGATCTACACAGTCAACCACGCTGGTGCTGCAGCTTATTA
s2_F_1475_CAAGATTCAC	AATGATACGGCGACCACCGAGATCTACACCAAGATTCACGCTGGTGCTGCAGCTTATTA
s2_F_1476_CACAGCTTAC	AATGATACGGCGACCACCGAGATCTACACCACAGCTTACGCTGGTGCTGCAGCTTATTA
s2_F_1477_CACCTCTCAC	AATGATACGGCGACCACCGAGATCTACACCACCTCTCACGCTGGTGCTGCAGCTTATTA
s2_F_1478_CATAGAGGAC	AATGATACGGCGACCACCGAGATCTACACCATAGAGGACGCTGGTGCTGCAGCTTATTA
s2_F_1479_CCTCGAGAAC	AATGATACGGCGACCACCGAGATCTACACCCTCGAGAACGCTGGTGCTGCAGCTTATTA
s2_F_1480_CGTTATACAC	AATGATACGGCGACCACCGAGATCTACACCGTTATACACGCTGGTGCTGCAGCTTATTA
s2_F_1481_CTTGTACAAC	AATGATACGGCGACCACCGAGATCTACACCTTGTACAACGCTGGTGCTGCAGCTTATTA
s2_F_1482_GCAGCTTCAA	AATGATACGGCGACCACCGAGATCTACACGCAGCTTCAAGCTGGTGCTGCAGCTTATTA
s2_F_1483_ACTACTCACC	AATGATACGGCGACCACCGAGATCTACACACTACTCACCGCTGGTGCTGCAGCTTATTA
s2_F_1484_CGATATCACC	AATGATACGGCGACCACCGAGATCTACACCGATATCACCGCTGGTGCTGCAGCTTATTA
s2_F_1485_ACGAGCTACA	AATGATACGGCGACCACCGAGATCTACACACGAGCTACAGCTGGTGCTGCAGCTTATTA
s2_F_1486_TCGTTACGTC	AATGATACGGCGACCACCGAGATCTACACTCGTTACGTCGCTGGTGCTGCAGCTTATTA
s2_F_1487_ACACAACGGT	AATGATACGGCGACCACCGAGATCTACACACACAACGGTGCTGGTGCTGCAGCTTATTA
s2_F_1488_ACCTTCCGGT	AATGATACGGCGACCACCGAGATCTACACACCTTCCGGTGCTGGTGCTGCAGCTTATTA
s2_F_1489_GCCTAACGGT	AATGATACGGCGACCACCGAGATCTACACGCCTAACGGTGCTGGTGCTGCAGCTTATTA
s2_F_1490_AGCTTACCAC	AATGATACGGCGACCACCGAGATCTACACAGCTTACCACGCTGGTGCTGCAGCTTATTA
s2_F_1491_GCTGAGTTAC	AATGATACGGCGACCACCGAGATCTACACGCTGAGTTACGCTGGTGCTGCAGCTTATTA
s2_F_1492_GCCATCGTAT	AATGATACGGCGACCACCGAGATCTACACGCCATCGTATGCTGGTGCTGCAGCTTATTA
s2_F_1493_ATTGCATGCT	AATGATACGGCGACCACCGAGATCTACACATTGCATGCTGCTGGTGCTGCAGCTTATTA
s2_F_1494_AAGTGGCGAC	AATGATACGGCGACCACCGAGATCTACACAAGTGGCGACGCTGGTGCTGCAGCTTATTA
s2_F_1495_GGACTAGTAT	AATGATACGGCGACCACCGAGATCTACACGGACTAGTATGCTGGTGCTGCAGCTTATTA
s2_F_1496_ACCTACTGGC	AATGATACGGCGACCACCGAGATCTACACACCTACTGGCGCTGGTGCTGCAGCTTATTA
s2_F_1497_GATCGCAGTC	AATGATACGGCGACCACCGAGATCTACACGATCGCAGTCGCTGGTGCTGCAGCTTATTA
s2_F_1498_ACCGCCTTAA	AATGATACGGCGACCACCGAGATCTACACACCGCCTTAAGCTGGTGCTGCAGCTTATTA
s2_F_1499_CACTCTAGGC	AATGATACGGCGACCACCGAGATCTACACCACTCTAGGCGCTGGTGCTGCAGCTTATTA
s2_F_1500_CCTAATTCAC	AATGATACGGCGACCACCGAGATCTACACCCTAATTCACGCTGGTGCTGCAGCTTATTA
s2_F_1501_ACCAGTGGAT	AATGATACGGCGACCACCGAGATCTACACACCAGTGGATGCTGGTGCTGCAGCTTATTA
s2_F_1502_CCGCATATAG	AATGATACGGCGACCACCGAGATCTACACCCGCATATAGGCTGGTGCTGCAGCTTATTA
s2_F_1503_TCAACAAGTC	AATGATACGGCGACCACCGAGATCTACACTCAACAAGTCGCTGGTGCTGCAGCTTATTA
s2_F_1504_TTACTGAGTC	AATGATACGGCGACCACCGAGATCTACACTTACTGAGTCGCTGGTGCTGCAGCTTATTA
s2_F_1505_CTAGCCTCAG	AATGATACGGCGACCACCGAGATCTACACCTAGCCTCAGGCTGGTGCTGCAGCTTATTA
s2_F_1506_CACAGAGCAG	AATGATACGGCGACCACCGAGATCTACACCACAGAGCAGGCTGGTGCTGCAGCTTATTA
s2_F_1507_TGAAGAGCTT	AATGATACGGCGACCACCGAGATCTACACTGAAGAGCTTGCTGGTGCTGCAGCTTATTA
s2_F_1508_AGGTATAAGC	AATGATACGGCGACCACCGAGATCTACACAGGTATAAGCGCTGGTGCTGCAGCTTATTA
s2_F_1509_GCCACAGCAA	AATGATACGGCGACCACCGAGATCTACACGCCACAGCAAGCTGGTGCTGCAGCTTATTA
s2_F_1510_GACTAGTACC	AATGATACGGCGACCACCGAGATCTACACGACTAGTACCGCTGGTGCTGCAGCTTATTA
s2_F_1511_GCAATACACC	AATGATACGGCGACCACCGAGATCTACACGCAATACACCGCTGGTGCTGCAGCTTATTA
s2_F_1512_TGAGCATACC	AATGATACGGCGACCACCGAGATCTACACTGAGCATACCGCTGGTGCTGCAGCTTATTA
s2_F_1513_ACAGCCTCTG	AATGATACGGCGACCACCGAGATCTACACACAGCCTCTGGCTGGTGCTGCAGCTTATTA
s2_F_1514_ACCTGAGCAG	AATGATACGGCGACCACCGAGATCTACACACCTGAGCAGGCTGGTGCTGCAGCTTATTA
s2_F_1515_ACCTATAGCT	AATGATACGGCGACCACCGAGATCTACACACCTATAGCTGCTGGTGCTGCAGCTTATTA
s2_F_1516_TGGCATGCTT	AATGATACGGCGACCACCGAGATCTACACTGGCATGCTTGCTGGTGCTGCAGCTTATTA
s2_F_1517_ACCGAAGACA	AATGATACGGCGACCACCGAGATCTACACACCGAAGACAGCTGGTGCTGCAGCTTATTA
s2_F_1518_AGCAACGAAC	AATGATACGGCGACCACCGAGATCTACACAGCAACGAACGCTGGTGCTGCAGCTTATTA
s2_F_1519_AGTGGCTTAC	AATGATACGGCGACCACCGAGATCTACACAGTGGCTTACGCTGGTGCTGCAGCTTATTA
s2_F_1520_ATTCTTCCAC	AATGATACGGCGACCACCGAGATCTACACATTCTTCCACGCTGGTGCTGCAGCTTATTA
s2_F_1521_CAGGTTATAC	AATGATACGGCGACCACCGAGATCTACACCAGGTTATACGCTGGTGCTGCAGCTTATTA
s2_F_1522_GAGATACCAC	AATGATACGGCGACCACCGAGATCTACACGAGATACCACGCTGGTGCTGCAGCTTATTA
s2_F_1523_AACCTTCCTC	AATGATACGGCGACCACCGAGATCTACACAACCTTCCTCGCTGGTGCTGCAGCTTATTA
s2_F_1524_CAATGTCCTC	AATGATACGGCGACCACCGAGATCTACACCAATGTCCTCGCTGGTGCTGCAGCTTATTA
s2_F_1525_GCAGAGTACC	AATGATACGGCGACCACCGAGATCTACACGCAGAGTACCGCTGGTGCTGCAGCTTATTA
s2_F_1526_GAGAGAGACT	AATGATACGGCGACCACCGAGATCTACACGAGAGAGACTGCTGGTGCTGCAGCTTATTA
s2_F_1527_ACTTGTCCAC	AATGATACGGCGACCACCGAGATCTACACACTTGTCCACGCTGGTGCTGCAGCTTATTA
s2_F_1528_GGTTCCGCAT	AATGATACGGCGACCACCGAGATCTACACGGTTCCGCATGCTGGTGCTGCAGCTTATTA
s2_F_1529_AACGCCAGTC	AATGATACGGCGACCACCGAGATCTACACAACGCCAGTCGCTGGTGCTGCAGCTTATTA
s2_F_1530_ACTTAGACAC	AATGATACGGCGACCACCGAGATCTACACACTTAGACACGCTGGTGCTGCAGCTTATTA
s2_F_1531_CGAACGACAG	AATGATACGGCGACCACCGAGATCTACACCGAACGACAGGCTGGTGCTGCAGCTTATTA
s2_F_1532_GATCCGACAG	AATGATACGGCGACCACCGAGATCTACACGATCCGACAGGCTGGTGCTGCAGCTTATTA
s2_F_1533_AACTGCTACC	AATGATACGGCGACCACCGAGATCTACACAACTGCTACCGCTGGTGCTGCAGCTTATTA
s2_F_1534_CACAGATGCC	AATGATACGGCGACCACCGAGATCTACACCACAGATGCCGCTGGTGCTGCAGCTTATTA
s2_F_1535_ACACACAGAC	AATGATACGGCGACCACCGAGATCTACACACACACAGACGCTGGTGCTGCAGCTTATTA
s2_F_1536_AGCGAATCCG	AATGATACGGCGACCACCGAGATCTACACAGCGAATCCGGCTGGTGCTGCAGCTTATTA
s2_F_1537_GCCTAACTTC	AATGATACGGCGACCACCGAGATCTACACGCCTAACTTCGCTGGTGCTGCAGCTTATTA
s2_F_1538_TCACGTGGTT	AATGATACGGCGACCACCGAGATCTACACTCACGTGGTTGCTGGTGCTGCAGCTTATTA
s2_F_1539_ATTCACGTAC	AATGATACGGCGACCACCGAGATCTACACATTCACGTACGCTGGTGCTGCAGCTTATTA
s2_F_1540_ACTAGGACGT	AATGATACGGCGACCACCGAGATCTACACACTAGGACGTGCTGGTGCTGCAGCTTATTA
s2_F_1541_AGCTCTGCAT	AATGATACGGCGACCACCGAGATCTACACAGCTCTGCATGCTGGTGCTGCAGCTTATTA
s2_F_1542_ACTCAAGCTT	AATGATACGGCGACCACCGAGATCTACACACTCAAGCTTGCTGGTGCTGCAGCTTATTA
s2_F_1543_CGATTACAGC	AATGATACGGCGACCACCGAGATCTACACCGATTACAGCGCTGGTGCTGCAGCTTATTA
s2_F_1544_GATGGAGAGC	AATGATACGGCGACCACCGAGATCTACACGATGGAGAGCGCTGGTGCTGCAGCTTATTA
s2_F_1545_GATATCAGCT	AATGATACGGCGACCACCGAGATCTACACGATATCAGCTGCTGGTGCTGCAGCTTATTA
s2_F_1546_ACACACTAGT	AATGATACGGCGACCACCGAGATCTACACACACACTAGTGCTGGTGCTGCAGCTTATTA
s2_F_1547_ACACTGTACA	AATGATACGGCGACCACCGAGATCTACACACACTGTACAGCTGGTGCTGCAGCTTATTA
s2_F_1548_AGGACTACAC	AATGATACGGCGACCACCGAGATCTACACAGGACTACACGCTGGTGCTGCAGCTTATTA
s2_F_1549_CCATCCTCAC	AATGATACGGCGACCACCGAGATCTACACCCATCCTCACGCTGGTGCTGCAGCTTATTA
s2_F_1550_AACAACGAGA	AATGATACGGCGACCACCGAGATCTACACAACAACGAGAGCTGGTGCTGCAGCTTATTA
s2_F_1551_AACACACAGG	AATGATACGGCGACCACCGAGATCTACACAACACACAGGGCTGGTGCTGCAGCTTATTA
s2_F_1552_AACACAGTAG	AATGATACGGCGACCACCGAGATCTACACAACACAGTAGGCTGGTGCTGCAGCTTATTA
s2_F_1553_AACACCATTG	AATGATACGGCGACCACCGAGATCTACACAACACCATTGGCTGGTGCTGCAGCTTATTA
s2_F_1554_AACACGTCCA	AATGATACGGCGACCACCGAGATCTACACAACACGTCCAGCTGGTGCTGCAGCTTATTA
s2_F_1555_AACACTGCTT	AATGATACGGCGACCACCGAGATCTACACAACACTGCTTGCTGGTGCTGCAGCTTATTA
s2_F_1556_AACAGAGTGT	AATGATACGGCGACCACCGAGATCTACACAACAGAGTGTGCTGGTGCTGCAGCTTATTA
s2_F_1557_AACAGATAGC	AATGATACGGCGACCACCGAGATCTACACAACAGATAGCGCTGGTGCTGCAGCTTATTA
s2_F_1558_AACAGGATTC	AATGATACGGCGACCACCGAGATCTACACAACAGGATTCGCTGGTGCTGCAGCTTATTA
s2_F_1559_AACATCAAGC	AATGATACGGCGACCACCGAGATCTACACAACATCAAGCGCTGGTGCTGCAGCTTATTA
s2_F_1560_AACATGCAGT	AATGATACGGCGACCACCGAGATCTACACAACATGCAGTGCTGGTGCTGCAGCTTATTA
s2_F_1561_AACCAACCAG	AATGATACGGCGACCACCGAGATCTACACAACCAACCAGGCTGGTGCTGCAGCTTATTA
s2_F_1562_AACCAATAGG	AATGATACGGCGACCACCGAGATCTACACAACCAATAGGGCTGGTGCTGCAGCTTATTA
s2_F_1563_AACCACTGGT	AATGATACGGCGACCACCGAGATCTACACAACCACTGGTGCTGGTGCTGCAGCTTATTA
s2_F_1564_AACCAGAGGA	AATGATACGGCGACCACCGAGATCTACACAACCAGAGGAGCTGGTGCTGCAGCTTATTA
s2_F_1565_AACCAGCGAT	AATGATACGGCGACCACCGAGATCTACACAACCAGCGATGCTGGTGCTGCAGCTTATTA
s2_F_1566_AACCATGCAA	AATGATACGGCGACCACCGAGATCTACACAACCATGCAAGCTGGTGCTGCAGCTTATTA
s2_F_1567_AACCATTGAC	AATGATACGGCGACCACCGAGATCTACACAACCATTGACGCTGGTGCTGCAGCTTATTA
s2_F_1568_AACCGAATGC	AATGATACGGCGACCACCGAGATCTACACAACCGAATGCGCTGGTGCTGCAGCTTATTA
s2_F_1569_AACCGATCGT	AATGATACGGCGACCACCGAGATCTACACAACCGATCGTGCTGGTGCTGCAGCTTATTA
s2_F_1570_AACCGTACTA	AATGATACGGCGACCACCGAGATCTACACAACCGTACTAGCTGGTGCTGCAGCTTATTA
s2_F_1571_AACCGTGCCT	AATGATACGGCGACCACCGAGATCTACACAACCGTGCCTGCTGGTGCTGCAGCTTATTA
s2_F_1572_AACCTCATCC	AATGATACGGCGACCACCGAGATCTACACAACCTCATCCGCTGGTGCTGCAGCTTATTA
s2_F_1573_AACCTCCAGA	AATGATACGGCGACCACCGAGATCTACACAACCTCCAGAGCTGGTGCTGCAGCTTATTA
s2_F_1574_AACCTGAAGG	AATGATACGGCGACCACCGAGATCTACACAACCTGAAGGGCTGGTGCTGCAGCTTATTA
s2_F_1575_AACCTTAGAG	AATGATACGGCGACCACCGAGATCTACACAACCTTAGAGGCTGGTGCTGCAGCTTATTA
s2_F_1576_AACGAACCGT	AATGATACGGCGACCACCGAGATCTACACAACGAACCGTGCTGGTGCTGCAGCTTATTA
s2_F_1577_AACGACAGAA	AATGATACGGCGACCACCGAGATCTACACAACGACAGAAGCTGGTGCTGCAGCTTATTA
s2_F_1578_AACGACCACA	AATGATACGGCGACCACCGAGATCTACACAACGACCACAGCTGGTGCTGCAGCTTATTA
s2_F_1579_AACGACTCCT	AATGATACGGCGACCACCGAGATCTACACAACGACTCCTGCTGGTGCTGCAGCTTATTA
s2_F_1580_AACGAGTTAG	AATGATACGGCGACCACCGAGATCTACACAACGAGTTAGGCTGGTGCTGCAGCTTATTA
s2_F_1581_AACGATCAGG	AATGATACGGCGACCACCGAGATCTACACAACGATCAGGGCTGGTGCTGCAGCTTATTA
s2_F_1582_AACGATTCTG	AATGATACGGCGACCACCGAGATCTACACAACGATTCTGGCTGGTGCTGCAGCTTATTA
s2_F_1583_AACGCACAAC	AATGATACGGCGACCACCGAGATCTACACAACGCACAACGCTGGTGCTGCAGCTTATTA
s2_F_1584_AACGTAGCGA	AATGATACGGCGACCACCGAGATCTACACAACGTAGCGAGCTGGTGCTGCAGCTTATTA
s2_F_1585_AACGTGACAA	AATGATACGGCGACCACCGAGATCTACACAACGTGACAAGCTGGTGCTGCAGCTTATTA
s2_F_1586_AACGTGCTAT	AATGATACGGCGACCACCGAGATCTACACAACGTGCTATGCTGGTGCTGCAGCTTATTA
s2_F_1587_AACTACATGG	AATGATACGGCGACCACCGAGATCTACACAACTACATGGGCTGGTGCTGCAGCTTATTA
s2_F_1588_AACTACGTCT	AATGATACGGCGACCACCGAGATCTACACAACTACGTCTGCTGGTGCTGCAGCTTATTA
s2_F_1589_AACTAGAGAG	AATGATACGGCGACCACCGAGATCTACACAACTAGAGAGGCTGGTGCTGCAGCTTATTA
s2_F_1590_AACTCACCTT	AATGATACGGCGACCACCGAGATCTACACAACTCACCTTGCTGGTGCTGCAGCTTATTA
s2_F_1591_AACTCAGTCA	AATGATACGGCGACCACCGAGATCTACACAACTCAGTCAGCTGGTGCTGCAGCTTATTA
s2_F_1592_AACTGAACTG	AATGATACGGCGACCACCGAGATCTACACAACTGAACTGGCTGGTGCTGCAGCTTATTA
s2_F_1593_AACTGAGGAA	AATGATACGGCGACCACCGAGATCTACACAACTGAGGAAGCTGGTGCTGCAGCTTATTA
s2_F_1594_AACTGCCTTC	AATGATACGGCGACCACCGAGATCTACACAACTGCCTTCGCTGGTGCTGCAGCTTATTA
s2_F_1595_AACTGGATGA	AATGATACGGCGACCACCGAGATCTACACAACTGGATGAGCTGGTGCTGCAGCTTATTA
s2_F_1596_AACTGGCCAT	AATGATACGGCGACCACCGAGATCTACACAACTGGCCATGCTGGTGCTGCAGCTTATTA
s2_F_1597_AACTTCGTAC	AATGATACGGCGACCACCGAGATCTACACAACTTCGTACGCTGGTGCTGCAGCTTATTA
s2_F_1598_AACTTGGCTT	AATGATACGGCGACCACCGAGATCTACACAACTTGGCTTGCTGGTGCTGCAGCTTATTA
s2_F_1599_AAGAACCTCT	AATGATACGGCGACCACCGAGATCTACACAAGAACCTCTGCTGGTGCTGCAGCTTATTA
s2_F_1600_AAGAAGGATG	AATGATACGGCGACCACCGAGATCTACACAAGAAGGATGGCTGGTGCTGCAGCTTATTA
s2_F_1601_AAGACAAGAG	AATGATACGGCGACCACCGAGATCTACACAAGACAAGAGGCTGGTGCTGCAGCTTATTA
s2_F_1602_AAGACCAGGA	AATGATACGGCGACCACCGAGATCTACACAAGACCAGGAGCTGGTGCTGCAGCTTATTA
s2_F_1603_AAGACTCCAG	AATGATACGGCGACCACCGAGATCTACACAAGACTCCAGGCTGGTGCTGCAGCTTATTA
s2_F_1604_AAGACTGACT	AATGATACGGCGACCACCGAGATCTACACAAGACTGACTGCTGGTGCTGCAGCTTATTA
s2_F_1605_AAGAGACCAA	AATGATACGGCGACCACCGAGATCTACACAAGAGACCAAGCTGGTGCTGCAGCTTATTA
s2_F_1606_AAGATGTCCT	AATGATACGGCGACCACCGAGATCTACACAAGATGTCCTGCTGGTGCTGCAGCTTATTA
s2_F_1607_AAGCAAGTTG	AATGATACGGCGACCACCGAGATCTACACAAGCAAGTTGGCTGGTGCTGCAGCTTATTA
s2_F_1608_AAGCACTGAG	AATGATACGGCGACCACCGAGATCTACACAAGCACTGAGGCTGGTGCTGCAGCTTATTA
s2_F_1609_AAGCAGACAT	AATGATACGGCGACCACCGAGATCTACACAAGCAGACATGCTGGTGCTGCAGCTTATTA
s2_F_1610_AAGCATCATG	AATGATACGGCGACCACCGAGATCTACACAAGCATCATGGCTGGTGCTGCAGCTTATTA
s2_F_1611_AAGCCAGATT	AATGATACGGCGACCACCGAGATCTACACAAGCCAGATTGCTGGTGCTGCAGCTTATTA
s2_F_1612_AAGGAAGCAT	AATGATACGGCGACCACCGAGATCTACACAAGGAAGCATGCTGGTGCTGCAGCTTATTA
s2_F_1613_AAGGACACGA	AATGATACGGCGACCACCGAGATCTACACAAGGACACGAGCTGGTGCTGCAGCTTATTA
s2_F_1614_AAGGACGTAA	AATGATACGGCGACCACCGAGATCTACACAAGGACGTAAGCTGGTGCTGCAGCTTATTA
s2_F_1615_AAGGAGGACT	AATGATACGGCGACCACCGAGATCTACACAAGGAGGACTGCTGGTGCTGCAGCTTATTA
s2_F_1616_AAGGATGAGA	AATGATACGGCGACCACCGAGATCTACACAAGGATGAGAGCTGGTGCTGCAGCTTATTA
s2_F_1617_AAGGATTCCA	AATGATACGGCGACCACCGAGATCTACACAAGGATTCCAGCTGGTGCTGCAGCTTATTA
s2_F_1618_AAGGCAACCT	AATGATACGGCGACCACCGAGATCTACACAAGGCAACCTGCTGGTGCTGCAGCTTATTA
s2_F_1619_AAGGCATAGT	AATGATACGGCGACCACCGAGATCTACACAAGGCATAGTGCTGGTGCTGCAGCTTATTA
s2_F_1620_AAGGCTCATT	AATGATACGGCGACCACCGAGATCTACACAAGGCTCATTGCTGGTGCTGCAGCTTATTA
s2_F_1621_AAGGTTCTGG	AATGATACGGCGACCACCGAGATCTACACAAGGTTCTGGGCTGGTGCTGCAGCTTATTA
s2_F_1622_AAGTAACCGA	AATGATACGGCGACCACCGAGATCTACACAAGTAACCGAGCTGGTGCTGCAGCTTATTA
s2_F_1623_AAGTAACGTG	AATGATACGGCGACCACCGAGATCTACACAAGTAACGTGGCTGGTGCTGCAGCTTATTA
s2_F_1624_AAGTAAGGCT	AATGATACGGCGACCACCGAGATCTACACAAGTAAGGCTGCTGGTGCTGCAGCTTATTA
s2_F_1625_AAGTCAATGG	AATGATACGGCGACCACCGAGATCTACACAAGTCAATGGGCTGGTGCTGCAGCTTATTA
s2_F_1626_AAGTCCTGGT	AATGATACGGCGACCACCGAGATCTACACAAGTCCTGGTGCTGGTGCTGCAGCTTATTA
s2_F_1627_AAGTCTCAGG	AATGATACGGCGACCACCGAGATCTACACAAGTCTCAGGGCTGGTGCTGCAGCTTATTA
s2_F_1628_AAGTTCGAGA	AATGATACGGCGACCACCGAGATCTACACAAGTTCGAGAGCTGGTGCTGCAGCTTATTA
s2_F_1629_AATACACTCC	AATGATACGGCGACCACCGAGATCTACACAATACACTCCGCTGGTGCTGCAGCTTATTA
s2_F_1630_AATAGGAGGA	AATGATACGGCGACCACCGAGATCTACACAATAGGAGGAGCTGGTGCTGCAGCTTATTA
s2_F_1631_AATCAAGAGC	AATGATACGGCGACCACCGAGATCTACACAATCAAGAGCGCTGGTGCTGCAGCTTATTA
s2_F_1632_AATCCATCTG	AATGATACGGCGACCACCGAGATCTACACAATCCATCTGGCTGGTGCTGCAGCTTATTA
s2_F_1633_AATCCGTTCT	AATGATACGGCGACCACCGAGATCTACACAATCCGTTCTGCTGGTGCTGCAGCTTATTA
s2_F_1634_AATCGACCTA	AATGATACGGCGACCACCGAGATCTACACAATCGACCTAGCTGGTGCTGCAGCTTATTA
s2_F_1635_AATCGAGTCT	AATGATACGGCGACCACCGAGATCTACACAATCGAGTCTGCTGGTGCTGCAGCTTATTA
s2_F_1636_AATCGTCCAT	AATGATACGGCGACCACCGAGATCTACACAATCGTCCATGCTGGTGCTGCAGCTTATTA
s2_F_1637_AATCTGTCGT	AATGATACGGCGACCACCGAGATCTACACAATCTGTCGTGCTGGTGCTGCAGCTTATTA
s2_F_1638_AATGAGCAAG	AATGATACGGCGACCACCGAGATCTACACAATGAGCAAGGCTGGTGCTGCAGCTTATTA
s2_F_1639_AATGCGAAGA	AATGATACGGCGACCACCGAGATCTACACAATGCGAAGAGCTGGTGCTGCAGCTTATTA
s2_F_1640_AATGCTGAGT	AATGATACGGCGACCACCGAGATCTACACAATGCTGAGTGCTGGTGCTGCAGCTTATTA
s2_F_1641_AATGCTGTTG	AATGATACGGCGACCACCGAGATCTACACAATGCTGTTGGCTGGTGCTGCAGCTTATTA
s2_F_1642_AATGGATGGT	AATGATACGGCGACCACCGAGATCTACACAATGGATGGTGCTGGTGCTGCAGCTTATTA
s2_F_1643_AATGTTCCAG	AATGATACGGCGACCACCGAGATCTACACAATGTTCCAGGCTGGTGCTGCAGCTTATTA
s2_F_1644_AATTGCCACT	AATGATACGGCGACCACCGAGATCTACACAATTGCCACTGCTGGTGCTGCAGCTTATTA
s2_F_1645_ACAACAACCT	AATGATACGGCGACCACCGAGATCTACACACAACAACCTGCTGGTGCTGCAGCTTATTA
s2_F_1646_ACAACCGAGT	AATGATACGGCGACCACCGAGATCTACACACAACCGAGTGCTGGTGCTGCAGCTTATTA
s2_F_1647_ACAACCTCGA	AATGATACGGCGACCACCGAGATCTACACACAACCTCGAGCTGGTGCTGCAGCTTATTA
s2_F_1648_ACAACGAATG	AATGATACGGCGACCACCGAGATCTACACACAACGAATGGCTGGTGCTGCAGCTTATTA
s2_F_1649_ACAACTTAGG	AATGATACGGCGACCACCGAGATCTACACACAACTTAGGGCTGGTGCTGCAGCTTATTA
s2_F_1650_ACAACTTGCT	AATGATACGGCGACCACCGAGATCTACACACAACTTGCTGCTGGTGCTGCAGCTTATTA
s2_F_1651_ACAAGCCACT	AATGATACGGCGACCACCGAGATCTACACACAAGCCACTGCTGGTGCTGCAGCTTATTA
s2_F_1652_ACAAGCCTAA	AATGATACGGCGACCACCGAGATCTACACACAAGCCTAAGCTGGTGCTGCAGCTTATTA
s2_F_1653_ACAAGGATGG	AATGATACGGCGACCACCGAGATCTACACACAAGGATGGGCTGGTGCTGCAGCTTATTA
s2_F_1654_ACAAGTAGGA	AATGATACGGCGACCACCGAGATCTACACACAAGTAGGAGCTGGTGCTGCAGCTTATTA
s2_F_1655_ACAAGTCTTG	AATGATACGGCGACCACCGAGATCTACACACAAGTCTTGGCTGGTGCTGCAGCTTATTA
s2_F_1656_ACAAGTTCAG	AATGATACGGCGACCACCGAGATCTACACACAAGTTCAGGCTGGTGCTGCAGCTTATTA
s2_F_1657_ACAATACGTG	AATGATACGGCGACCACCGAGATCTACACACAATACGTGGCTGGTGCTGCAGCTTATTA
s2_F_1658_ACAATGCTCA	AATGATACGGCGACCACCGAGATCTACACACAATGCTCAGCTGGTGCTGCAGCTTATTA
s2_F_1659_ACAATGGACT	AATGATACGGCGACCACCGAGATCTACACACAATGGACTGCTGGTGCTGCAGCTTATTA
s2_F_1660_ACAATGGTTG	AATGATACGGCGACCACCGAGATCTACACACAATGGTTGGCTGGTGCTGCAGCTTATTA
s2_F_1661_ACACACTCTA	AATGATACGGCGACCACCGAGATCTACACACACACTCTAGCTGGTGCTGCAGCTTATTA
s2_F_1662_ACACATGAGA	AATGATACGGCGACCACCGAGATCTACACACACATGAGAGCTGGTGCTGCAGCTTATTA
s2_F_1663_ACACATGCCT	AATGATACGGCGACCACCGAGATCTACACACACATGCCTGCTGGTGCTGCAGCTTATTA
s2_F_1664_ACACCTGATG	AATGATACGGCGACCACCGAGATCTACACACACCTGATGGCTGGTGCTGCAGCTTATTA
s2_F_1665_ACACCTTCTT	AATGATACGGCGACCACCGAGATCTACACACACCTTCTTGCTGGTGCTGCAGCTTATTA
s2_F_1666_ACACGACAAG	AATGATACGGCGACCACCGAGATCTACACACACGACAAGGCTGGTGCTGCAGCTTATTA
s2_F_1667_ACACGAGAGT	AATGATACGGCGACCACCGAGATCTACACACACGAGAGTGCTGGTGCTGCAGCTTATTA
s2_F_1668_ACACGTAAGG	AATGATACGGCGACCACCGAGATCTACACACACGTAAGGGCTGGTGCTGCAGCTTATTA
s2_F_1669_ACACTAGGCT	AATGATACGGCGACCACCGAGATCTACACACACTAGGCTGCTGGTGCTGCAGCTTATTA
s2_F_1670_ACACTCAGGA	AATGATACGGCGACCACCGAGATCTACACACACTCAGGAGCTGGTGCTGCAGCTTATTA
s2_F_1671_ACACTCGAAC	AATGATACGGCGACCACCGAGATCTACACACACTCGAACGCTGGTGCTGCAGCTTATTA
s2_F_1672_ACACTGTCTG	AATGATACGGCGACCACCGAGATCTACACACACTGTCTGGCTGGTGCTGCAGCTTATTA
s2_F_1673_ACAGAACAGG	AATGATACGGCGACCACCGAGATCTACACACAGAACAGGGCTGGTGCTGCAGCTTATTA
s2_F_1674_ACAGACGATT	AATGATACGGCGACCACCGAGATCTACACACAGACGATTGCTGGTGCTGCAGCTTATTA
s2_F_1675_ACAGATCCTA	AATGATACGGCGACCACCGAGATCTACACACAGATCCTAGCTGGTGCTGCAGCTTATTA
s2_F_1676_ACAGATGAAG	AATGATACGGCGACCACCGAGATCTACACACAGATGAAGGCTGGTGCTGCAGCTTATTA
s2_F_1677_ACAGCGACTA	AATGATACGGCGACCACCGAGATCTACACACAGCGACTAGCTGGTGCTGCAGCTTATTA
s2_F_1678_ACAGCTATTG	AATGATACGGCGACCACCGAGATCTACACACAGCTATTGGCTGGTGCTGCAGCTTATTA
s2_F_1679_ACAGGACTGC	AATGATACGGCGACCACCGAGATCTACACACAGGACTGCGCTGGTGCTGCAGCTTATTA
s2_F_1680_ACAGTACGAA	AATGATACGGCGACCACCGAGATCTACACACAGTACGAAGCTGGTGCTGCAGCTTATTA
s2_F_1681_ACAGTCACAT	AATGATACGGCGACCACCGAGATCTACACACAGTCACATGCTGGTGCTGCAGCTTATTA
s2_F_1682_ACAGTTCTGA	AATGATACGGCGACCACCGAGATCTACACACAGTTCTGAGCTGGTGCTGCAGCTTATTA
s2_F_1683_ACATAGCGAG	AATGATACGGCGACCACCGAGATCTACACACATAGCGAGGCTGGTGCTGCAGCTTATTA
s2_F_1684_ACATCCGTGA	AATGATACGGCGACCACCGAGATCTACACACATCCGTGAGCTGGTGCTGCAGCTTATTA
s2_F_1685_ACATGCGTCC	AATGATACGGCGACCACCGAGATCTACACACATGCGTCCGCTGGTGCTGCAGCTTATTA
s2_F_1686_ACATGCTAAC	AATGATACGGCGACCACCGAGATCTACACACATGCTAACGCTGGTGCTGCAGCTTATTA
s2_F_1687_ACATTCCATC	AATGATACGGCGACCACCGAGATCTACACACATTCCATCGCTGGTGCTGCAGCTTATTA
s2_F_1688_ACATTGCGTT	AATGATACGGCGACCACCGAGATCTACACACATTGCGTTGCTGGTGCTGCAGCTTATTA
s2_F_1689_ACATTGGCGA	AATGATACGGCGACCACCGAGATCTACACACATTGGCGAGCTGGTGCTGCAGCTTATTA
s2_F_1690_ACCAACAAGG	AATGATACGGCGACCACCGAGATCTACACACCAACAAGGGCTGGTGCTGCAGCTTATTA
s2_F_1691_ACCAACACTA	AATGATACGGCGACCACCGAGATCTACACACCAACACTAGCTGGTGCTGCAGCTTATTA
s2_F_1692_ACCAACTATC	AATGATACGGCGACCACCGAGATCTACACACCAACTATCGCTGGTGCTGCAGCTTATTA
s2_F_1693_ACCACAAGAA	AATGATACGGCGACCACCGAGATCTACACACCACAAGAAGCTGGTGCTGCAGCTTATTA
s2_F_1694_ACCACATAAG	AATGATACGGCGACCACCGAGATCTACACACCACATAAGGCTGGTGCTGCAGCTTATTA
s2_F_1695_ACCACATTCA	AATGATACGGCGACCACCGAGATCTACACACCACATTCAGCTGGTGCTGCAGCTTATTA
s2_F_1696_ACCACGCTAC	AATGATACGGCGACCACCGAGATCTACACACCACGCTACGCTGGTGCTGCAGCTTATTA
s2_F_1697_ACCACGTCTT	AATGATACGGCGACCACCGAGATCTACACACCACGTCTTGCTGGTGCTGCAGCTTATTA
s2_F_1698_ACCAGATACT	AATGATACGGCGACCACCGAGATCTACACACCAGATACTGCTGGTGCTGCAGCTTATTA
s2_F_1699_ACCAGGAAGA	AATGATACGGCGACCACCGAGATCTACACACCAGGAAGAGCTGGTGCTGCAGCTTATTA
s2_F_1700_ACCATCAGAT	AATGATACGGCGACCACCGAGATCTACACACCATCAGATGCTGGTGCTGCAGCTTATTA
s2_F_1701_ACCATCTTAC	AATGATACGGCGACCACCGAGATCTACACACCATCTTACGCTGGTGCTGCAGCTTATTA
s2_F_1702_ACCGAACCAA	AATGATACGGCGACCACCGAGATCTACACACCGAACCAAGCTGGTGCTGCAGCTTATTA
s2_F_1703_ACCGAGAATG	AATGATACGGCGACCACCGAGATCTACACACCGAGAATGGCTGGTGCTGCAGCTTATTA
s2_F_1704_ACCGTCCTCA	AATGATACGGCGACCACCGAGATCTACACACCGTCCTCAGCTGGTGCTGCAGCTTATTA
s2_F_1705_ACCTAAGATG	AATGATACGGCGACCACCGAGATCTACACACCTAAGATGGCTGGTGCTGCAGCTTATTA
s2_F_1706_ACCTACCTGA	AATGATACGGCGACCACCGAGATCTACACACCTACCTGAGCTGGTGCTGCAGCTTATTA
s2_F_1707_ACCTACTTAG	AATGATACGGCGACCACCGAGATCTACACACCTACTTAGGCTGGTGCTGCAGCTTATTA
s2_F_1708_ACCTCAATAG	AATGATACGGCGACCACCGAGATCTACACACCTCAATAGGCTGGTGCTGCAGCTTATTA
s2_F_1709_ACCTCATGAC	AATGATACGGCGACCACCGAGATCTACACACCTCATGACGCTGGTGCTGCAGCTTATTA
s2_F_1710_ACCTCCGACT	AATGATACGGCGACCACCGAGATCTACACACCTCCGACTGCTGGTGCTGCAGCTTATTA
s2_F_1711_ACCTCCTGTT	AATGATACGGCGACCACCGAGATCTACACACCTCCTGTTGCTGGTGCTGCAGCTTATTA
s2_F_1712_ACCTGAACGA	AATGATACGGCGACCACCGAGATCTACACACCTGAACGAGCTGGTGCTGCAGCTTATTA
s2_F_1713_ACCTGTCTAT	AATGATACGGCGACCACCGAGATCTACACACCTGTCTATGCTGGTGCTGCAGCTTATTA
s2_F_1714_ACCTTATAGG	AATGATACGGCGACCACCGAGATCTACACACCTTATAGGGCTGGTGCTGCAGCTTATTA
s2_F_1715_ACCTTCCTTG	AATGATACGGCGACCACCGAGATCTACACACCTTCCTTGGCTGGTGCTGCAGCTTATTA
s2_F_1716_ACGAAGTCAA	AATGATACGGCGACCACCGAGATCTACACACGAAGTCAAGCTGGTGCTGCAGCTTATTA
s2_F_1717_ACGAATCAGT	AATGATACGGCGACCACCGAGATCTACACACGAATCAGTGCTGGTGCTGCAGCTTATTA
s2_F_1718_ACGACAGGAT	AATGATACGGCGACCACCGAGATCTACACACGACAGGATGCTGGTGCTGCAGCTTATTA
s2_F_1719_ACGACCTCAG	AATGATACGGCGACCACCGAGATCTACACACGACCTCAGGCTGGTGCTGCAGCTTATTA
s2_F_1720_ACGACTATCT	AATGATACGGCGACCACCGAGATCTACACACGACTATCTGCTGGTGCTGCAGCTTATTA
s2_F_1721_ACGAGACTCT	AATGATACGGCGACCACCGAGATCTACACACGAGACTCTGCTGGTGCTGCAGCTTATTA
s2_F_1722_ACGAGATAGG	AATGATACGGCGACCACCGAGATCTACACACGAGATAGGGCTGGTGCTGCAGCTTATTA
s2_F_1723_ACGAGGCATT	AATGATACGGCGACCACCGAGATCTACACACGAGGCATTGCTGGTGCTGCAGCTTATTA
s2_F_1724_ACGAGTCCGA	AATGATACGGCGACCACCGAGATCTACACACGAGTCCGAGCTGGTGCTGCAGCTTATTA
s2_F_1725_ACGATAGCCA	AATGATACGGCGACCACCGAGATCTACACACGATAGCCAGCTGGTGCTGCAGCTTATTA
s2_F_1726_ACGATTAAGG	AATGATACGGCGACCACCGAGATCTACACACGATTAAGGGCTGGTGCTGCAGCTTATTA
s2_F_1727_ACGCAACAAT	AATGATACGGCGACCACCGAGATCTACACACGCAACAATGCTGGTGCTGCAGCTTATTA
s2_F_1728_ACGCAATATG	AATGATACGGCGACCACCGAGATCTACACACGCAATATGGCTGGTGCTGCAGCTTATTA
s2_F_1729_ACGCATAACT	AATGATACGGCGACCACCGAGATCTACACACGCATAACTGCTGGTGCTGCAGCTTATTA
s2_F_1730_ACGCTATGTT	AATGATACGGCGACCACCGAGATCTACACACGCTATGTTGCTGGTGCTGCAGCTTATTA
s2_F_1731_ACGCTTCAAG	AATGATACGGCGACCACCGAGATCTACACACGCTTCAAGGCTGGTGCTGCAGCTTATTA
s2_F_1732_ACGTAACTCC	AATGATACGGCGACCACCGAGATCTACACACGTAACTCCGCTGGTGCTGCAGCTTATTA
s2_F_1733_ACGTAATTGG	AATGATACGGCGACCACCGAGATCTACACACGTAATTGGGCTGGTGCTGCAGCTTATTA
s2_F_1734_ACGTACACCT	AATGATACGGCGACCACCGAGATCTACACACGTACACCTGCTGGTGCTGCAGCTTATTA
s2_F_1735_ACGTAGCTTA	AATGATACGGCGACCACCGAGATCTACACACGTAGCTTAGCTGGTGCTGCAGCTTATTA
s2_F_1736_ACGTCACGAG	AATGATACGGCGACCACCGAGATCTACACACGTCACGAGGCTGGTGCTGCAGCTTATTA
s2_F_1737_ACGTCCAACC	AATGATACGGCGACCACCGAGATCTACACACGTCCAACCGCTGGTGCTGCAGCTTATTA
s2_F_1738_ACTAACCTTG	AATGATACGGCGACCACCGAGATCTACACACTAACCTTGGCTGGTGCTGCAGCTTATTA
s2_F_1739_ACTACAACTG	AATGATACGGCGACCACCGAGATCTACACACTACAACTGGCTGGTGCTGCAGCTTATTA
s2_F_1740_ACTACCAAGC	AATGATACGGCGACCACCGAGATCTACACACTACCAAGCGCTGGTGCTGCAGCTTATTA
s2_F_1741_ACTACCACAA	AATGATACGGCGACCACCGAGATCTACACACTACCACAAGCTGGTGCTGCAGCTTATTA
s2_F_1742_ACTACGAACA	AATGATACGGCGACCACCGAGATCTACACACTACGAACAGCTGGTGCTGCAGCTTATTA
s2_F_1743_ACTAGAGTCC	AATGATACGGCGACCACCGAGATCTACACACTAGAGTCCGCTGGTGCTGCAGCTTATTA
s2_F_1744_ACTAGCGAAT	AATGATACGGCGACCACCGAGATCTACACACTAGCGAATGCTGGTGCTGCAGCTTATTA
s2_F_1745_ACTATCCAGG	AATGATACGGCGACCACCGAGATCTACACACTATCCAGGGCTGGTGCTGCAGCTTATTA
s2_F_1746_ACTCACCAGA	AATGATACGGCGACCACCGAGATCTACACACTCACCAGAGCTGGTGCTGCAGCTTATTA
s2_F_1747_ACTCAGCCAT	AATGATACGGCGACCACCGAGATCTACACACTCAGCCATGCTGGTGCTGCAGCTTATTA
s2_F_1748_ACTCATTCAG	AATGATACGGCGACCACCGAGATCTACACACTCATTCAGGCTGGTGCTGCAGCTTATTA
s2_F_1749_ACTCCTCAAT	AATGATACGGCGACCACCGAGATCTACACACTCCTCAATGCTGGTGCTGCAGCTTATTA
s2_F_1750_ACTCCTTAGC	AATGATACGGCGACCACCGAGATCTACACACTCCTTAGCGCTGGTGCTGCAGCTTATTA
s2_F_1751_ACTCTGTAAG	AATGATACGGCGACCACCGAGATCTACACACTCTGTAAGGCTGGTGCTGCAGCTTATTA
s2_F_1752_ACTGACTCGT	AATGATACGGCGACCACCGAGATCTACACACTGACTCGTGCTGGTGCTGCAGCTTATTA
s2_F_1753_ACTGAGTTCA	AATGATACGGCGACCACCGAGATCTACACACTGAGTTCAGCTGGTGCTGCAGCTTATTA
s2_F_1754_ACTGATGCGA	AATGATACGGCGACCACCGAGATCTACACACTGATGCGAGCTGGTGCTGCAGCTTATTA
s2_F_1755_ACTGCCATTA	AATGATACGGCGACCACCGAGATCTACACACTGCCATTAGCTGGTGCTGCAGCTTATTA
s2_F_1756_ACTGCTCAGG	AATGATACGGCGACCACCGAGATCTACACACTGCTCAGGGCTGGTGCTGCAGCTTATTA
s2_F_1757_ACTGCTCCTT	AATGATACGGCGACCACCGAGATCTACACACTGCTCCTTGCTGGTGCTGCAGCTTATTA
s2_F_1758_ACTGGAATCA	AATGATACGGCGACCACCGAGATCTACACACTGGAATCAGCTGGTGCTGCAGCTTATTA
s2_F_1759_ACTTACAGAG	AATGATACGGCGACCACCGAGATCTACACACTTACAGAGGCTGGTGCTGCAGCTTATTA
s2_F_1760_ACTTAGGAAG	AATGATACGGCGACCACCGAGATCTACACACTTAGGAAGGCTGGTGCTGCAGCTTATTA
s2_F_1761_AGAACACAAC	AATGATACGGCGACCACCGAGATCTACACAGAACACAACGCTGGTGCTGCAGCTTATTA
s2_F_1762_AGAACACTGA	AATGATACGGCGACCACCGAGATCTACACAGAACACTGAGCTGGTGCTGCAGCTTATTA
s2_F_1763_AGAACCGTAG	AATGATACGGCGACCACCGAGATCTACACAGAACCGTAGGCTGGTGCTGCAGCTTATTA
s2_F_1764_AGAACTCCAA	AATGATACGGCGACCACCGAGATCTACACAGAACTCCAAGCTGGTGCTGCAGCTTATTA
s2_F_1765_AGAAGACGAG	AATGATACGGCGACCACCGAGATCTACACAGAAGACGAGGCTGGTGCTGCAGCTTATTA
s2_F_1766_AGAAGGTGAT	AATGATACGGCGACCACCGAGATCTACACAGAAGGTGATGCTGGTGCTGCAGCTTATTA
s2_F_1767_AGAATGAGGA	AATGATACGGCGACCACCGAGATCTACACAGAATGAGGAGCTGGTGCTGCAGCTTATTA
s2_F_1768_AGACAACCTG	AATGATACGGCGACCACCGAGATCTACACAGACAACCTGGCTGGTGCTGCAGCTTATTA
s2_F_1769_AGACAGATGA	AATGATACGGCGACCACCGAGATCTACACAGACAGATGAGCTGGTGCTGCAGCTTATTA
s2_F_1770_AGACATCTCA	AATGATACGGCGACCACCGAGATCTACACAGACATCTCAGCTGGTGCTGCAGCTTATTA
s2_F_1771_AGACCATGTT	AATGATACGGCGACCACCGAGATCTACACAGACCATGTTGCTGGTGCTGCAGCTTATTA
s2_F_1772_AGACGACATT	AATGATACGGCGACCACCGAGATCTACACAGACGACATTGCTGGTGCTGCAGCTTATTA
s2_F_1773_AGAGACTAAG	AATGATACGGCGACCACCGAGATCTACACAGAGACTAAGGCTGGTGCTGCAGCTTATTA
s2_F_1774_AGAGCAACGA	AATGATACGGCGACCACCGAGATCTACACAGAGCAACGAGCTGGTGCTGCAGCTTATTA
s2_F_1775_AGAGCCTTCC	AATGATACGGCGACCACCGAGATCTACACAGAGCCTTCCGCTGGTGCTGCAGCTTATTA
s2_F_1776_AGAGCGTACT	AATGATACGGCGACCACCGAGATCTACACAGAGCGTACTGCTGGTGCTGCAGCTTATTA
s2_F_1777_AGAGGAATAC	AATGATACGGCGACCACCGAGATCTACACAGAGGAATACGCTGGTGCTGCAGCTTATTA
s2_F_1778_AGAGGATTCT	AATGATACGGCGACCACCGAGATCTACACAGAGGATTCTGCTGGTGCTGCAGCTTATTA
s2_F_1779_AGAGGCATGA	AATGATACGGCGACCACCGAGATCTACACAGAGGCATGAGCTGGTGCTGCAGCTTATTA
s2_F_1780_AGAGGCCAAT	AATGATACGGCGACCACCGAGATCTACACAGAGGCCAATGCTGGTGCTGCAGCTTATTA
s2_F_1781_AGAGTGAAGG	AATGATACGGCGACCACCGAGATCTACACAGAGTGAAGGGCTGGTGCTGCAGCTTATTA
s2_F_1782_AGATGTACGA	AATGATACGGCGACCACCGAGATCTACACAGATGTACGAGCTGGTGCTGCAGCTTATTA
s2_F_1783_AGATTGCGAA	AATGATACGGCGACCACCGAGATCTACACAGATTGCGAAGCTGGTGCTGCAGCTTATTA
s2_F_1784_AGCAAGACAA	AATGATACGGCGACCACCGAGATCTACACAGCAAGACAAGCTGGTGCTGCAGCTTATTA
s2_F_1785_AGCAGAGTAA	AATGATACGGCGACCACCGAGATCTACACAGCAGAGTAAGCTGGTGCTGCAGCTTATTA
s2_F_1786_AGCATTCTGG	AATGATACGGCGACCACCGAGATCTACACAGCATTCTGGGCTGGTGCTGCAGCTTATTA
s2_F_1787_AGCCACTGAA	AATGATACGGCGACCACCGAGATCTACACAGCCACTGAAGCTGGTGCTGCAGCTTATTA
s2_F_1788_AGCCATTCCT	AATGATACGGCGACCACCGAGATCTACACAGCCATTCCTGCTGGTGCTGCAGCTTATTA
s2_F_1789_AGCGATAGGA	AATGATACGGCGACCACCGAGATCTACACAGCGATAGGAGCTGGTGCTGCAGCTTATTA
s2_F_1790_AGCGTAATCT	AATGATACGGCGACCACCGAGATCTACACAGCGTAATCTGCTGGTGCTGCAGCTTATTA
s2_F_1791_AGCGTCATTA	AATGATACGGCGACCACCGAGATCTACACAGCGTCATTAGCTGGTGCTGCAGCTTATTA
s2_F_1792_AGCTAGAAGG	AATGATACGGCGACCACCGAGATCTACACAGCTAGAAGGGCTGGTGCTGCAGCTTATTA
s2_F_1793_AGCTTACTGA	AATGATACGGCGACCACCGAGATCTACACAGCTTACTGAGCTGGTGCTGCAGCTTATTA
s2_F_1794_AGGAACCAAG	AATGATACGGCGACCACCGAGATCTACACAGGAACCAAGGCTGGTGCTGCAGCTTATTA
s2_F_1795_AGGACGAAGA	AATGATACGGCGACCACCGAGATCTACACAGGACGAAGAGCTGGTGCTGCAGCTTATTA
s2_F_1796_AGGATATCTG	AATGATACGGCGACCACCGAGATCTACACAGGATATCTGGCTGGTGCTGCAGCTTATTA
s2_F_1797_AGGCAGTAAT	AATGATACGGCGACCACCGAGATCTACACAGGCAGTAATGCTGGTGCTGCAGCTTATTA
s2_F_1798_AGGCTATAGG	AATGATACGGCGACCACCGAGATCTACACAGGCTATAGGGCTGGTGCTGCAGCTTATTA
s2_F_1799_AGGTGCAAGT	AATGATACGGCGACCACCGAGATCTACACAGGTGCAAGTGCTGGTGCTGCAGCTTATTA
s2_F_1800_AGTACGAGAT	AATGATACGGCGACCACCGAGATCTACACAGTACGAGATGCTGGTGCTGCAGCTTATTA
s2_F_1801_AGTAGGATCA	AATGATACGGCGACCACCGAGATCTACACAGTAGGATCAGCTGGTGCTGCAGCTTATTA
s2_F_1802_AGTAGTGCCT	AATGATACGGCGACCACCGAGATCTACACAGTAGTGCCTGCTGGTGCTGCAGCTTATTA
s2_F_1803_AGTATACCAG	AATGATACGGCGACCACCGAGATCTACACAGTATACCAGGCTGGTGCTGCAGCTTATTA
s2_F_1804_AGTATCCAAC	AATGATACGGCGACCACCGAGATCTACACAGTATCCAACGCTGGTGCTGCAGCTTATTA
s2_F_1805_AGTATTCCGT	AATGATACGGCGACCACCGAGATCTACACAGTATTCCGTGCTGGTGCTGCAGCTTATTA
s2_F_1806_AGTCAGCGAA	AATGATACGGCGACCACCGAGATCTACACAGTCAGCGAAGCTGGTGCTGCAGCTTATTA
s2_F_1807_AGTCCAGGAT	AATGATACGGCGACCACCGAGATCTACACAGTCCAGGATGCTGGTGCTGCAGCTTATTA
s2_F_1808_AGTCCTCCAG	AATGATACGGCGACCACCGAGATCTACACAGTCCTCCAGGCTGGTGCTGCAGCTTATTA
s2_F_1809_AGTCTCAGAA	AATGATACGGCGACCACCGAGATCTACACAGTCTCAGAAGCTGGTGCTGCAGCTTATTA
s2_F_1810_AGTCTTCATC	AATGATACGGCGACCACCGAGATCTACACAGTCTTCATCGCTGGTGCTGCAGCTTATTA
s2_F_1811_AGTTCCAAGA	AATGATACGGCGACCACCGAGATCTACACAGTTCCAAGAGCTGGTGCTGCAGCTTATTA
s2_F_1812_AGTTGCTCTT	AATGATACGGCGACCACCGAGATCTACACAGTTGCTCTTGCTGGTGCTGCAGCTTATTA
s2_F_1813_ATACAGTTGG	AATGATACGGCGACCACCGAGATCTACACATACAGTTGGGCTGGTGCTGCAGCTTATTA
s2_F_1814_ATACCACATG	AATGATACGGCGACCACCGAGATCTACACATACCACATGGCTGGTGCTGCAGCTTATTA
s2_F_1815_ATACCTCACA	AATGATACGGCGACCACCGAGATCTACACATACCTCACAGCTGGTGCTGCAGCTTATTA
s2_F_1816_ATAGCCTAAC	AATGATACGGCGACCACCGAGATCTACACATAGCCTAACGCTGGTGCTGCAGCTTATTA
s2_F_1817_ATAGGATAGG	AATGATACGGCGACCACCGAGATCTACACATAGGATAGGGCTGGTGCTGCAGCTTATTA
s2_F_1818_ATAGTCTTGG	AATGATACGGCGACCACCGAGATCTACACATAGTCTTGGGCTGGTGCTGCAGCTTATTA
s2_F_1819_ATAGTTCCTG	AATGATACGGCGACCACCGAGATCTACACATAGTTCCTGGCTGGTGCTGCAGCTTATTA
s2_F_1820_ATATGGTGAG	AATGATACGGCGACCACCGAGATCTACACATATGGTGAGGCTGGTGCTGCAGCTTATTA
s2_F_1821_ATCAACAGAG	AATGATACGGCGACCACCGAGATCTACACATCAACAGAGGCTGGTGCTGCAGCTTATTA
s2_F_1822_ATCAACTGGA	AATGATACGGCGACCACCGAGATCTACACATCAACTGGAGCTGGTGCTGCAGCTTATTA
s2_F_1823_ATCACACGTT	AATGATACGGCGACCACCGAGATCTACACATCACACGTTGCTGGTGCTGCAGCTTATTA
s2_F_1824_ATCACTCTCC	AATGATACGGCGACCACCGAGATCTACACATCACTCTCCGCTGGTGCTGCAGCTTATTA
s2_F_1825_ATCATCCTTC	AATGATACGGCGACCACCGAGATCTACACATCATCCTTCGCTGGTGCTGCAGCTTATTA
s2_F_1826_ATCCACCATT	AATGATACGGCGACCACCGAGATCTACACATCCACCATTGCTGGTGCTGCAGCTTATTA
s2_F_1827_ATCCAGTCAT	AATGATACGGCGACCACCGAGATCTACACATCCAGTCATGCTGGTGCTGCAGCTTATTA
s2_F_1828_ATCCGATCCA	AATGATACGGCGACCACCGAGATCTACACATCCGATCCAGCTGGTGCTGCAGCTTATTA
s2_F_1829_ATCCGTTAAG	AATGATACGGCGACCACCGAGATCTACACATCCGTTAAGGCTGGTGCTGCAGCTTATTA
s2_F_1830_ATCCTCGAAG	AATGATACGGCGACCACCGAGATCTACACATCCTCGAAGGCTGGTGCTGCAGCTTATTA
s2_F_1831_ATCCTGCATA	AATGATACGGCGACCACCGAGATCTACACATCCTGCATAGCTGGTGCTGCAGCTTATTA
s2_F_1832_ATCGACTAGG	AATGATACGGCGACCACCGAGATCTACACATCGACTAGGGCTGGTGCTGCAGCTTATTA
s2_F_1833_ATCGAGTTCC	AATGATACGGCGACCACCGAGATCTACACATCGAGTTCCGCTGGTGCTGCAGCTTATTA
s2_F_1834_ATCGTATAGC	AATGATACGGCGACCACCGAGATCTACACATCGTATAGCGCTGGTGCTGCAGCTTATTA
s2_F_1835_ATCTACGCAA	AATGATACGGCGACCACCGAGATCTACACATCTACGCAAGCTGGTGCTGCAGCTTATTA
s2_F_1836_ATCTGCCTCA	AATGATACGGCGACCACCGAGATCTACACATCTGCCTCAGCTGGTGCTGCAGCTTATTA
s2_F_1837_ATCTGTCACT	AATGATACGGCGACCACCGAGATCTACACATCTGTCACTGCTGGTGCTGCAGCTTATTA
s2_F_1838_ATGAAGGTCA	AATGATACGGCGACCACCGAGATCTACACATGAAGGTCAGCTGGTGCTGCAGCTTATTA
s2_F_1839_ATGACCGAAG	AATGATACGGCGACCACCGAGATCTACACATGACCGAAGGCTGGTGCTGCAGCTTATTA
s2_F_1840_ATGCGTACAA	AATGATACGGCGACCACCGAGATCTACACATGCGTACAAGCTGGTGCTGCAGCTTATTA
s2_F_1841_ATTACGATGC	AATGATACGGCGACCACCGAGATCTACACATTACGATGCGCTGGTGCTGCAGCTTATTA
s2_F_1842_ATTAGGCTGA	AATGATACGGCGACCACCGAGATCTACACATTAGGCTGAGCTGGTGCTGCAGCTTATTA
s2_F_1843_ATTCCTGCTT	AATGATACGGCGACCACCGAGATCTACACATTCCTGCTTGCTGGTGCTGCAGCTTATTA
s2_F_1844_ATTGCCTAGT	AATGATACGGCGACCACCGAGATCTACACATTGCCTAGTGCTGGTGCTGCAGCTTATTA
s2_F_1845_ATTGTCAAGG	AATGATACGGCGACCACCGAGATCTACACATTGTCAAGGGCTGGTGCTGCAGCTTATTA
s2_F_1846_CAACAATCAG	AATGATACGGCGACCACCGAGATCTACACCAACAATCAGGCTGGTGCTGCAGCTTATTA
s2_F_1847_CAACAGATGG	AATGATACGGCGACCACCGAGATCTACACCAACAGATGGGCTGGTGCTGCAGCTTATTA
s2_F_1848_CAACATAGGT	AATGATACGGCGACCACCGAGATCTACACCAACATAGGTGCTGGTGCTGCAGCTTATTA
s2_F_1849_CAACATCATC	AATGATACGGCGACCACCGAGATCTACACCAACATCATCGCTGGTGCTGCAGCTTATTA
s2_F_1850_CAACATGAAG	AATGATACGGCGACCACCGAGATCTACACCAACATGAAGGCTGGTGCTGCAGCTTATTA
s2_F_1851_CAACCAACGT	AATGATACGGCGACCACCGAGATCTACACCAACCAACGTGCTGGTGCTGCAGCTTATTA
s2_F_1852_CAACGAAGAG	AATGATACGGCGACCACCGAGATCTACACCAACGAAGAGGCTGGTGCTGCAGCTTATTA
s2_F_1853_CAACGAGAAT	AATGATACGGCGACCACCGAGATCTACACCAACGAGAATGCTGGTGCTGCAGCTTATTA
s2_F_1854_CAACTACTGA	AATGATACGGCGACCACCGAGATCTACACCAACTACTGAGCTGGTGCTGCAGCTTATTA
s2_F_1855_CAACTTCCAG	AATGATACGGCGACCACCGAGATCTACACCAACTTCCAGGCTGGTGCTGCAGCTTATTA
s2_F_1856_CAAGAAGGTT	AATGATACGGCGACCACCGAGATCTACACCAAGAAGGTTGCTGGTGCTGCAGCTTATTA
s2_F_1857_CAAGACCTGA	AATGATACGGCGACCACCGAGATCTACACCAAGACCTGAGCTGGTGCTGCAGCTTATTA
s2_F_1858_CAAGCCATAG	AATGATACGGCGACCACCGAGATCTACACCAAGCCATAGGCTGGTGCTGCAGCTTATTA
s2_F_1859_CAAGGATAAG	AATGATACGGCGACCACCGAGATCTACACCAAGGATAAGGCTGGTGCTGCAGCTTATTA
s2_F_1860_CAATATGCCT	AATGATACGGCGACCACCGAGATCTACACCAATATGCCTGCTGGTGCTGCAGCTTATTA
s2_F_1861_CAATCCACGA	AATGATACGGCGACCACCGAGATCTACACCAATCCACGAGCTGGTGCTGCAGCTTATTA
s2_F_1862_CAATCGTTGA	AATGATACGGCGACCACCGAGATCTACACCAATCGTTGAGCTGGTGCTGCAGCTTATTA
s2_F_1863_CAATTACCTG	AATGATACGGCGACCACCGAGATCTACACCAATTACCTGGCTGGTGCTGCAGCTTATTA
s2_F_1864_CAATTCCGAT	AATGATACGGCGACCACCGAGATCTACACCAATTCCGATGCTGGTGCTGCAGCTTATTA
s2_F_1865_CACAAGAAGG	AATGATACGGCGACCACCGAGATCTACACCACAAGAAGGGCTGGTGCTGCAGCTTATTA
s2_F_1866_CACAAGGAAT	AATGATACGGCGACCACCGAGATCTACACCACAAGGAATGCTGGTGCTGCAGCTTATTA
s2_F_1867_CACAGAACGA	AATGATACGGCGACCACCGAGATCTACACCACAGAACGAGCTGGTGCTGCAGCTTATTA
s2_F_1868_CACATATAGG	AATGATACGGCGACCACCGAGATCTACACCACATATAGGGCTGGTGCTGCAGCTTATTA
s2_F_1869_CACCAATCCT	AATGATACGGCGACCACCGAGATCTACACCACCAATCCTGCTGGTGCTGCAGCTTATTA
s2_F_1870_CACCATCTAG	AATGATACGGCGACCACCGAGATCTACACCACCATCTAGGCTGGTGCTGCAGCTTATTA
s2_F_1871_CACCGTTGAT	AATGATACGGCGACCACCGAGATCTACACCACCGTTGATGCTGGTGCTGCAGCTTATTA
s2_F_1872_CACCTATGAG	AATGATACGGCGACCACCGAGATCTACACCACCTATGAGGCTGGTGCTGCAGCTTATTA
s2_F_1873_CACCTCCTTA	AATGATACGGCGACCACCGAGATCTACACCACCTCCTTAGCTGGTGCTGCAGCTTATTA
s2_F_1874_CACCTCGATT	AATGATACGGCGACCACCGAGATCTACACCACCTCGATTGCTGGTGCTGCAGCTTATTA
s2_F_1875_CACTATTGCT	AATGATACGGCGACCACCGAGATCTACACCACTATTGCTGCTGGTGCTGCAGCTTATTA
s2_F_1876_CACTGAACAT	AATGATACGGCGACCACCGAGATCTACACCACTGAACATGCTGGTGCTGCAGCTTATTA
s2_F_1877_CACTTCTAAG	AATGATACGGCGACCACCGAGATCTACACCACTTCTAAGGCTGGTGCTGCAGCTTATTA
s2_F_1878_CAGAACACTT	AATGATACGGCGACCACCGAGATCTACACCAGAACACTTGCTGGTGCTGCAGCTTATTA
s2_F_1879_CAGGTCTAAT	AATGATACGGCGACCACCGAGATCTACACCAGGTCTAATGCTGGTGCTGCAGCTTATTA
s2_F_1880_CAGTAACAAG	AATGATACGGCGACCACCGAGATCTACACCAGTAACAAGGCTGGTGCTGCAGCTTATTA
s2_F_1881_CAGTAGTAGG	AATGATACGGCGACCACCGAGATCTACACCAGTAGTAGGGCTGGTGCTGCAGCTTATTA
s2_F_1882_CAGTTGATTG	AATGATACGGCGACCACCGAGATCTACACCAGTTGATTGGCTGGTGCTGCAGCTTATTA
s2_F_1883_CATAAGTTGC	AATGATACGGCGACCACCGAGATCTACACCATAAGTTGCGCTGGTGCTGCAGCTTATTA
s2_F_1884_CATCATAGAG	AATGATACGGCGACCACCGAGATCTACACCATCATAGAGGCTGGTGCTGCAGCTTATTA
s2_F_1885_CATCCACAGG	AATGATACGGCGACCACCGAGATCTACACCATCCACAGGGCTGGTGCTGCAGCTTATTA
s2_F_1886_CATCCACTAT	AATGATACGGCGACCACCGAGATCTACACCATCCACTATGCTGGTGCTGCAGCTTATTA
s2_F_1887_CATCCTATGT	AATGATACGGCGACCACCGAGATCTACACCATCCTATGTGCTGGTGCTGCAGCTTATTA
s2_F_1888_CATGACTTAG	AATGATACGGCGACCACCGAGATCTACACCATGACTTAGGCTGGTGCTGCAGCTTATTA
s2_F_1889_CATTCATCCA	AATGATACGGCGACCACCGAGATCTACACCATTCATCCAGCTGGTGCTGCAGCTTATTA
s2_F_1890_CCAACGAGGA	AATGATACGGCGACCACCGAGATCTACACCCAACGAGGAGCTGGTGCTGCAGCTTATTA
s2_F_1891_CCAAGAGAAG	AATGATACGGCGACCACCGAGATCTACACCCAAGAGAAGGCTGGTGCTGCAGCTTATTA
s2_F_1892_CCAAGGTAGT	AATGATACGGCGACCACCGAGATCTACACCCAAGGTAGTGCTGGTGCTGCAGCTTATTA
s2_F_1893_CCAATCTCAA	AATGATACGGCGACCACCGAGATCTACACCCAATCTCAAGCTGGTGCTGCAGCTTATTA
s2_F_1894_CCACACTGAA	AATGATACGGCGACCACCGAGATCTACACCCACACTGAAGCTGGTGCTGCAGCTTATTA
s2_F_1895_CCACATAACC	AATGATACGGCGACCACCGAGATCTACACCCACATAACCGCTGGTGCTGCAGCTTATTA
s2_F_1896_CCACCTAGTA	AATGATACGGCGACCACCGAGATCTACACCCACCTAGTAGCTGGTGCTGCAGCTTATTA
s2_F_1897_CCACCTATGC	AATGATACGGCGACCACCGAGATCTACACCCACCTATGCGCTGGTGCTGCAGCTTATTA
s2_F_1898_CCACTTCGTT	AATGATACGGCGACCACCGAGATCTACACCCACTTCGTTGCTGGTGCTGCAGCTTATTA
s2_F_1899_CCAGAAGACT	AATGATACGGCGACCACCGAGATCTACACCCAGAAGACTGCTGGTGCTGCAGCTTATTA
s2_F_1900_CCATCACAGA	AATGATACGGCGACCACCGAGATCTACACCCATCACAGAGCTGGTGCTGCAGCTTATTA
s2_F_1901_CCATCCACCT	AATGATACGGCGACCACCGAGATCTACACCCATCCACCTGCTGGTGCTGCAGCTTATTA
s2_F_1902_CCATCCATTC	AATGATACGGCGACCACCGAGATCTACACCCATCCATTCGCTGGTGCTGCAGCTTATTA
s2_F_1903_CCATGTGACT	AATGATACGGCGACCACCGAGATCTACACCCATGTGACTGCTGGTGCTGCAGCTTATTA
s2_F_1904_CCGAACTAGA	AATGATACGGCGACCACCGAGATCTACACCCGAACTAGAGCTGGTGCTGCAGCTTATTA
s2_F_1905_CCGAAGTTCT	AATGATACGGCGACCACCGAGATCTACACCCGAAGTTCTGCTGGTGCTGCAGCTTATTA
s2_F_1906_CCGAGGATAG	AATGATACGGCGACCACCGAGATCTACACCCGAGGATAGGCTGGTGCTGCAGCTTATTA
s2_F_1907_CCGATAACTT	AATGATACGGCGACCACCGAGATCTACACCCGATAACTTGCTGGTGCTGCAGCTTATTA
s2_F_1908_CCGTCAGAAG	AATGATACGGCGACCACCGAGATCTACACCCGTCAGAAGGCTGGTGCTGCAGCTTATTA
s2_F_1909_CCGTTAATAG	AATGATACGGCGACCACCGAGATCTACACCCGTTAATAGGCTGGTGCTGCAGCTTATTA
s2_F_1910_CCTACCTTCC	AATGATACGGCGACCACCGAGATCTACACCCTACCTTCCGCTGGTGCTGCAGCTTATTA
s2_F_1911_CCTAGATGAG	AATGATACGGCGACCACCGAGATCTACACCCTAGATGAGGCTGGTGCTGCAGCTTATTA
s2_F_1912_CCTCAAGTCC	AATGATACGGCGACCACCGAGATCTACACCCTCAAGTCCGCTGGTGCTGCAGCTTATTA
s2_F_1913_CCTCACCATT	AATGATACGGCGACCACCGAGATCTACACCCTCACCATTGCTGGTGCTGCAGCTTATTA
s2_F_1914_CCTCATTCTT	AATGATACGGCGACCACCGAGATCTACACCCTCATTCTTGCTGGTGCTGCAGCTTATTA
s2_F_1915_CCTCGACTCT	AATGATACGGCGACCACCGAGATCTACACCCTCGACTCTGCTGGTGCTGCAGCTTATTA
s2_F_1916_CCTGAACACA	AATGATACGGCGACCACCGAGATCTACACCCTGAACACAGCTGGTGCTGCAGCTTATTA
s2_F_1917_CCTGAATCTG	AATGATACGGCGACCACCGAGATCTACACCCTGAATCTGGCTGGTGCTGCAGCTTATTA
s2_F_1918_CCTGAGTAAT	AATGATACGGCGACCACCGAGATCTACACCCTGAGTAATGCTGGTGCTGCAGCTTATTA
s2_F_1919_CCTTCCTCTT	AATGATACGGCGACCACCGAGATCTACACCCTTCCTCTTGCTGGTGCTGCAGCTTATTA
s2_F_1920_CGAACCAGTA	AATGATACGGCGACCACCGAGATCTACACCGAACCAGTAGCTGGTGCTGCAGCTTATTA
s2_F_1921_CGAACGCTTG	AATGATACGGCGACCACCGAGATCTACACCGAACGCTTGGCTGGTGCTGCAGCTTATTA
s2_F_1922_CGAAGACACA	AATGATACGGCGACCACCGAGATCTACACCGAAGACACAGCTGGTGCTGCAGCTTATTA
s2_F_1923_CGAAGAGTAT	AATGATACGGCGACCACCGAGATCTACACCGAAGAGTATGCTGGTGCTGCAGCTTATTA
s2_F_1924_CGAAGGTTAG	AATGATACGGCGACCACCGAGATCTACACCGAAGGTTAGGCTGGTGCTGCAGCTTATTA
s2_F_1925_CGAAGTATGG	AATGATACGGCGACCACCGAGATCTACACCGAAGTATGGGCTGGTGCTGCAGCTTATTA
s2_F_1926_CGAATCTAAG	AATGATACGGCGACCACCGAGATCTACACCGAATCTAAGGCTGGTGCTGCAGCTTATTA
s2_F_1927_CGACCAATAG	AATGATACGGCGACCACCGAGATCTACACCGACCAATAGGCTGGTGCTGCAGCTTATTA
s2_F_1928_CGACTAAGTA	AATGATACGGCGACCACCGAGATCTACACCGACTAAGTAGCTGGTGCTGCAGCTTATTA
s2_F_1929_CGAGAATAGT	AATGATACGGCGACCACCGAGATCTACACCGAGAATAGTGCTGGTGCTGCAGCTTATTA
s2_F_1930_CGAGGACTAA	AATGATACGGCGACCACCGAGATCTACACCGAGGACTAAGCTGGTGCTGCAGCTTATTA
s2_F_1931_CGAGTAACCA	AATGATACGGCGACCACCGAGATCTACACCGAGTAACCAGCTGGTGCTGCAGCTTATTA
s2_F_1932_CGAGTTGAAG	AATGATACGGCGACCACCGAGATCTACACCGAGTTGAAGGCTGGTGCTGCAGCTTATTA
s2_F_1933_CGTACCGTTA	AATGATACGGCGACCACCGAGATCTACACCGTACCGTTAGCTGGTGCTGCAGCTTATTA
s2_F_1934_CGTGCGTGAA	AATGATACGGCGACCACCGAGATCTACACCGTGCGTGAAGCTGGTGCTGCAGCTTATTA
s2_F_1935_CTACCTCTTC	AATGATACGGCGACCACCGAGATCTACACCTACCTCTTCGCTGGTGCTGCAGCTTATTA
s2_F_1936_CTAGTTCCAA	AATGATACGGCGACCACCGAGATCTACACCTAGTTCCAAGCTGGTGCTGCAGCTTATTA
s2_F_1937_CTATTCACTG	AATGATACGGCGACCACCGAGATCTACACCTATTCACTGGCTGGTGCTGCAGCTTATTA
s2_F_1938_CTCATATCTG	AATGATACGGCGACCACCGAGATCTACACCTCATATCTGGCTGGTGCTGCAGCTTATTA
s2_F_1939_CTCCACCACA	AATGATACGGCGACCACCGAGATCTACACCTCCACCACAGCTGGTGCTGCAGCTTATTA
s2_F_1940_CTCCTTCAGA	AATGATACGGCGACCACCGAGATCTACACCTCCTTCAGAGCTGGTGCTGCAGCTTATTA
s2_F_1941_CTGAGTTCTT	AATGATACGGCGACCACCGAGATCTACACCTGAGTTCTTGCTGGTGCTGCAGCTTATTA
s2_F_1942_CTGATGTACT	AATGATACGGCGACCACCGAGATCTACACCTGATGTACTGCTGGTGCTGCAGCTTATTA
s2_F_1943_CTTCCAGTAA	AATGATACGGCGACCACCGAGATCTACACCTTCCAGTAAGCTGGTGCTGCAGCTTATTA
s2_F_1944_GAACGAATCT	AATGATACGGCGACCACCGAGATCTACACGAACGAATCTGCTGGTGCTGCAGCTTATTA
s2_F_1945_GAACTGTAAG	AATGATACGGCGACCACCGAGATCTACACGAACTGTAAGGCTGGTGCTGCAGCTTATTA
s2_F_1946_GAAGAAGTTC	AATGATACGGCGACCACCGAGATCTACACGAAGAAGTTCGCTGGTGCTGCAGCTTATTA
s2_F_1947_GAAGAGGTAG	AATGATACGGCGACCACCGAGATCTACACGAAGAGGTAGGCTGGTGCTGCAGCTTATTA
s2_F_1948_GAAGGCAAGG	AATGATACGGCGACCACCGAGATCTACACGAAGGCAAGGGCTGGTGCTGCAGCTTATTA
s2_F_1949_GAAGGTTCTT	AATGATACGGCGACCACCGAGATCTACACGAAGGTTCTTGCTGGTGCTGCAGCTTATTA
s2_F_1950_GAATAGCGAT	AATGATACGGCGACCACCGAGATCTACACGAATAGCGATGCTGGTGCTGCAGCTTATTA
s2_F_1951_GACAAGATAG	AATGATACGGCGACCACCGAGATCTACACGACAAGATAGGCTGGTGCTGCAGCTTATTA
s2_F_1952_GACCGAATTA	AATGATACGGCGACCACCGAGATCTACACGACCGAATTAGCTGGTGCTGCAGCTTATTA
s2_F_1953_GACCTACTAA	AATGATACGGCGACCACCGAGATCTACACGACCTACTAAGCTGGTGCTGCAGCTTATTA
s2_F_1954_GACTGGATAT	AATGATACGGCGACCACCGAGATCTACACGACTGGATATGCTGGTGCTGCAGCTTATTA
s2_F_1955_GACTGTTCCT	AATGATACGGCGACCACCGAGATCTACACGACTGTTCCTGCTGGTGCTGCAGCTTATTA
s2_F_1956_GAGATCGAAT	AATGATACGGCGACCACCGAGATCTACACGAGATCGAATGCTGGTGCTGCAGCTTATTA
s2_F_1957_GAGCAAGTCA	AATGATACGGCGACCACCGAGATCTACACGAGCAAGTCAGCTGGTGCTGCAGCTTATTA
s2_F_1958_GAGGACATTA	AATGATACGGCGACCACCGAGATCTACACGAGGACATTAGCTGGTGCTGCAGCTTATTA
s2_F_1959_GAGGCATGTT	AATGATACGGCGACCACCGAGATCTACACGAGGCATGTTGCTGGTGCTGCAGCTTATTA
s2_F_1960_GAGTACGACT	AATGATACGGCGACCACCGAGATCTACACGAGTACGACTGCTGGTGCTGCAGCTTATTA
s2_F_1961_GATCTTGCCT	AATGATACGGCGACCACCGAGATCTACACGATCTTGCCTGCTGGTGCTGCAGCTTATTA
s2_F_1962_GATGCTCATG	AATGATACGGCGACCACCGAGATCTACACGATGCTCATGGCTGGTGCTGCAGCTTATTA
s2_F_1963_GATTCATTCC	AATGATACGGCGACCACCGAGATCTACACGATTCATTCCGCTGGTGCTGCAGCTTATTA
s2_F_1964_GATTCCTCAA	AATGATACGGCGACCACCGAGATCTACACGATTCCTCAAGCTGGTGCTGCAGCTTATTA
s2_F_1965_GCAGCTAAGG	AATGATACGGCGACCACCGAGATCTACACGCAGCTAAGGGCTGGTGCTGCAGCTTATTA
s2_F_1966_GCAGTCCAAT	AATGATACGGCGACCACCGAGATCTACACGCAGTCCAATGCTGGTGCTGCAGCTTATTA
s2_F_1967_GCTACAGTCT	AATGATACGGCGACCACCGAGATCTACACGCTACAGTCTGCTGGTGCTGCAGCTTATTA
s2_F_1968_GTACACCTAG	AATGATACGGCGACCACCGAGATCTACACGTACACCTAGGCTGGTGCTGCAGCTTATTA
s2_F_1969_GTACTAGTTG	AATGATACGGCGACCACCGAGATCTACACGTACTAGTTGGCTGGTGCTGCAGCTTATTA
s2_F_1970_GTCTAACAGA	AATGATACGGCGACCACCGAGATCTACACGTCTAACAGAGCTGGTGCTGCAGCTTATTA
s2_F_1971_GTTCATCAAG	AATGATACGGCGACCACCGAGATCTACACGTTCATCAAGGCTGGTGCTGCAGCTTATTA
s2_F_1972_TAGGAGAATG	AATGATACGGCGACCACCGAGATCTACACTAGGAGAATGGCTGGTGCTGCAGCTTATTA
s2_F_1973_TCAGGACTTA	AATGATACGGCGACCACCGAGATCTACACTCAGGACTTAGCTGGTGCTGCAGCTTATTA
s2_F_1974_TCAGTACCTG	AATGATACGGCGACCACCGAGATCTACACTCAGTACCTGGCTGGTGCTGCAGCTTATTA
s2_F_1975_GTCTTCACTA	AATGATACGGCGACCACCGAGATCTACACGTCTTCACTAGCTGGTGCTGCAGCTTATTA
s2_F_1976_AAGAGGACAG	AATGATACGGCGACCACCGAGATCTACACAAGAGGACAGGCTGGTGCTGCAGCTTATTA
s2_F_1977_ATCTAGGACC	AATGATACGGCGACCACCGAGATCTACACATCTAGGACCGCTGGTGCTGCAGCTTATTA
s2_F_1978_GAGACCTAAC	AATGATACGGCGACCACCGAGATCTACACGAGACCTAACGCTGGTGCTGCAGCTTATTA
s2_F_1979_ACTCCATGGA	AATGATACGGCGACCACCGAGATCTACACACTCCATGGAGCTGGTGCTGCAGCTTATTA
s2_F_1980_CGACAAGTCG	AATGATACGGCGACCACCGAGATCTACACCGACAAGTCGGCTGGTGCTGCAGCTTATTA
s2_F_1981_AAGCAACTAC	AATGATACGGCGACCACCGAGATCTACACAAGCAACTACGCTGGTGCTGCAGCTTATTA
s2_F_1982_ACGAGTATAC	AATGATACGGCGACCACCGAGATCTACACACGAGTATACGCTGGTGCTGCAGCTTATTA
s2_F_1983_AGTTCCTGAC	AATGATACGGCGACCACCGAGATCTACACAGTTCCTGACGCTGGTGCTGCAGCTTATTA
s2_F_1984_CAACCTTAAC	AATGATACGGCGACCACCGAGATCTACACCAACCTTAACGCTGGTGCTGCAGCTTATTA
s2_F_1985_CACATTGTAC	AATGATACGGCGACCACCGAGATCTACACCACATTGTACGCTGGTGCTGCAGCTTATTA
s2_F_1986_CAGACAACAC	AATGATACGGCGACCACCGAGATCTACACCAGACAACACGCTGGTGCTGCAGCTTATTA
s2_F_1987_CATTACTGAC	AATGATACGGCGACCACCGAGATCTACACCATTACTGACGCTGGTGCTGCAGCTTATTA
s2_F_1988_CCACACCAAC	AATGATACGGCGACCACCGAGATCTACACCCACACCAACGCTGGTGCTGCAGCTTATTA
s2_F_1989_CTCCGACTAC	AATGATACGGCGACCACCGAGATCTACACCTCCGACTACGCTGGTGCTGCAGCTTATTA
s2_F_1990_GAACCACTAC	AATGATACGGCGACCACCGAGATCTACACGAACCACTACGCTGGTGCTGCAGCTTATTA
s2_F_1991_GACGTGTTAC	AATGATACGGCGACCACCGAGATCTACACGACGTGTTACGCTGGTGCTGCAGCTTATTA
s2_F_1992_GCCAGATCAC	AATGATACGGCGACCACCGAGATCTACACGCCAGATCACGCTGGTGCTGCAGCTTATTA
s2_F_1993_GCCATAAGAC	AATGATACGGCGACCACCGAGATCTACACGCCATAAGACGCTGGTGCTGCAGCTTATTA
s2_F_1994_GGTTGAAGAC	AATGATACGGCGACCACCGAGATCTACACGGTTGAAGACGCTGGTGCTGCAGCTTATTA
s2_F_1995_TCTACTCTAG	AATGATACGGCGACCACCGAGATCTACACTCTACTCTAGGCTGGTGCTGCAGCTTATTA
s2_F_1996_CGCAACAGAC	AATGATACGGCGACCACCGAGATCTACACCGCAACAGACGCTGGTGCTGCAGCTTATTA
s2_F_1997_AACACGAGGC	AATGATACGGCGACCACCGAGATCTACACAACACGAGGCGCTGGTGCTGCAGCTTATTA
s2_F_1998_AACCTAGCTG	AATGATACGGCGACCACCGAGATCTACACAACCTAGCTGGCTGGTGCTGCAGCTTATTA
s2_F_1999_CCAAGCATAT	AATGATACGGCGACCACCGAGATCTACACCCAAGCATATGCTGGTGCTGCAGCTTATTA
s2_F_2000_ATTATCTGCC	AATGATACGGCGACCACCGAGATCTACACATTATCTGCCGCTGGTGCTGCAGCTTATTA
s2_F_2001_ACGCTAATAC	AATGATACGGCGACCACCGAGATCTACACACGCTAATACGCTGGTGCTGCAGCTTATTA
s2_F_2002_ATAAGCTGAC	AATGATACGGCGACCACCGAGATCTACACATAAGCTGACGCTGGTGCTGCAGCTTATTA
s2_F_2003_GCTACCGGAA	AATGATACGGCGACCACCGAGATCTACACGCTACCGGAAGCTGGTGCTGCAGCTTATTA
s2_F_2004_AAGGTCGAAG	AATGATACGGCGACCACCGAGATCTACACAAGGTCGAAGGCTGGTGCTGCAGCTTATTA
s2_F_2005_CAATCCGTAC	AATGATACGGCGACCACCGAGATCTACACCAATCCGTACGCTGGTGCTGCAGCTTATTA
s2_F_2006_AAGTCGCATC	AATGATACGGCGACCACCGAGATCTACACAAGTCGCATCGCTGGTGCTGCAGCTTATTA
s2_F_2007_ATAACTGGTC	AATGATACGGCGACCACCGAGATCTACACATAACTGGTCGCTGGTGCTGCAGCTTATTA
s2_F_2008_AAGAACGCTA	AATGATACGGCGACCACCGAGATCTACACAAGAACGCTAGCTGGTGCTGCAGCTTATTA
s2_F_2009_ACCGGTGACT	AATGATACGGCGACCACCGAGATCTACACACCGGTGACTGCTGGTGCTGCAGCTTATTA
s2_F_2010_AACACATCTC	AATGATACGGCGACCACCGAGATCTACACAACACATCTCGCTGGTGCTGCAGCTTATTA
s2_F_2011_ACAGAAGGCC	AATGATACGGCGACCACCGAGATCTACACACAGAAGGCCGCTGGTGCTGCAGCTTATTA
s2_F_2012_ATAGTTGGCC	AATGATACGGCGACCACCGAGATCTACACATAGTTGGCCGCTGGTGCTGCAGCTTATTA
s2_F_2013_AGGTCGACAA	AATGATACGGCGACCACCGAGATCTACACAGGTCGACAAGCTGGTGCTGCAGCTTATTA
s2_F_2014_ACAAGGCCTC	AATGATACGGCGACCACCGAGATCTACACACAAGGCCTCGCTGGTGCTGCAGCTTATTA
s2_F_2015_ACGGTTCCTC	AATGATACGGCGACCACCGAGATCTACACACGGTTCCTCGCTGGTGCTGCAGCTTATTA
s2_F_2016_GACGGTATTC	AATGATACGGCGACCACCGAGATCTACACGACGGTATTCGCTGGTGCTGCAGCTTATTA
s2_F_2017_ACTGCGCAAC	AATGATACGGCGACCACCGAGATCTACACACTGCGCAACGCTGGTGCTGCAGCTTATTA
s2_F_2018_AAGCTGGACG	AATGATACGGCGACCACCGAGATCTACACAAGCTGGACGGCTGGTGCTGCAGCTTATTA
s2_F_2019_ACTGATGGTC	AATGATACGGCGACCACCGAGATCTACACACTGATGGTCGCTGGTGCTGCAGCTTATTA
s2_F_2020_CGAGACGCTA	AATGATACGGCGACCACCGAGATCTACACCGAGACGCTAGCTGGTGCTGCAGCTTATTA
s2_F_2021_ATGTCAACTC	AATGATACGGCGACCACCGAGATCTACACATGTCAACTCGCTGGTGCTGCAGCTTATTA
s2_F_2022_AGATTGCACC	AATGATACGGCGACCACCGAGATCTACACAGATTGCACCGCTGGTGCTGCAGCTTATTA
s2_F_2023_ACCACTGCAG	AATGATACGGCGACCACCGAGATCTACACACCACTGCAGGCTGGTGCTGCAGCTTATTA
s2_F_2024_AAGTGGACTC	AATGATACGGCGACCACCGAGATCTACACAAGTGGACTCGCTGGTGCTGCAGCTTATTA
