s2_R_1_CATCTGTATC	CAAGCAGAAGACGGCATACGAGATCATCTGTATCAGGGTCAAGTGCACAGTCTA
s2_R_2_GAGGCTTAGA	CAAGCAGAAGACGGCATACGAGATGAGGCTTAGAAGGGTCAAGTGCACAGTCTA
s2_R_3_CTGTCCGTTC	CAAGCAGAAGACGGCATACGAGATCTGTCCGTTCAGGGTCAAGTGCACAGTCTA
s2_R_4_GTAACATCGT	CAAGCAGAAGACGGCATACGAGATGTAACATCGTAGGGTCAAGTGCACAGTCTA
s2_R_5_CCACCTTGGT	CAAGCAGAAGACGGCATACGAGATCCACCTTGGTAGGGTCAAGTGCACAGTCTA
s2_R_6_CTACAAGAGT	CAAGCAGAAGACGGCATACGAGATCTACAAGAGTAGGGTCAAGTGCACAGTCTA
s2_R_7_CCTTGTAGCT	CAAGCAGAAGACGGCATACGAGATCCTTGTAGCTAGGGTCAAGTGCACAGTCTA
s2_R_8_GTCTCAGTAG	CAAGCAGAAGACGGCATACGAGATGTCTCAGTAGAGGGTCAAGTGCACAGTCTA
s2_R_9_GTTCTGTACT	CAAGCAGAAGACGGCATACGAGATGTTCTGTACTAGGGTCAAGTGCACAGTCTA
s2_R_10_TGTACGCCTA	CAAGCAGAAGACGGCATACGAGATTGTACGCCTAAGGGTCAAGTGCACAGTCTA
s2_R_11_CTAGAGCAGT	CAAGCAGAAGACGGCATACGAGATCTAGAGCAGTAGGGTCAAGTGCACAGTCTA
s2_R_12_TTCTGGTAGG	CAAGCAGAAGACGGCATACGAGATTTCTGGTAGGAGGGTCAAGTGCACAGTCTA
s2_R_13_GTCTTGTAAG	CAAGCAGAAGACGGCATACGAGATGTCTTGTAAGAGGGTCAAGTGCACAGTCTA
s2_R_14_CATGTCAGTC	CAAGCAGAAGACGGCATACGAGATCATGTCAGTCAGGGTCAAGTGCACAGTCTA
s2_R_15_TTCCGTATAG	CAAGCAGAAGACGGCATACGAGATTTCCGTATAGAGGGTCAAGTGCACAGTCTA
s2_R_16_CTACAGTGAC	CAAGCAGAAGACGGCATACGAGATCTACAGTGACAGGGTCAAGTGCACAGTCTA
s2_R_17_TTAATCCGGT	CAAGCAGAAGACGGCATACGAGATTTAATCCGGTAGGGTCAAGTGCACAGTCTA
s2_R_18_CTACTGTTGT	CAAGCAGAAGACGGCATACGAGATCTACTGTTGTAGGGTCAAGTGCACAGTCTA
s2_R_19_CCAGTGAGTC	CAAGCAGAAGACGGCATACGAGATCCAGTGAGTCAGGGTCAAGTGCACAGTCTA
s2_R_20_CATGTAACAC	CAAGCAGAAGACGGCATACGAGATCATGTAACACAGGGTCAAGTGCACAGTCTA
s2_R_21_CGGTAGCTTG	CAAGCAGAAGACGGCATACGAGATCGGTAGCTTGAGGGTCAAGTGCACAGTCTA
s2_R_22_CTGTGTAACA	CAAGCAGAAGACGGCATACGAGATCTGTGTAACAAGGGTCAAGTGCACAGTCTA
s2_R_23_AGACTCATAC	CAAGCAGAAGACGGCATACGAGATAGACTCATACAGGGTCAAGTGCACAGTCTA
s2_R_24_TTAGTGCGAG	CAAGCAGAAGACGGCATACGAGATTTAGTGCGAGAGGGTCAAGTGCACAGTCTA
s2_R_25_CACAACGTAG	CAAGCAGAAGACGGCATACGAGATCACAACGTAGAGGGTCAAGTGCACAGTCTA
s2_R_26_ATCAACGCTG	CAAGCAGAAGACGGCATACGAGATATCAACGCTGAGGGTCAAGTGCACAGTCTA
s2_R_27_GAAGGTAGCT	CAAGCAGAAGACGGCATACGAGATGAAGGTAGCTAGGGTCAAGTGCACAGTCTA
s2_R_28_CCAGATGGAC	CAAGCAGAAGACGGCATACGAGATCCAGATGGACAGGGTCAAGTGCACAGTCTA
s2_R_29_CGGATCGTAG	CAAGCAGAAGACGGCATACGAGATCGGATCGTAGAGGGTCAAGTGCACAGTCTA
s2_R_30_GTTCGATGGA	CAAGCAGAAGACGGCATACGAGATGTTCGATGGAAGGGTCAAGTGCACAGTCTA
s2_R_31_CAGTCGGCTT	CAAGCAGAAGACGGCATACGAGATCAGTCGGCTTAGGGTCAAGTGCACAGTCTA
s2_R_32_GGTGCCTCTT	CAAGCAGAAGACGGCATACGAGATGGTGCCTCTTAGGGTCAAGTGCACAGTCTA
s2_R_33_TTCTGGCTAT	CAAGCAGAAGACGGCATACGAGATTTCTGGCTATAGGGTCAAGTGCACAGTCTA
s2_R_34_CATTCGTCGT	CAAGCAGAAGACGGCATACGAGATCATTCGTCGTAGGGTCAAGTGCACAGTCTA
s2_R_35_GCGTAGTTCA	CAAGCAGAAGACGGCATACGAGATGCGTAGTTCAAGGGTCAAGTGCACAGTCTA
s2_R_36_TCCGCGTACT	CAAGCAGAAGACGGCATACGAGATTCCGCGTACTAGGGTCAAGTGCACAGTCTA
s2_R_37_CTACCGTGTT	CAAGCAGAAGACGGCATACGAGATCTACCGTGTTAGGGTCAAGTGCACAGTCTA
s2_R_38_CTTCTTGTAC	CAAGCAGAAGACGGCATACGAGATCTTCTTGTACAGGGTCAAGTGCACAGTCTA
s2_R_39_GGACTCTTGT	CAAGCAGAAGACGGCATACGAGATGGACTCTTGTAGGGTCAAGTGCACAGTCTA
s2_R_40_CAATACTGGT	CAAGCAGAAGACGGCATACGAGATCAATACTGGTAGGGTCAAGTGCACAGTCTA
s2_R_41_GTAGTGTTCT	CAAGCAGAAGACGGCATACGAGATGTAGTGTTCTAGGGTCAAGTGCACAGTCTA
s2_R_42_CCGACTAGGT	CAAGCAGAAGACGGCATACGAGATCCGACTAGGTAGGGTCAAGTGCACAGTCTA
s2_R_43_CCAACAATGT	CAAGCAGAAGACGGCATACGAGATCCAACAATGTAGGGTCAAGTGCACAGTCTA
s2_R_44_TACTGTACGT	CAAGCAGAAGACGGCATACGAGATTACTGTACGTAGGGTCAAGTGCACAGTCTA
s2_R_45_ATGTCTGGTG	CAAGCAGAAGACGGCATACGAGATATGTCTGGTGAGGGTCAAGTGCACAGTCTA
s2_R_46_GTCACGGCTT	CAAGCAGAAGACGGCATACGAGATGTCACGGCTTAGGGTCAAGTGCACAGTCTA
s2_R_47_GTTCATCCGT	CAAGCAGAAGACGGCATACGAGATGTTCATCCGTAGGGTCAAGTGCACAGTCTA
s2_R_48_ATGGACTCCG	CAAGCAGAAGACGGCATACGAGATATGGACTCCGAGGGTCAAGTGCACAGTCTA
s2_R_49_CCGTGTTACG	CAAGCAGAAGACGGCATACGAGATCCGTGTTACGAGGGTCAAGTGCACAGTCTA
s2_R_50_TTCATGCGGA	CAAGCAGAAGACGGCATACGAGATTTCATGCGGAAGGGTCAAGTGCACAGTCTA
s2_R_51_CACAGTGTCT	CAAGCAGAAGACGGCATACGAGATCACAGTGTCTAGGGTCAAGTGCACAGTCTA
s2_R_52_CGGTTATGAT	CAAGCAGAAGACGGCATACGAGATCGGTTATGATAGGGTCAAGTGCACAGTCTA
s2_R_53_CCTATGTAGA	CAAGCAGAAGACGGCATACGAGATCCTATGTAGAAGGGTCAAGTGCACAGTCTA
s2_R_54_CCACTATTGG	CAAGCAGAAGACGGCATACGAGATCCACTATTGGAGGGTCAAGTGCACAGTCTA
s2_R_55_TAATGCGTGA	CAAGCAGAAGACGGCATACGAGATTAATGCGTGAAGGGTCAAGTGCACAGTCTA
s2_R_56_TAGGTGCGTT	CAAGCAGAAGACGGCATACGAGATTAGGTGCGTTAGGGTCAAGTGCACAGTCTA
s2_R_57_CTACCGTAGC	CAAGCAGAAGACGGCATACGAGATCTACCGTAGCAGGGTCAAGTGCACAGTCTA
s2_R_58_TGGTCTTAGG	CAAGCAGAAGACGGCATACGAGATTGGTCTTAGGAGGGTCAAGTGCACAGTCTA
s2_R_59_GGTTCTTCGT	CAAGCAGAAGACGGCATACGAGATGGTTCTTCGTAGGGTCAAGTGCACAGTCTA
s2_R_60_TGAGCGTGTT	CAAGCAGAAGACGGCATACGAGATTGAGCGTGTTAGGGTCAAGTGCACAGTCTA
s2_R_61_GTACAGCGGT	CAAGCAGAAGACGGCATACGAGATGTACAGCGGTAGGGTCAAGTGCACAGTCTA
s2_R_62_TAGCACGGTT	CAAGCAGAAGACGGCATACGAGATTAGCACGGTTAGGGTCAAGTGCACAGTCTA
s2_R_63_CTAAGTCGTT	CAAGCAGAAGACGGCATACGAGATCTAAGTCGTTAGGGTCAAGTGCACAGTCTA
s2_R_64_TCAACCTGGT	CAAGCAGAAGACGGCATACGAGATTCAACCTGGTAGGGTCAAGTGCACAGTCTA
s2_R_65_AGGCACGAGT	CAAGCAGAAGACGGCATACGAGATAGGCACGAGTAGGGTCAAGTGCACAGTCTA
s2_R_66_TCCGGATGGT	CAAGCAGAAGACGGCATACGAGATTCCGGATGGTAGGGTCAAGTGCACAGTCTA
s2_R_67_TTGTCGGCCT	CAAGCAGAAGACGGCATACGAGATTTGTCGGCCTAGGGTCAAGTGCACAGTCTA
s2_R_68_TACTAGCTGT	CAAGCAGAAGACGGCATACGAGATTACTAGCTGTAGGGTCAAGTGCACAGTCTA
s2_R_69_TCGTGTCTCC	CAAGCAGAAGACGGCATACGAGATTCGTGTCTCCAGGGTCAAGTGCACAGTCTA
s2_R_70_ACGTGCGTAG	CAAGCAGAAGACGGCATACGAGATACGTGCGTAGAGGGTCAAGTGCACAGTCTA
s2_R_71_TCAGAGCTGT	CAAGCAGAAGACGGCATACGAGATTCAGAGCTGTAGGGTCAAGTGCACAGTCTA
s2_R_72_AGTCTCCTGT	CAAGCAGAAGACGGCATACGAGATAGTCTCCTGTAGGGTCAAGTGCACAGTCTA
s2_R_73_GATACTCTGT	CAAGCAGAAGACGGCATACGAGATGATACTCTGTAGGGTCAAGTGCACAGTCTA
s2_R_74_CTACGCCACT	CAAGCAGAAGACGGCATACGAGATCTACGCCACTAGGGTCAAGTGCACAGTCTA
s2_R_75_CCTGGATAGT	CAAGCAGAAGACGGCATACGAGATCCTGGATAGTAGGGTCAAGTGCACAGTCTA
s2_R_76_GTACTTAGGT	CAAGCAGAAGACGGCATACGAGATGTACTTAGGTAGGGTCAAGTGCACAGTCTA
s2_R_77_TGTTCGCTAT	CAAGCAGAAGACGGCATACGAGATTGTTCGCTATAGGGTCAAGTGCACAGTCTA
s2_R_78_CTAGCCTTGT	CAAGCAGAAGACGGCATACGAGATCTAGCCTTGTAGGGTCAAGTGCACAGTCTA
s2_R_79_TCCTGAGGTA	CAAGCAGAAGACGGCATACGAGATTCCTGAGGTAAGGGTCAAGTGCACAGTCTA
s2_R_80_TCGTAAGTAG	CAAGCAGAAGACGGCATACGAGATTCGTAAGTAGAGGGTCAAGTGCACAGTCTA
s2_R_81_TTGAGTCGAA	CAAGCAGAAGACGGCATACGAGATTTGAGTCGAAAGGGTCAAGTGCACAGTCTA
s2_R_82_GTGACCGATC	CAAGCAGAAGACGGCATACGAGATGTGACCGATCAGGGTCAAGTGCACAGTCTA
s2_R_83_TCGCCATGAT	CAAGCAGAAGACGGCATACGAGATTCGCCATGATAGGGTCAAGTGCACAGTCTA
s2_R_84_TAGTAGTCTG	CAAGCAGAAGACGGCATACGAGATTAGTAGTCTGAGGGTCAAGTGCACAGTCTA
s2_R_85_ACGGAATTCT	CAAGCAGAAGACGGCATACGAGATACGGAATTCTAGGGTCAAGTGCACAGTCTA
s2_R_86_CCTATTGGAA	CAAGCAGAAGACGGCATACGAGATCCTATTGGAAAGGGTCAAGTGCACAGTCTA
s2_R_87_TGTGGATCGT	CAAGCAGAAGACGGCATACGAGATTGTGGATCGTAGGGTCAAGTGCACAGTCTA
s2_R_88_CGCCATGTTG	CAAGCAGAAGACGGCATACGAGATCGCCATGTTGAGGGTCAAGTGCACAGTCTA
s2_R_89_GTCAGATCCG	CAAGCAGAAGACGGCATACGAGATGTCAGATCCGAGGGTCAAGTGCACAGTCTA
s2_R_90_TCGCAGCCTT	CAAGCAGAAGACGGCATACGAGATTCGCAGCCTTAGGGTCAAGTGCACAGTCTA
s2_R_91_CTTGCTCTGT	CAAGCAGAAGACGGCATACGAGATCTTGCTCTGTAGGGTCAAGTGCACAGTCTA
s2_R_92_CGTGTATTAC	CAAGCAGAAGACGGCATACGAGATCGTGTATTACAGGGTCAAGTGCACAGTCTA
s2_R_93_TCCATCTTGT	CAAGCAGAAGACGGCATACGAGATTCCATCTTGTAGGGTCAAGTGCACAGTCTA
s2_R_94_TGCAGACGTA	CAAGCAGAAGACGGCATACGAGATTGCAGACGTAAGGGTCAAGTGCACAGTCTA
s2_R_95_CTCCGTAACC	CAAGCAGAAGACGGCATACGAGATCTCCGTAACCAGGGTCAAGTGCACAGTCTA
s2_R_96_CAGATTCTGT	CAAGCAGAAGACGGCATACGAGATCAGATTCTGTAGGGTCAAGTGCACAGTCTA
s2_R_97_CCATTCATGT	CAAGCAGAAGACGGCATACGAGATCCATTCATGTAGGGTCAAGTGCACAGTCTA
s2_R_98_CTAACGACGT	CAAGCAGAAGACGGCATACGAGATCTAACGACGTAGGGTCAAGTGCACAGTCTA
s2_R_99_CCAGAGTCTT	CAAGCAGAAGACGGCATACGAGATCCAGAGTCTTAGGGTCAAGTGCACAGTCTA
s2_R_100_GTTGAGTCTT	CAAGCAGAAGACGGCATACGAGATGTTGAGTCTTAGGGTCAAGTGCACAGTCTA
s2_R_101_GCGATCTCCA	CAAGCAGAAGACGGCATACGAGATGCGATCTCCAAGGGTCAAGTGCACAGTCTA
s2_R_102_TCGGCATACG	CAAGCAGAAGACGGCATACGAGATTCGGCATACGAGGGTCAAGTGCACAGTCTA
s2_R_103_CGGACTTCAT	CAAGCAGAAGACGGCATACGAGATCGGACTTCATAGGGTCAAGTGCACAGTCTA
s2_R_104_GATGTATCCG	CAAGCAGAAGACGGCATACGAGATGATGTATCCGAGGGTCAAGTGCACAGTCTA
s2_R_105_CTGTGATACC	CAAGCAGAAGACGGCATACGAGATCTGTGATACCAGGGTCAAGTGCACAGTCTA
s2_R_106_AGAGCTTGAC	CAAGCAGAAGACGGCATACGAGATAGAGCTTGACAGGGTCAAGTGCACAGTCTA
s2_R_107_CTTCTACTGG	CAAGCAGAAGACGGCATACGAGATCTTCTACTGGAGGGTCAAGTGCACAGTCTA
s2_R_108_AGATTCGGCT	CAAGCAGAAGACGGCATACGAGATAGATTCGGCTAGGGTCAAGTGCACAGTCTA
s2_R_109_TGAGGTGATC	CAAGCAGAAGACGGCATACGAGATTGAGGTGATCAGGGTCAAGTGCACAGTCTA
s2_R_110_GACCAACTGT	CAAGCAGAAGACGGCATACGAGATGACCAACTGTAGGGTCAAGTGCACAGTCTA
s2_R_111_CGAATTGGCT	CAAGCAGAAGACGGCATACGAGATCGAATTGGCTAGGGTCAAGTGCACAGTCTA
s2_R_112_TCTGTGGTAG	CAAGCAGAAGACGGCATACGAGATTCTGTGGTAGAGGGTCAAGTGCACAGTCTA
s2_R_113_CTAGACCGTA	CAAGCAGAAGACGGCATACGAGATCTAGACCGTAAGGGTCAAGTGCACAGTCTA
s2_R_114_TGGATTCCGA	CAAGCAGAAGACGGCATACGAGATTGGATTCCGAAGGGTCAAGTGCACAGTCTA
s2_R_115_GGTGCGAATG	CAAGCAGAAGACGGCATACGAGATGGTGCGAATGAGGGTCAAGTGCACAGTCTA
s2_R_116_TTGACGTAGA	CAAGCAGAAGACGGCATACGAGATTTGACGTAGAAGGGTCAAGTGCACAGTCTA
s2_R_117_GCGTGATGTC	CAAGCAGAAGACGGCATACGAGATGCGTGATGTCAGGGTCAAGTGCACAGTCTA
s2_R_118_CCAACGGCTA	CAAGCAGAAGACGGCATACGAGATCCAACGGCTAAGGGTCAAGTGCACAGTCTA
s2_R_119_CCTGTCTTGG	CAAGCAGAAGACGGCATACGAGATCCTGTCTTGGAGGGTCAAGTGCACAGTCTA
s2_R_120_CCACTAGATG	CAAGCAGAAGACGGCATACGAGATCCACTAGATGAGGGTCAAGTGCACAGTCTA
s2_R_121_CATCGTTGGC	CAAGCAGAAGACGGCATACGAGATCATCGTTGGCAGGGTCAAGTGCACAGTCTA
s2_R_122_GTAGTCTAGT	CAAGCAGAAGACGGCATACGAGATGTAGTCTAGTAGGGTCAAGTGCACAGTCTA
s2_R_123_TCTCAGTGGC	CAAGCAGAAGACGGCATACGAGATTCTCAGTGGCAGGGTCAAGTGCACAGTCTA
s2_R_124_GACCACGTTG	CAAGCAGAAGACGGCATACGAGATGACCACGTTGAGGGTCAAGTGCACAGTCTA
s2_R_125_TGTTCGTGGC	CAAGCAGAAGACGGCATACGAGATTGTTCGTGGCAGGGTCAAGTGCACAGTCTA
s2_R_126_ATTGGTTCCA	CAAGCAGAAGACGGCATACGAGATATTGGTTCCAAGGGTCAAGTGCACAGTCTA
s2_R_127_CCTTCAACGT	CAAGCAGAAGACGGCATACGAGATCCTTCAACGTAGGGTCAAGTGCACAGTCTA
s2_R_128_CGTACGTAAC	CAAGCAGAAGACGGCATACGAGATCGTACGTAACAGGGTCAAGTGCACAGTCTA
s2_R_129_ATGTGCTCCT	CAAGCAGAAGACGGCATACGAGATATGTGCTCCTAGGGTCAAGTGCACAGTCTA
s2_R_130_GAGTAGCCTC	CAAGCAGAAGACGGCATACGAGATGAGTAGCCTCAGGGTCAAGTGCACAGTCTA
s2_R_131_CTTCCATGAT	CAAGCAGAAGACGGCATACGAGATCTTCCATGATAGGGTCAAGTGCACAGTCTA
s2_R_132_TGGCACTGGT	CAAGCAGAAGACGGCATACGAGATTGGCACTGGTAGGGTCAAGTGCACAGTCTA
s2_R_133_AGTTGTGATC	CAAGCAGAAGACGGCATACGAGATAGTTGTGATCAGGGTCAAGTGCACAGTCTA
s2_R_134_TACACTGTTC	CAAGCAGAAGACGGCATACGAGATTACACTGTTCAGGGTCAAGTGCACAGTCTA
s2_R_135_CGGACGAATC	CAAGCAGAAGACGGCATACGAGATCGGACGAATCAGGGTCAAGTGCACAGTCTA
s2_R_136_CCAAGATCCG	CAAGCAGAAGACGGCATACGAGATCCAAGATCCGAGGGTCAAGTGCACAGTCTA
s2_R_137_GAGAGAATGT	CAAGCAGAAGACGGCATACGAGATGAGAGAATGTAGGGTCAAGTGCACAGTCTA
s2_R_138_GCGACGATTC	CAAGCAGAAGACGGCATACGAGATGCGACGATTCAGGGTCAAGTGCACAGTCTA
s2_R_139_TGTACATCTG	CAAGCAGAAGACGGCATACGAGATTGTACATCTGAGGGTCAAGTGCACAGTCTA
s2_R_140_GGCTTAGTCT	CAAGCAGAAGACGGCATACGAGATGGCTTAGTCTAGGGTCAAGTGCACAGTCTA
s2_R_141_CTTCAGGATC	CAAGCAGAAGACGGCATACGAGATCTTCAGGATCAGGGTCAAGTGCACAGTCTA
s2_R_142_TCTTCCTTGT	CAAGCAGAAGACGGCATACGAGATTCTTCCTTGTAGGGTCAAGTGCACAGTCTA
s2_R_143_CGACATGACT	CAAGCAGAAGACGGCATACGAGATCGACATGACTAGGGTCAAGTGCACAGTCTA
s2_R_144_AGTTCGGATT	CAAGCAGAAGACGGCATACGAGATAGTTCGGATTAGGGTCAAGTGCACAGTCTA
s2_R_145_TACATCGTTG	CAAGCAGAAGACGGCATACGAGATTACATCGTTGAGGGTCAAGTGCACAGTCTA
s2_R_146_ATTCCGACTC	CAAGCAGAAGACGGCATACGAGATATTCCGACTCAGGGTCAAGTGCACAGTCTA
s2_R_147_CTTCTCAAGT	CAAGCAGAAGACGGCATACGAGATCTTCTCAAGTAGGGTCAAGTGCACAGTCTA
s2_R_148_GAATCACGGA	CAAGCAGAAGACGGCATACGAGATGAATCACGGAAGGGTCAAGTGCACAGTCTA
s2_R_149_CTGAGATGAC	CAAGCAGAAGACGGCATACGAGATCTGAGATGACAGGGTCAAGTGCACAGTCTA
s2_R_150_CTATGGATGT	CAAGCAGAAGACGGCATACGAGATCTATGGATGTAGGGTCAAGTGCACAGTCTA
s2_R_151_CCATCGAGAG	CAAGCAGAAGACGGCATACGAGATCCATCGAGAGAGGGTCAAGTGCACAGTCTA
s2_R_152_TCGCCTTCAG	CAAGCAGAAGACGGCATACGAGATTCGCCTTCAGAGGGTCAAGTGCACAGTCTA
s2_R_153_CCTATCGACA	CAAGCAGAAGACGGCATACGAGATCCTATCGACAAGGGTCAAGTGCACAGTCTA
s2_R_154_CAATCCGGTT	CAAGCAGAAGACGGCATACGAGATCAATCCGGTTAGGGTCAAGTGCACAGTCTA
s2_R_155_TGTCGGATTA	CAAGCAGAAGACGGCATACGAGATTGTCGGATTAAGGGTCAAGTGCACAGTCTA
s2_R_156_TGCGTAACAT	CAAGCAGAAGACGGCATACGAGATTGCGTAACATAGGGTCAAGTGCACAGTCTA
s2_R_157_TCAACGTTCA	CAAGCAGAAGACGGCATACGAGATTCAACGTTCAAGGGTCAAGTGCACAGTCTA
s2_R_158_TGTGTCTAGA	CAAGCAGAAGACGGCATACGAGATTGTGTCTAGAAGGGTCAAGTGCACAGTCTA
s2_R_159_CCATCTAAGT	CAAGCAGAAGACGGCATACGAGATCCATCTAAGTAGGGTCAAGTGCACAGTCTA
s2_R_160_CCACACAGCT	CAAGCAGAAGACGGCATACGAGATCCACACAGCTAGGGTCAAGTGCACAGTCTA
s2_R_161_CGAGAGTGCT	CAAGCAGAAGACGGCATACGAGATCGAGAGTGCTAGGGTCAAGTGCACAGTCTA
s2_R_162_GAGCCAACAT	CAAGCAGAAGACGGCATACGAGATGAGCCAACATAGGGTCAAGTGCACAGTCTA
s2_R_163_CACTCAGAGT	CAAGCAGAAGACGGCATACGAGATCACTCAGAGTAGGGTCAAGTGCACAGTCTA
s2_R_164_CTCCTAGGAC	CAAGCAGAAGACGGCATACGAGATCTCCTAGGACAGGGTCAAGTGCACAGTCTA
s2_R_165_GACATACGGT	CAAGCAGAAGACGGCATACGAGATGACATACGGTAGGGTCAAGTGCACAGTCTA
s2_R_166_TACCTTGGTA	CAAGCAGAAGACGGCATACGAGATTACCTTGGTAAGGGTCAAGTGCACAGTCTA
s2_R_167_GGAACGGTTA	CAAGCAGAAGACGGCATACGAGATGGAACGGTTAAGGGTCAAGTGCACAGTCTA
s2_R_168_GCATTCGGAC	CAAGCAGAAGACGGCATACGAGATGCATTCGGACAGGGTCAAGTGCACAGTCTA
s2_R_169_TCGTGCTTGG	CAAGCAGAAGACGGCATACGAGATTCGTGCTTGGAGGGTCAAGTGCACAGTCTA
s2_R_170_CTGTCTTATC	CAAGCAGAAGACGGCATACGAGATCTGTCTTATCAGGGTCAAGTGCACAGTCTA
s2_R_171_GGAATGATCT	CAAGCAGAAGACGGCATACGAGATGGAATGATCTAGGGTCAAGTGCACAGTCTA
s2_R_172_GGTTCAATGA	CAAGCAGAAGACGGCATACGAGATGGTTCAATGAAGGGTCAAGTGCACAGTCTA
s2_R_173_GGTAGACGGT	CAAGCAGAAGACGGCATACGAGATGGTAGACGGTAGGGTCAAGTGCACAGTCTA
s2_R_174_ATGTTGCCTC	CAAGCAGAAGACGGCATACGAGATATGTTGCCTCAGGGTCAAGTGCACAGTCTA
s2_R_175_ATGACTCTGG	CAAGCAGAAGACGGCATACGAGATATGACTCTGGAGGGTCAAGTGCACAGTCTA
s2_R_176_CCAACTCCTC	CAAGCAGAAGACGGCATACGAGATCCAACTCCTCAGGGTCAAGTGCACAGTCTA
s2_R_177_GCTATGTGCT	CAAGCAGAAGACGGCATACGAGATGCTATGTGCTAGGGTCAAGTGCACAGTCTA
s2_R_178_TATCATTGCC	CAAGCAGAAGACGGCATACGAGATTATCATTGCCAGGGTCAAGTGCACAGTCTA
s2_R_179_GTGTGGCAAG	CAAGCAGAAGACGGCATACGAGATGTGTGGCAAGAGGGTCAAGTGCACAGTCTA
s2_R_180_GGACGTGTCT	CAAGCAGAAGACGGCATACGAGATGGACGTGTCTAGGGTCAAGTGCACAGTCTA
s2_R_181_TGCGATTATG	CAAGCAGAAGACGGCATACGAGATTGCGATTATGAGGGTCAAGTGCACAGTCTA
s2_R_182_AGCGACTTGT	CAAGCAGAAGACGGCATACGAGATAGCGACTTGTAGGGTCAAGTGCACAGTCTA
s2_R_183_GTGAACGAGA	CAAGCAGAAGACGGCATACGAGATGTGAACGAGAAGGGTCAAGTGCACAGTCTA
s2_R_184_CTGGTAGTCA	CAAGCAGAAGACGGCATACGAGATCTGGTAGTCAAGGGTCAAGTGCACAGTCTA
s2_R_185_GGTAGTCCGA	CAAGCAGAAGACGGCATACGAGATGGTAGTCCGAAGGGTCAAGTGCACAGTCTA
s2_R_186_TTCTAGAGCT	CAAGCAGAAGACGGCATACGAGATTTCTAGAGCTAGGGTCAAGTGCACAGTCTA
s2_R_187_CGCATCGTCT	CAAGCAGAAGACGGCATACGAGATCGCATCGTCTAGGGTCAAGTGCACAGTCTA
s2_R_188_GGTCTGCTAC	CAAGCAGAAGACGGCATACGAGATGGTCTGCTACAGGGTCAAGTGCACAGTCTA
s2_R_189_CTACAAGGCC	CAAGCAGAAGACGGCATACGAGATCTACAAGGCCAGGGTCAAGTGCACAGTCTA
s2_R_190_GATCGTTCTG	CAAGCAGAAGACGGCATACGAGATGATCGTTCTGAGGGTCAAGTGCACAGTCTA
s2_R_191_CGTCGTAGTC	CAAGCAGAAGACGGCATACGAGATCGTCGTAGTCAGGGTCAAGTGCACAGTCTA
s2_R_192_TGTATTCCAC	CAAGCAGAAGACGGCATACGAGATTGTATTCCACAGGGTCAAGTGCACAGTCTA
s2_R_193_CTCCGTAGTA	CAAGCAGAAGACGGCATACGAGATCTCCGTAGTAAGGGTCAAGTGCACAGTCTA
s2_R_194_GTGTCATGAG	CAAGCAGAAGACGGCATACGAGATGTGTCATGAGAGGGTCAAGTGCACAGTCTA
s2_R_195_ACGGCAGACT	CAAGCAGAAGACGGCATACGAGATACGGCAGACTAGGGTCAAGTGCACAGTCTA
s2_R_196_ATAGTGGACA	CAAGCAGAAGACGGCATACGAGATATAGTGGACAAGGGTCAAGTGCACAGTCTA
s2_R_197_GACCAAGACT	CAAGCAGAAGACGGCATACGAGATGACCAAGACTAGGGTCAAGTGCACAGTCTA
s2_R_198_TGATCCGGAG	CAAGCAGAAGACGGCATACGAGATTGATCCGGAGAGGGTCAAGTGCACAGTCTA
s2_R_199_CTCCAGAAGT	CAAGCAGAAGACGGCATACGAGATCTCCAGAAGTAGGGTCAAGTGCACAGTCTA
s2_R_200_GGAATCGTAA	CAAGCAGAAGACGGCATACGAGATGGAATCGTAAAGGGTCAAGTGCACAGTCTA
s2_R_201_CCTTATCTGT	CAAGCAGAAGACGGCATACGAGATCCTTATCTGTAGGGTCAAGTGCACAGTCTA
s2_R_202_GTCTCTGCGA	CAAGCAGAAGACGGCATACGAGATGTCTCTGCGAAGGGTCAAGTGCACAGTCTA
s2_R_203_CCTACGGAAT	CAAGCAGAAGACGGCATACGAGATCCTACGGAATAGGGTCAAGTGCACAGTCTA
s2_R_204_CCACGTTATG	CAAGCAGAAGACGGCATACGAGATCCACGTTATGAGGGTCAAGTGCACAGTCTA
s2_R_205_GAACATGCTC	CAAGCAGAAGACGGCATACGAGATGAACATGCTCAGGGTCAAGTGCACAGTCTA
s2_R_206_AAGTGAAGCC	CAAGCAGAAGACGGCATACGAGATAAGTGAAGCCAGGGTCAAGTGCACAGTCTA
s2_R_207_CTCTAACTGT	CAAGCAGAAGACGGCATACGAGATCTCTAACTGTAGGGTCAAGTGCACAGTCTA
s2_R_208_CTTCTCACTA	CAAGCAGAAGACGGCATACGAGATCTTCTCACTAAGGGTCAAGTGCACAGTCTA
s2_R_209_GAGGAGTGTC	CAAGCAGAAGACGGCATACGAGATGAGGAGTGTCAGGGTCAAGTGCACAGTCTA
s2_R_210_GTTGCGGTGA	CAAGCAGAAGACGGCATACGAGATGTTGCGGTGAAGGGTCAAGTGCACAGTCTA
s2_R_211_TGCACATCGT	CAAGCAGAAGACGGCATACGAGATTGCACATCGTAGGGTCAAGTGCACAGTCTA
s2_R_212_GTACCGATGT	CAAGCAGAAGACGGCATACGAGATGTACCGATGTAGGGTCAAGTGCACAGTCTA
s2_R_213_GTTCGACTTA	CAAGCAGAAGACGGCATACGAGATGTTCGACTTAAGGGTCAAGTGCACAGTCTA
s2_R_214_TAGTCATCTC	CAAGCAGAAGACGGCATACGAGATTAGTCATCTCAGGGTCAAGTGCACAGTCTA
s2_R_215_GAGTTGTGCC	CAAGCAGAAGACGGCATACGAGATGAGTTGTGCCAGGGTCAAGTGCACAGTCTA
s2_R_216_CAAGGTCGTA	CAAGCAGAAGACGGCATACGAGATCAAGGTCGTAAGGGTCAAGTGCACAGTCTA
s2_R_217_TTCAGCGTAT	CAAGCAGAAGACGGCATACGAGATTTCAGCGTATAGGGTCAAGTGCACAGTCTA
s2_R_218_TAAGCAGTCG	CAAGCAGAAGACGGCATACGAGATTAAGCAGTCGAGGGTCAAGTGCACAGTCTA
s2_R_219_GTCTGAGGCT	CAAGCAGAAGACGGCATACGAGATGTCTGAGGCTAGGGTCAAGTGCACAGTCTA
s2_R_220_CAAGGTAGGC	CAAGCAGAAGACGGCATACGAGATCAAGGTAGGCAGGGTCAAGTGCACAGTCTA
s2_R_221_TGTCGGCTAG	CAAGCAGAAGACGGCATACGAGATTGTCGGCTAGAGGGTCAAGTGCACAGTCTA
s2_R_222_TTCTCATGGT	CAAGCAGAAGACGGCATACGAGATTTCTCATGGTAGGGTCAAGTGCACAGTCTA
s2_R_223_TTCTTCACGT	CAAGCAGAAGACGGCATACGAGATTTCTTCACGTAGGGTCAAGTGCACAGTCTA
s2_R_224_TTATCGCTGT	CAAGCAGAAGACGGCATACGAGATTTATCGCTGTAGGGTCAAGTGCACAGTCTA
s2_R_225_GAACGGACAC	CAAGCAGAAGACGGCATACGAGATGAACGGACACAGGGTCAAGTGCACAGTCTA
s2_R_226_TAGTGACTAC	CAAGCAGAAGACGGCATACGAGATTAGTGACTACAGGGTCAAGTGCACAGTCTA
s2_R_227_TCTGGTCTAA	CAAGCAGAAGACGGCATACGAGATTCTGGTCTAAAGGGTCAAGTGCACAGTCTA
s2_R_228_GTTGGCCTAA	CAAGCAGAAGACGGCATACGAGATGTTGGCCTAAAGGGTCAAGTGCACAGTCTA
s2_R_229_TGTGGAATGA	CAAGCAGAAGACGGCATACGAGATTGTGGAATGAAGGGTCAAGTGCACAGTCTA
s2_R_230_CCGGACTTGT	CAAGCAGAAGACGGCATACGAGATCCGGACTTGTAGGGTCAAGTGCACAGTCTA
s2_R_231_TCGTGCCACT	CAAGCAGAAGACGGCATACGAGATTCGTGCCACTAGGGTCAAGTGCACAGTCTA
s2_R_232_TCTTGGCTAC	CAAGCAGAAGACGGCATACGAGATTCTTGGCTACAGGGTCAAGTGCACAGTCTA
s2_R_233_CAAGTCGAGT	CAAGCAGAAGACGGCATACGAGATCAAGTCGAGTAGGGTCAAGTGCACAGTCTA
s2_R_234_TCGACTTCGT	CAAGCAGAAGACGGCATACGAGATTCGACTTCGTAGGGTCAAGTGCACAGTCTA
s2_R_235_GCATCGTGTT	CAAGCAGAAGACGGCATACGAGATGCATCGTGTTAGGGTCAAGTGCACAGTCTA
s2_R_236_CCAGGTACTA	CAAGCAGAAGACGGCATACGAGATCCAGGTACTAAGGGTCAAGTGCACAGTCTA
s2_R_237_GCAATGTATG	CAAGCAGAAGACGGCATACGAGATGCAATGTATGAGGGTCAAGTGCACAGTCTA
s2_R_238_AGACCGATTC	CAAGCAGAAGACGGCATACGAGATAGACCGATTCAGGGTCAAGTGCACAGTCTA
s2_R_239_AGTCCTCGGA	CAAGCAGAAGACGGCATACGAGATAGTCCTCGGAAGGGTCAAGTGCACAGTCTA
s2_R_240_CTGATACGGA	CAAGCAGAAGACGGCATACGAGATCTGATACGGAAGGGTCAAGTGCACAGTCTA
s2_R_241_CCAGTTACCG	CAAGCAGAAGACGGCATACGAGATCCAGTTACCGAGGGTCAAGTGCACAGTCTA
s2_R_242_GTAGTAGTAC	CAAGCAGAAGACGGCATACGAGATGTAGTAGTACAGGGTCAAGTGCACAGTCTA
s2_R_243_CTGTAGGAAT	CAAGCAGAAGACGGCATACGAGATCTGTAGGAATAGGGTCAAGTGCACAGTCTA
s2_R_244_GTTAGTCGTC	CAAGCAGAAGACGGCATACGAGATGTTAGTCGTCAGGGTCAAGTGCACAGTCTA
s2_R_245_CTGAACGAAC	CAAGCAGAAGACGGCATACGAGATCTGAACGAACAGGGTCAAGTGCACAGTCTA
s2_R_246_ATCCAATCTC	CAAGCAGAAGACGGCATACGAGATATCCAATCTCAGGGTCAAGTGCACAGTCTA
s2_R_247_GACTGCTTCG	CAAGCAGAAGACGGCATACGAGATGACTGCTTCGAGGGTCAAGTGCACAGTCTA
s2_R_248_GGTAACGTCC	CAAGCAGAAGACGGCATACGAGATGGTAACGTCCAGGGTCAAGTGCACAGTCTA
s2_R_249_TCCTACAAGT	CAAGCAGAAGACGGCATACGAGATTCCTACAAGTAGGGTCAAGTGCACAGTCTA
s2_R_250_GATCAGCCTT	CAAGCAGAAGACGGCATACGAGATGATCAGCCTTAGGGTCAAGTGCACAGTCTA
s2_R_251_TGAATGTCCT	CAAGCAGAAGACGGCATACGAGATTGAATGTCCTAGGGTCAAGTGCACAGTCTA
s2_R_252_CTCCTGGTTA	CAAGCAGAAGACGGCATACGAGATCTCCTGGTTAAGGGTCAAGTGCACAGTCTA
s2_R_253_GAACCGATTG	CAAGCAGAAGACGGCATACGAGATGAACCGATTGAGGGTCAAGTGCACAGTCTA
s2_R_254_CCTTGTGAGG	CAAGCAGAAGACGGCATACGAGATCCTTGTGAGGAGGGTCAAGTGCACAGTCTA
s2_R_255_TTGCGGAAGT	CAAGCAGAAGACGGCATACGAGATTTGCGGAAGTAGGGTCAAGTGCACAGTCTA
s2_R_256_CTACATCTGT	CAAGCAGAAGACGGCATACGAGATCTACATCTGTAGGGTCAAGTGCACAGTCTA
s2_R_257_CTCTCTTCGT	CAAGCAGAAGACGGCATACGAGATCTCTCTTCGTAGGGTCAAGTGCACAGTCTA
s2_R_258_TTGCTTGCTC	CAAGCAGAAGACGGCATACGAGATTTGCTTGCTCAGGGTCAAGTGCACAGTCTA
s2_R_259_TCTTAAGCGT	CAAGCAGAAGACGGCATACGAGATTCTTAAGCGTAGGGTCAAGTGCACAGTCTA
s2_R_260_TCTATGCGCG	CAAGCAGAAGACGGCATACGAGATTCTATGCGCGAGGGTCAAGTGCACAGTCTA
s2_R_261_GTCTCTTGCT	CAAGCAGAAGACGGCATACGAGATGTCTCTTGCTAGGGTCAAGTGCACAGTCTA
s2_R_262_TAGTCGCGTA	CAAGCAGAAGACGGCATACGAGATTAGTCGCGTAAGGGTCAAGTGCACAGTCTA
s2_R_263_TCGCACAGAG	CAAGCAGAAGACGGCATACGAGATTCGCACAGAGAGGGTCAAGTGCACAGTCTA
s2_R_264_TACGTGGATC	CAAGCAGAAGACGGCATACGAGATTACGTGGATCAGGGTCAAGTGCACAGTCTA
s2_R_265_CTACAACGAA	CAAGCAGAAGACGGCATACGAGATCTACAACGAAAGGGTCAAGTGCACAGTCTA
s2_R_266_CGTAGTTAGC	CAAGCAGAAGACGGCATACGAGATCGTAGTTAGCAGGGTCAAGTGCACAGTCTA
s2_R_267_GTCCTTCTCT	CAAGCAGAAGACGGCATACGAGATGTCCTTCTCTAGGGTCAAGTGCACAGTCTA
s2_R_268_TTGATCGGAT	CAAGCAGAAGACGGCATACGAGATTTGATCGGATAGGGTCAAGTGCACAGTCTA
s2_R_269_GAGCTTATGG	CAAGCAGAAGACGGCATACGAGATGAGCTTATGGAGGGTCAAGTGCACAGTCTA
s2_R_270_TCATCCGGCT	CAAGCAGAAGACGGCATACGAGATTCATCCGGCTAGGGTCAAGTGCACAGTCTA
s2_R_271_CCGAACATGG	CAAGCAGAAGACGGCATACGAGATCCGAACATGGAGGGTCAAGTGCACAGTCTA
s2_R_272_CGATTAACGT	CAAGCAGAAGACGGCATACGAGATCGATTAACGTAGGGTCAAGTGCACAGTCTA
s2_R_273_TTCCATCGTT	CAAGCAGAAGACGGCATACGAGATTTCCATCGTTAGGGTCAAGTGCACAGTCTA
s2_R_274_TCTAGAAGGT	CAAGCAGAAGACGGCATACGAGATTCTAGAAGGTAGGGTCAAGTGCACAGTCTA
s2_R_275_CTGGTTACGT	CAAGCAGAAGACGGCATACGAGATCTGGTTACGTAGGGTCAAGTGCACAGTCTA
s2_R_276_GGTCAATCAA	CAAGCAGAAGACGGCATACGAGATGGTCAATCAAAGGGTCAAGTGCACAGTCTA
s2_R_277_TGTACTGCGG	CAAGCAGAAGACGGCATACGAGATTGTACTGCGGAGGGTCAAGTGCACAGTCTA
s2_R_278_ACAATCGGAG	CAAGCAGAAGACGGCATACGAGATACAATCGGAGAGGGTCAAGTGCACAGTCTA
s2_R_279_CTTCAGCTAC	CAAGCAGAAGACGGCATACGAGATCTTCAGCTACAGGGTCAAGTGCACAGTCTA
s2_R_280_CCTTCGATCC	CAAGCAGAAGACGGCATACGAGATCCTTCGATCCAGGGTCAAGTGCACAGTCTA
s2_R_281_CATGAGTGCC	CAAGCAGAAGACGGCATACGAGATCATGAGTGCCAGGGTCAAGTGCACAGTCTA
s2_R_282_CCTACGAGTC	CAAGCAGAAGACGGCATACGAGATCCTACGAGTCAGGGTCAAGTGCACAGTCTA
s2_R_283_CAAGTGTCCG	CAAGCAGAAGACGGCATACGAGATCAAGTGTCCGAGGGTCAAGTGCACAGTCTA
s2_R_284_ATCTTAGCCA	CAAGCAGAAGACGGCATACGAGATATCTTAGCCAAGGGTCAAGTGCACAGTCTA
s2_R_285_CGGTACAGCT	CAAGCAGAAGACGGCATACGAGATCGGTACAGCTAGGGTCAAGTGCACAGTCTA
s2_R_286_CCACATCGGA	CAAGCAGAAGACGGCATACGAGATCCACATCGGAAGGGTCAAGTGCACAGTCTA
s2_R_287_TCAGTGGACG	CAAGCAGAAGACGGCATACGAGATTCAGTGGACGAGGGTCAAGTGCACAGTCTA
s2_R_288_GACTCATCGT	CAAGCAGAAGACGGCATACGAGATGACTCATCGTAGGGTCAAGTGCACAGTCTA
s2_R_289_GGAACTCTGG	CAAGCAGAAGACGGCATACGAGATGGAACTCTGGAGGGTCAAGTGCACAGTCTA
s2_R_290_TGTCCGGTGA	CAAGCAGAAGACGGCATACGAGATTGTCCGGTGAAGGGTCAAGTGCACAGTCTA
s2_R_291_GTTCGCGTCA	CAAGCAGAAGACGGCATACGAGATGTTCGCGTCAAGGGTCAAGTGCACAGTCTA
s2_R_292_GGAATCTCTA	CAAGCAGAAGACGGCATACGAGATGGAATCTCTAAGGGTCAAGTGCACAGTCTA
s2_R_293_CGGTGTCTGA	CAAGCAGAAGACGGCATACGAGATCGGTGTCTGAAGGGTCAAGTGCACAGTCTA
s2_R_294_CTGACGTTAA	CAAGCAGAAGACGGCATACGAGATCTGACGTTAAAGGGTCAAGTGCACAGTCTA
s2_R_295_GGTAGATACC	CAAGCAGAAGACGGCATACGAGATGGTAGATACCAGGGTCAAGTGCACAGTCTA
s2_R_296_CCGATGCGTT	CAAGCAGAAGACGGCATACGAGATCCGATGCGTTAGGGTCAAGTGCACAGTCTA
s2_R_297_CAAGTGACTT	CAAGCAGAAGACGGCATACGAGATCAAGTGACTTAGGGTCAAGTGCACAGTCTA
s2_R_298_GTGTCTAACG	CAAGCAGAAGACGGCATACGAGATGTGTCTAACGAGGGTCAAGTGCACAGTCTA
s2_R_299_CACTCTGCCA	CAAGCAGAAGACGGCATACGAGATCACTCTGCCAAGGGTCAAGTGCACAGTCTA
s2_R_300_AGGATCTGGT	CAAGCAGAAGACGGCATACGAGATAGGATCTGGTAGGGTCAAGTGCACAGTCTA
s2_R_301_GTGTCTCTGA	CAAGCAGAAGACGGCATACGAGATGTGTCTCTGAAGGGTCAAGTGCACAGTCTA
s2_R_302_TGGCACGTCT	CAAGCAGAAGACGGCATACGAGATTGGCACGTCTAGGGTCAAGTGCACAGTCTA
s2_R_303_GTCGCGTAAC	CAAGCAGAAGACGGCATACGAGATGTCGCGTAACAGGGTCAAGTGCACAGTCTA
s2_R_304_CTTCTTACAG	CAAGCAGAAGACGGCATACGAGATCTTCTTACAGAGGGTCAAGTGCACAGTCTA
s2_R_305_GTATTCGGCG	CAAGCAGAAGACGGCATACGAGATGTATTCGGCGAGGGTCAAGTGCACAGTCTA
s2_R_306_TCTCCTAAGT	CAAGCAGAAGACGGCATACGAGATTCTCCTAAGTAGGGTCAAGTGCACAGTCTA
s2_R_307_TTGGTCACTT	CAAGCAGAAGACGGCATACGAGATTTGGTCACTTAGGGTCAAGTGCACAGTCTA
s2_R_308_AGTAGGCGTG	CAAGCAGAAGACGGCATACGAGATAGTAGGCGTGAGGGTCAAGTGCACAGTCTA
s2_R_309_TCGCTTCATT	CAAGCAGAAGACGGCATACGAGATTCGCTTCATTAGGGTCAAGTGCACAGTCTA
s2_R_310_TACTCTGTGG	CAAGCAGAAGACGGCATACGAGATTACTCTGTGGAGGGTCAAGTGCACAGTCTA
s2_R_311_CCAATAGCGA	CAAGCAGAAGACGGCATACGAGATCCAATAGCGAAGGGTCAAGTGCACAGTCTA
s2_R_312_GATGGTCTCT	CAAGCAGAAGACGGCATACGAGATGATGGTCTCTAGGGTCAAGTGCACAGTCTA
s2_R_313_CATCTGGAGT	CAAGCAGAAGACGGCATACGAGATCATCTGGAGTAGGGTCAAGTGCACAGTCTA
s2_R_314_TGAAGCGGAT	CAAGCAGAAGACGGCATACGAGATTGAAGCGGATAGGGTCAAGTGCACAGTCTA
s2_R_315_ACGACGTAGT	CAAGCAGAAGACGGCATACGAGATACGACGTAGTAGGGTCAAGTGCACAGTCTA
s2_R_316_CACTTCCTGT	CAAGCAGAAGACGGCATACGAGATCACTTCCTGTAGGGTCAAGTGCACAGTCTA
s2_R_317_CTTAACGATG	CAAGCAGAAGACGGCATACGAGATCTTAACGATGAGGGTCAAGTGCACAGTCTA
s2_R_318_GTAATCGCGG	CAAGCAGAAGACGGCATACGAGATGTAATCGCGGAGGGTCAAGTGCACAGTCTA
s2_R_319_TTGAGTACAC	CAAGCAGAAGACGGCATACGAGATTTGAGTACACAGGGTCAAGTGCACAGTCTA
s2_R_320_GACTCAACCG	CAAGCAGAAGACGGCATACGAGATGACTCAACCGAGGGTCAAGTGCACAGTCTA
s2_R_321_CCATATATCG	CAAGCAGAAGACGGCATACGAGATCCATATATCGAGGGTCAAGTGCACAGTCTA
s2_R_322_CCATAGACGT	CAAGCAGAAGACGGCATACGAGATCCATAGACGTAGGGTCAAGTGCACAGTCTA
s2_R_323_GAGCAATGCG	CAAGCAGAAGACGGCATACGAGATGAGCAATGCGAGGGTCAAGTGCACAGTCTA
s2_R_324_GTACGGAATC	CAAGCAGAAGACGGCATACGAGATGTACGGAATCAGGGTCAAGTGCACAGTCTA
s2_R_325_CCTGAAGGAA	CAAGCAGAAGACGGCATACGAGATCCTGAAGGAAAGGGTCAAGTGCACAGTCTA
s2_R_326_GTCTGTATGG	CAAGCAGAAGACGGCATACGAGATGTCTGTATGGAGGGTCAAGTGCACAGTCTA
s2_R_327_CAGGTGCTCT	CAAGCAGAAGACGGCATACGAGATCAGGTGCTCTAGGGTCAAGTGCACAGTCTA
s2_R_328_TATGATGTGG	CAAGCAGAAGACGGCATACGAGATTATGATGTGGAGGGTCAAGTGCACAGTCTA
s2_R_329_TCTAGGCGTT	CAAGCAGAAGACGGCATACGAGATTCTAGGCGTTAGGGTCAAGTGCACAGTCTA
s2_R_330_CTTCCGAAGG	CAAGCAGAAGACGGCATACGAGATCTTCCGAAGGAGGGTCAAGTGCACAGTCTA
s2_R_331_CCTCTACGAG	CAAGCAGAAGACGGCATACGAGATCCTCTACGAGAGGGTCAAGTGCACAGTCTA
s2_R_332_CCACTCACAC	CAAGCAGAAGACGGCATACGAGATCCACTCACACAGGGTCAAGTGCACAGTCTA
s2_R_333_CGCCATAATT	CAAGCAGAAGACGGCATACGAGATCGCCATAATTAGGGTCAAGTGCACAGTCTA
s2_R_334_GCGAATCGTG	CAAGCAGAAGACGGCATACGAGATGCGAATCGTGAGGGTCAAGTGCACAGTCTA
s2_R_335_CCTGGACGAT	CAAGCAGAAGACGGCATACGAGATCCTGGACGATAGGGTCAAGTGCACAGTCTA
s2_R_336_CTTAGCGAGT	CAAGCAGAAGACGGCATACGAGATCTTAGCGAGTAGGGTCAAGTGCACAGTCTA
s2_R_337_AGTTCGTTGT	CAAGCAGAAGACGGCATACGAGATAGTTCGTTGTAGGGTCAAGTGCACAGTCTA
s2_R_338_CTTGCTTGGC	CAAGCAGAAGACGGCATACGAGATCTTGCTTGGCAGGGTCAAGTGCACAGTCTA
s2_R_339_CTAATGTCAG	CAAGCAGAAGACGGCATACGAGATCTAATGTCAGAGGGTCAAGTGCACAGTCTA
s2_R_340_TCGAGCCTGA	CAAGCAGAAGACGGCATACGAGATTCGAGCCTGAAGGGTCAAGTGCACAGTCTA
s2_R_341_CTCTTATCAC	CAAGCAGAAGACGGCATACGAGATCTCTTATCACAGGGTCAAGTGCACAGTCTA
s2_R_342_TCTAGTGCAT	CAAGCAGAAGACGGCATACGAGATTCTAGTGCATAGGGTCAAGTGCACAGTCTA
s2_R_343_TCCTCACCTG	CAAGCAGAAGACGGCATACGAGATTCCTCACCTGAGGGTCAAGTGCACAGTCTA
s2_R_344_TTGTCCAGAT	CAAGCAGAAGACGGCATACGAGATTTGTCCAGATAGGGTCAAGTGCACAGTCTA
s2_R_345_CTTGACTCCA	CAAGCAGAAGACGGCATACGAGATCTTGACTCCAAGGGTCAAGTGCACAGTCTA
s2_R_346_TCTGTTCACC	CAAGCAGAAGACGGCATACGAGATTCTGTTCACCAGGGTCAAGTGCACAGTCTA
s2_R_347_TCCGACATCT	CAAGCAGAAGACGGCATACGAGATTCCGACATCTAGGGTCAAGTGCACAGTCTA
s2_R_348_TCCGAGTTAT	CAAGCAGAAGACGGCATACGAGATTCCGAGTTATAGGGTCAAGTGCACAGTCTA
s2_R_349_TCCGATAGCC	CAAGCAGAAGACGGCATACGAGATTCCGATAGCCAGGGTCAAGTGCACAGTCTA
s2_R_350_CGTACTAATG	CAAGCAGAAGACGGCATACGAGATCGTACTAATGAGGGTCAAGTGCACAGTCTA
s2_R_351_CTATCGAATC	CAAGCAGAAGACGGCATACGAGATCTATCGAATCAGGGTCAAGTGCACAGTCTA
s2_R_352_GTCAACAGCT	CAAGCAGAAGACGGCATACGAGATGTCAACAGCTAGGGTCAAGTGCACAGTCTA
s2_R_353_CTAGGAATGG	CAAGCAGAAGACGGCATACGAGATCTAGGAATGGAGGGTCAAGTGCACAGTCTA
s2_R_354_TGCTCTGGTT	CAAGCAGAAGACGGCATACGAGATTGCTCTGGTTAGGGTCAAGTGCACAGTCTA
s2_R_355_TACGGTCTTG	CAAGCAGAAGACGGCATACGAGATTACGGTCTTGAGGGTCAAGTGCACAGTCTA
s2_R_356_TGGCTATTGC	CAAGCAGAAGACGGCATACGAGATTGGCTATTGCAGGGTCAAGTGCACAGTCTA
s2_R_357_TGAATGCGTC	CAAGCAGAAGACGGCATACGAGATTGAATGCGTCAGGGTCAAGTGCACAGTCTA
s2_R_358_TCGGCACATC	CAAGCAGAAGACGGCATACGAGATTCGGCACATCAGGGTCAAGTGCACAGTCTA
s2_R_359_TCAGGTGTAC	CAAGCAGAAGACGGCATACGAGATTCAGGTGTACAGGGTCAAGTGCACAGTCTA
s2_R_360_GTTACGATCT	CAAGCAGAAGACGGCATACGAGATGTTACGATCTAGGGTCAAGTGCACAGTCTA
s2_R_361_CCGTACTATC	CAAGCAGAAGACGGCATACGAGATCCGTACTATCAGGGTCAAGTGCACAGTCTA
s2_R_362_CGCCAATGTC	CAAGCAGAAGACGGCATACGAGATCGCCAATGTCAGGGTCAAGTGCACAGTCTA
s2_R_363_GCGTCCGTAA	CAAGCAGAAGACGGCATACGAGATGCGTCCGTAAAGGGTCAAGTGCACAGTCTA
s2_R_364_GCGTAACTGA	CAAGCAGAAGACGGCATACGAGATGCGTAACTGAAGGGTCAAGTGCACAGTCTA
s2_R_365_TTGCTTCTGG	CAAGCAGAAGACGGCATACGAGATTTGCTTCTGGAGGGTCAAGTGCACAGTCTA
s2_R_366_TTGGAGTCTC	CAAGCAGAAGACGGCATACGAGATTTGGAGTCTCAGGGTCAAGTGCACAGTCTA
s2_R_367_CCTCTGGCTT	CAAGCAGAAGACGGCATACGAGATCCTCTGGCTTAGGGTCAAGTGCACAGTCTA
s2_R_368_TTCGGCATGA	CAAGCAGAAGACGGCATACGAGATTTCGGCATGAAGGGTCAAGTGCACAGTCTA
s2_R_369_TGTCCACGAG	CAAGCAGAAGACGGCATACGAGATTGTCCACGAGAGGGTCAAGTGCACAGTCTA
s2_R_370_GTCTTGTCTC	CAAGCAGAAGACGGCATACGAGATGTCTTGTCTCAGGGTCAAGTGCACAGTCTA
s2_R_371_GCTTACCGTG	CAAGCAGAAGACGGCATACGAGATGCTTACCGTGAGGGTCAAGTGCACAGTCTA
s2_R_372_GGAAGTGCTC	CAAGCAGAAGACGGCATACGAGATGGAAGTGCTCAGGGTCAAGTGCACAGTCTA
s2_R_373_CAAGCTCCGA	CAAGCAGAAGACGGCATACGAGATCAAGCTCCGAAGGGTCAAGTGCACAGTCTA
s2_R_374_GGTTCTGTCA	CAAGCAGAAGACGGCATACGAGATGGTTCTGTCAAGGGTCAAGTGCACAGTCTA
s2_R_375_GTCATACGTC	CAAGCAGAAGACGGCATACGAGATGTCATACGTCAGGGTCAAGTGCACAGTCTA
s2_R_376_GGAGATCCTG	CAAGCAGAAGACGGCATACGAGATGGAGATCCTGAGGGTCAAGTGCACAGTCTA
s2_R_377_GGACAACCGA	CAAGCAGAAGACGGCATACGAGATGGACAACCGAAGGGTCAAGTGCACAGTCTA
s2_R_378_GTGATTCTTG	CAAGCAGAAGACGGCATACGAGATGTGATTCTTGAGGGTCAAGTGCACAGTCTA
s2_R_379_TGGTCATCCT	CAAGCAGAAGACGGCATACGAGATTGGTCATCCTAGGGTCAAGTGCACAGTCTA
s2_R_380_CTTCTAGCAT	CAAGCAGAAGACGGCATACGAGATCTTCTAGCATAGGGTCAAGTGCACAGTCTA
s2_R_381_GTCCAGTCTG	CAAGCAGAAGACGGCATACGAGATGTCCAGTCTGAGGGTCAAGTGCACAGTCTA
s2_R_382_CCGTACTGAG	CAAGCAGAAGACGGCATACGAGATCCGTACTGAGAGGGTCAAGTGCACAGTCTA
s2_R_383_GAGTGACGAG	CAAGCAGAAGACGGCATACGAGATGAGTGACGAGAGGGTCAAGTGCACAGTCTA
s2_R_384_TCGGAATTGA	CAAGCAGAAGACGGCATACGAGATTCGGAATTGAAGGGTCAAGTGCACAGTCTA
s2_R_385_TAACATGCCA	CAAGCAGAAGACGGCATACGAGATTAACATGCCAAGGGTCAAGTGCACAGTCTA
s2_R_386_CTACATGGAT	CAAGCAGAAGACGGCATACGAGATCTACATGGATAGGGTCAAGTGCACAGTCTA
s2_R_387_CTAATGGTTC	CAAGCAGAAGACGGCATACGAGATCTAATGGTTCAGGGTCAAGTGCACAGTCTA
s2_R_388_CTATTGGACT	CAAGCAGAAGACGGCATACGAGATCTATTGGACTAGGGTCAAGTGCACAGTCTA
s2_R_389_CTACTCCAAG	CAAGCAGAAGACGGCATACGAGATCTACTCCAAGAGGGTCAAGTGCACAGTCTA
s2_R_390_GCGTAGAGTA	CAAGCAGAAGACGGCATACGAGATGCGTAGAGTAAGGGTCAAGTGCACAGTCTA
s2_R_391_GCGTTCAGAT	CAAGCAGAAGACGGCATACGAGATGCGTTCAGATAGGGTCAAGTGCACAGTCTA
s2_R_392_CATCGCCAAG	CAAGCAGAAGACGGCATACGAGATCATCGCCAAGAGGGTCAAGTGCACAGTCTA
s2_R_393_TCATCTTCTC	CAAGCAGAAGACGGCATACGAGATTCATCTTCTCAGGGTCAAGTGCACAGTCTA
s2_R_394_TCTGAGGCCA	CAAGCAGAAGACGGCATACGAGATTCTGAGGCCAAGGGTCAAGTGCACAGTCTA
s2_R_395_TACGGATCAG	CAAGCAGAAGACGGCATACGAGATTACGGATCAGAGGGTCAAGTGCACAGTCTA
s2_R_396_GGATAAGCAG	CAAGCAGAAGACGGCATACGAGATGGATAAGCAGAGGGTCAAGTGCACAGTCTA
s2_R_397_TCAGACGGAT	CAAGCAGAAGACGGCATACGAGATTCAGACGGATAGGGTCAAGTGCACAGTCTA
s2_R_398_GTCTACGGAT	CAAGCAGAAGACGGCATACGAGATGTCTACGGATAGGGTCAAGTGCACAGTCTA
s2_R_399_GTCCGTGTTA	CAAGCAGAAGACGGCATACGAGATGTCCGTGTTAAGGGTCAAGTGCACAGTCTA
s2_R_400_TTCATGATGG	CAAGCAGAAGACGGCATACGAGATTTCATGATGGAGGGTCAAGTGCACAGTCTA
s2_R_401_GCTAGCCTCT	CAAGCAGAAGACGGCATACGAGATGCTAGCCTCTAGGGTCAAGTGCACAGTCTA
s2_R_402_CGTCAGGCAA	CAAGCAGAAGACGGCATACGAGATCGTCAGGCAAAGGGTCAAGTGCACAGTCTA
s2_R_403_CTTACCTAAG	CAAGCAGAAGACGGCATACGAGATCTTACCTAAGAGGGTCAAGTGCACAGTCTA
s2_R_404_AGCGTGTGGT	CAAGCAGAAGACGGCATACGAGATAGCGTGTGGTAGGGTCAAGTGCACAGTCTA
s2_R_405_TGTCGCTTGT	CAAGCAGAAGACGGCATACGAGATTGTCGCTTGTAGGGTCAAGTGCACAGTCTA
s2_R_406_TGTAAGGCAG	CAAGCAGAAGACGGCATACGAGATTGTAAGGCAGAGGGTCAAGTGCACAGTCTA
s2_R_407_AGGTTCCGTG	CAAGCAGAAGACGGCATACGAGATAGGTTCCGTGAGGGTCAAGTGCACAGTCTA
s2_R_408_TCGTCACTGT	CAAGCAGAAGACGGCATACGAGATTCGTCACTGTAGGGTCAAGTGCACAGTCTA
s2_R_409_CCAACGTGAC	CAAGCAGAAGACGGCATACGAGATCCAACGTGACAGGGTCAAGTGCACAGTCTA
s2_R_410_TCGTGCTGTT	CAAGCAGAAGACGGCATACGAGATTCGTGCTGTTAGGGTCAAGTGCACAGTCTA
s2_R_411_TCTCCATTCA	CAAGCAGAAGACGGCATACGAGATTCTCCATTCAAGGGTCAAGTGCACAGTCTA
s2_R_412_CGATTCCGTA	CAAGCAGAAGACGGCATACGAGATCGATTCCGTAAGGGTCAAGTGCACAGTCTA
s2_R_413_CCGTTGTCAA	CAAGCAGAAGACGGCATACGAGATCCGTTGTCAAAGGGTCAAGTGCACAGTCTA
s2_R_414_CCTGTCGGAT	CAAGCAGAAGACGGCATACGAGATCCTGTCGGATAGGGTCAAGTGCACAGTCTA
s2_R_415_TACGATAGGT	CAAGCAGAAGACGGCATACGAGATTACGATAGGTAGGGTCAAGTGCACAGTCTA
s2_R_416_CTATACCGAG	CAAGCAGAAGACGGCATACGAGATCTATACCGAGAGGGTCAAGTGCACAGTCTA
s2_R_417_TCTTACTGCC	CAAGCAGAAGACGGCATACGAGATTCTTACTGCCAGGGTCAAGTGCACAGTCTA
s2_R_418_GGTACGGTAG	CAAGCAGAAGACGGCATACGAGATGGTACGGTAGAGGGTCAAGTGCACAGTCTA
s2_R_419_TGGTTGTCGT	CAAGCAGAAGACGGCATACGAGATTGGTTGTCGTAGGGTCAAGTGCACAGTCTA
s2_R_420_CCGACCATAC	CAAGCAGAAGACGGCATACGAGATCCGACCATACAGGGTCAAGTGCACAGTCTA
s2_R_421_TCCGGCAATG	CAAGCAGAAGACGGCATACGAGATTCCGGCAATGAGGGTCAAGTGCACAGTCTA
s2_R_422_TATCCTCTGG	CAAGCAGAAGACGGCATACGAGATTATCCTCTGGAGGGTCAAGTGCACAGTCTA
s2_R_423_CATACGAAGT	CAAGCAGAAGACGGCATACGAGATCATACGAAGTAGGGTCAAGTGCACAGTCTA
s2_R_424_TTGTCCTCGT	CAAGCAGAAGACGGCATACGAGATTTGTCCTCGTAGGGTCAAGTGCACAGTCTA
s2_R_425_GGTGACTGAC	CAAGCAGAAGACGGCATACGAGATGGTGACTGACAGGGTCAAGTGCACAGTCTA
s2_R_426_CCTTAGAATG	CAAGCAGAAGACGGCATACGAGATCCTTAGAATGAGGGTCAAGTGCACAGTCTA
s2_R_427_TATCTGAACC	CAAGCAGAAGACGGCATACGAGATTATCTGAACCAGGGTCAAGTGCACAGTCTA
s2_R_428_GGTGCCAGTA	CAAGCAGAAGACGGCATACGAGATGGTGCCAGTAAGGGTCAAGTGCACAGTCTA
s2_R_429_CTCCGGTATC	CAAGCAGAAGACGGCATACGAGATCTCCGGTATCAGGGTCAAGTGCACAGTCTA
s2_R_430_CTTCGGTAAG	CAAGCAGAAGACGGCATACGAGATCTTCGGTAAGAGGGTCAAGTGCACAGTCTA
s2_R_431_CTACTACACA	CAAGCAGAAGACGGCATACGAGATCTACTACACAAGGGTCAAGTGCACAGTCTA
s2_R_432_TGCACAGAAC	CAAGCAGAAGACGGCATACGAGATTGCACAGAACAGGGTCAAGTGCACAGTCTA
s2_R_433_GACACTAGAG	CAAGCAGAAGACGGCATACGAGATGACACTAGAGAGGGTCAAGTGCACAGTCTA
s2_R_434_GTGGACGCTT	CAAGCAGAAGACGGCATACGAGATGTGGACGCTTAGGGTCAAGTGCACAGTCTA
s2_R_435_GTCAATTGCC	CAAGCAGAAGACGGCATACGAGATGTCAATTGCCAGGGTCAAGTGCACAGTCTA
s2_R_436_GAATCTGTTC	CAAGCAGAAGACGGCATACGAGATGAATCTGTTCAGGGTCAAGTGCACAGTCTA
s2_R_437_GTTGCTTAGG	CAAGCAGAAGACGGCATACGAGATGTTGCTTAGGAGGGTCAAGTGCACAGTCTA
s2_R_438_TGACAGTGCC	CAAGCAGAAGACGGCATACGAGATTGACAGTGCCAGGGTCAAGTGCACAGTCTA
s2_R_439_CCATTGGTTA	CAAGCAGAAGACGGCATACGAGATCCATTGGTTAAGGGTCAAGTGCACAGTCTA
s2_R_440_GGACCTCGTT	CAAGCAGAAGACGGCATACGAGATGGACCTCGTTAGGGTCAAGTGCACAGTCTA
s2_R_441_GCGAACGGAT	CAAGCAGAAGACGGCATACGAGATGCGAACGGATAGGGTCAAGTGCACAGTCTA
s2_R_442_TACGGCAGTT	CAAGCAGAAGACGGCATACGAGATTACGGCAGTTAGGGTCAAGTGCACAGTCTA
s2_R_443_TTACGACGGT	CAAGCAGAAGACGGCATACGAGATTTACGACGGTAGGGTCAAGTGCACAGTCTA
s2_R_444_GGCACGCTAA	CAAGCAGAAGACGGCATACGAGATGGCACGCTAAAGGGTCAAGTGCACAGTCTA
s2_R_445_CTAAGCAGAA	CAAGCAGAAGACGGCATACGAGATCTAAGCAGAAAGGGTCAAGTGCACAGTCTA
s2_R_446_TCTTCCGGAC	CAAGCAGAAGACGGCATACGAGATTCTTCCGGACAGGGTCAAGTGCACAGTCTA
s2_R_447_GTGAAGCCAT	CAAGCAGAAGACGGCATACGAGATGTGAAGCCATAGGGTCAAGTGCACAGTCTA
s2_R_448_GTAGCACGAT	CAAGCAGAAGACGGCATACGAGATGTAGCACGATAGGGTCAAGTGCACAGTCTA
s2_R_449_TACTCTCCTC	CAAGCAGAAGACGGCATACGAGATTACTCTCCTCAGGGTCAAGTGCACAGTCTA
s2_R_450_AGTGCCATGT	CAAGCAGAAGACGGCATACGAGATAGTGCCATGTAGGGTCAAGTGCACAGTCTA
s2_R_451_CATTCTCAGA	CAAGCAGAAGACGGCATACGAGATCATTCTCAGAAGGGTCAAGTGCACAGTCTA
s2_R_452_GACTCCTGAT	CAAGCAGAAGACGGCATACGAGATGACTCCTGATAGGGTCAAGTGCACAGTCTA
s2_R_453_GGTCGTAGAG	CAAGCAGAAGACGGCATACGAGATGGTCGTAGAGAGGGTCAAGTGCACAGTCTA
s2_R_454_TCTTGCGTTA	CAAGCAGAAGACGGCATACGAGATTCTTGCGTTAAGGGTCAAGTGCACAGTCTA
s2_R_455_GGACGATAGT	CAAGCAGAAGACGGCATACGAGATGGACGATAGTAGGGTCAAGTGCACAGTCTA
s2_R_456_TTGGACCGAG	CAAGCAGAAGACGGCATACGAGATTTGGACCGAGAGGGTCAAGTGCACAGTCTA
s2_R_457_TGTCACTCCG	CAAGCAGAAGACGGCATACGAGATTGTCACTCCGAGGGTCAAGTGCACAGTCTA
s2_R_458_TCTGGCCTTG	CAAGCAGAAGACGGCATACGAGATTCTGGCCTTGAGGGTCAAGTGCACAGTCTA
s2_R_459_GGTGAGTACT	CAAGCAGAAGACGGCATACGAGATGGTGAGTACTAGGGTCAAGTGCACAGTCTA
s2_R_460_GTACCGACAA	CAAGCAGAAGACGGCATACGAGATGTACCGACAAAGGGTCAAGTGCACAGTCTA
s2_R_461_TGTTGGCGTA	CAAGCAGAAGACGGCATACGAGATTGTTGGCGTAAGGGTCAAGTGCACAGTCTA
s2_R_462_TCCTGCTTCC	CAAGCAGAAGACGGCATACGAGATTCCTGCTTCCAGGGTCAAGTGCACAGTCTA
s2_R_463_GTATTCGTTC	CAAGCAGAAGACGGCATACGAGATGTATTCGTTCAGGGTCAAGTGCACAGTCTA
s2_R_464_GTTCCGTATC	CAAGCAGAAGACGGCATACGAGATGTTCCGTATCAGGGTCAAGTGCACAGTCTA
s2_R_465_GTACGCTTCT	CAAGCAGAAGACGGCATACGAGATGTACGCTTCTAGGGTCAAGTGCACAGTCTA
s2_R_466_GGTACGACAC	CAAGCAGAAGACGGCATACGAGATGGTACGACACAGGGTCAAGTGCACAGTCTA
s2_R_467_CTTCAGAGGA	CAAGCAGAAGACGGCATACGAGATCTTCAGAGGAAGGGTCAAGTGCACAGTCTA
s2_R_468_CTGTTGTGAC	CAAGCAGAAGACGGCATACGAGATCTGTTGTGACAGGGTCAAGTGCACAGTCTA
s2_R_469_TGCTGACGGT	CAAGCAGAAGACGGCATACGAGATTGCTGACGGTAGGGTCAAGTGCACAGTCTA
s2_R_470_GCGAGAACTA	CAAGCAGAAGACGGCATACGAGATGCGAGAACTAAGGGTCAAGTGCACAGTCTA
s2_R_471_ATGGCTGTGT	CAAGCAGAAGACGGCATACGAGATATGGCTGTGTAGGGTCAAGTGCACAGTCTA
s2_R_472_CCTTACGAAC	CAAGCAGAAGACGGCATACGAGATCCTTACGAACAGGGTCAAGTGCACAGTCTA
s2_R_473_GACCAAGGAA	CAAGCAGAAGACGGCATACGAGATGACCAAGGAAAGGGTCAAGTGCACAGTCTA
s2_R_474_TGGAACGATC	CAAGCAGAAGACGGCATACGAGATTGGAACGATCAGGGTCAAGTGCACAGTCTA
s2_R_475_TTAGGCTAAG	CAAGCAGAAGACGGCATACGAGATTTAGGCTAAGAGGGTCAAGTGCACAGTCTA
s2_R_476_CTAGGACTCT	CAAGCAGAAGACGGCATACGAGATCTAGGACTCTAGGGTCAAGTGCACAGTCTA
s2_R_477_TCACGCCATT	CAAGCAGAAGACGGCATACGAGATTCACGCCATTAGGGTCAAGTGCACAGTCTA
s2_R_478_TTCCGAACAA	CAAGCAGAAGACGGCATACGAGATTTCCGAACAAAGGGTCAAGTGCACAGTCTA
s2_R_479_CTTGCGTTCC	CAAGCAGAAGACGGCATACGAGATCTTGCGTTCCAGGGTCAAGTGCACAGTCTA
s2_R_480_CATCTCAACA	CAAGCAGAAGACGGCATACGAGATCATCTCAACAAGGGTCAAGTGCACAGTCTA
s2_R_481_TCCTTGAACT	CAAGCAGAAGACGGCATACGAGATTCCTTGAACTAGGGTCAAGTGCACAGTCTA
s2_R_482_CTGTGTCTTC	CAAGCAGAAGACGGCATACGAGATCTGTGTCTTCAGGGTCAAGTGCACAGTCTA
s2_R_483_CTTACAACAG	CAAGCAGAAGACGGCATACGAGATCTTACAACAGAGGGTCAAGTGCACAGTCTA
s2_R_484_TGGATAGCTA	CAAGCAGAAGACGGCATACGAGATTGGATAGCTAAGGGTCAAGTGCACAGTCTA
s2_R_485_CTACGGTTCG	CAAGCAGAAGACGGCATACGAGATCTACGGTTCGAGGGTCAAGTGCACAGTCTA
s2_R_486_TTCGTAGAAC	CAAGCAGAAGACGGCATACGAGATTTCGTAGAACAGGGTCAAGTGCACAGTCTA
s2_R_487_GGTTCGTGAT	CAAGCAGAAGACGGCATACGAGATGGTTCGTGATAGGGTCAAGTGCACAGTCTA
s2_R_488_TTGGCTCCAA	CAAGCAGAAGACGGCATACGAGATTTGGCTCCAAAGGGTCAAGTGCACAGTCTA
s2_R_489_TGTTGCCAGA	CAAGCAGAAGACGGCATACGAGATTGTTGCCAGAAGGGTCAAGTGCACAGTCTA
s2_R_490_TTGGCTTCTT	CAAGCAGAAGACGGCATACGAGATTTGGCTTCTTAGGGTCAAGTGCACAGTCTA
s2_R_491_CGTTACGCCT	CAAGCAGAAGACGGCATACGAGATCGTTACGCCTAGGGTCAAGTGCACAGTCTA
s2_R_492_ACGCCAATGA	CAAGCAGAAGACGGCATACGAGATACGCCAATGAAGGGTCAAGTGCACAGTCTA
s2_R_493_TAGACTGTCG	CAAGCAGAAGACGGCATACGAGATTAGACTGTCGAGGGTCAAGTGCACAGTCTA
s2_R_494_GTGGTGCAAC	CAAGCAGAAGACGGCATACGAGATGTGGTGCAACAGGGTCAAGTGCACAGTCTA
s2_R_495_GCTTGTCGGT	CAAGCAGAAGACGGCATACGAGATGCTTGTCGGTAGGGTCAAGTGCACAGTCTA
s2_R_496_TTGCCTCAAC	CAAGCAGAAGACGGCATACGAGATTTGCCTCAACAGGGTCAAGTGCACAGTCTA
s2_R_497_GTAGTCGGAT	CAAGCAGAAGACGGCATACGAGATGTAGTCGGATAGGGTCAAGTGCACAGTCTA
s2_R_498_TCTGGCAGTC	CAAGCAGAAGACGGCATACGAGATTCTGGCAGTCAGGGTCAAGTGCACAGTCTA
s2_R_499_TTGATGCACA	CAAGCAGAAGACGGCATACGAGATTTGATGCACAAGGGTCAAGTGCACAGTCTA
s2_R_500_TAGTCCGTGT	CAAGCAGAAGACGGCATACGAGATTAGTCCGTGTAGGGTCAAGTGCACAGTCTA
s2_R_501_TCCACAACAC	CAAGCAGAAGACGGCATACGAGATTCCACAACACAGGGTCAAGTGCACAGTCTA
s2_R_502_CTTGACACGT	CAAGCAGAAGACGGCATACGAGATCTTGACACGTAGGGTCAAGTGCACAGTCTA
s2_R_503_CATGGTGCAT	CAAGCAGAAGACGGCATACGAGATCATGGTGCATAGGGTCAAGTGCACAGTCTA
s2_R_504_TGCGTGTTGC	CAAGCAGAAGACGGCATACGAGATTGCGTGTTGCAGGGTCAAGTGCACAGTCTA
s2_R_505_TGCCTATCCG	CAAGCAGAAGACGGCATACGAGATTGCCTATCCGAGGGTCAAGTGCACAGTCTA
s2_R_506_TACATAGTCC	CAAGCAGAAGACGGCATACGAGATTACATAGTCCAGGGTCAAGTGCACAGTCTA
s2_R_507_TATTCGTACC	CAAGCAGAAGACGGCATACGAGATTATTCGTACCAGGGTCAAGTGCACAGTCTA
s2_R_508_TCGACGATGT	CAAGCAGAAGACGGCATACGAGATTCGACGATGTAGGGTCAAGTGCACAGTCTA
s2_R_509_TCGAGCGTTG	CAAGCAGAAGACGGCATACGAGATTCGAGCGTTGAGGGTCAAGTGCACAGTCTA
s2_R_510_TCGACCACTA	CAAGCAGAAGACGGCATACGAGATTCGACCACTAAGGGTCAAGTGCACAGTCTA
s2_R_511_TCGACGGAAG	CAAGCAGAAGACGGCATACGAGATTCGACGGAAGAGGGTCAAGTGCACAGTCTA
s2_R_512_TCGAGAGATC	CAAGCAGAAGACGGCATACGAGATTCGAGAGATCAGGGTCAAGTGCACAGTCTA
s2_R_513_TGCGATGAGC	CAAGCAGAAGACGGCATACGAGATTGCGATGAGCAGGGTCAAGTGCACAGTCTA
s2_R_514_GTTCCTGGTC	CAAGCAGAAGACGGCATACGAGATGTTCCTGGTCAGGGTCAAGTGCACAGTCTA
s2_R_515_TTCGCTGATT	CAAGCAGAAGACGGCATACGAGATTTCGCTGATTAGGGTCAAGTGCACAGTCTA
s2_R_516_CCAGGAATTC	CAAGCAGAAGACGGCATACGAGATCCAGGAATTCAGGGTCAAGTGCACAGTCTA
s2_R_517_GCTTCTAGTC	CAAGCAGAAGACGGCATACGAGATGCTTCTAGTCAGGGTCAAGTGCACAGTCTA
s2_R_518_TCTGGAGAAG	CAAGCAGAAGACGGCATACGAGATTCTGGAGAAGAGGGTCAAGTGCACAGTCTA
s2_R_519_TCAACTCGTA	CAAGCAGAAGACGGCATACGAGATTCAACTCGTAAGGGTCAAGTGCACAGTCTA
s2_R_520_TTATCGCCAA	CAAGCAGAAGACGGCATACGAGATTTATCGCCAAAGGGTCAAGTGCACAGTCTA
s2_R_521_GTGCGTATTC	CAAGCAGAAGACGGCATACGAGATGTGCGTATTCAGGGTCAAGTGCACAGTCTA
s2_R_522_AGTGATTCAC	CAAGCAGAAGACGGCATACGAGATAGTGATTCACAGGGTCAAGTGCACAGTCTA
s2_R_523_TCATGGCAAG	CAAGCAGAAGACGGCATACGAGATTCATGGCAAGAGGGTCAAGTGCACAGTCTA
s2_R_524_CTCTGGCATG	CAAGCAGAAGACGGCATACGAGATCTCTGGCATGAGGGTCAAGTGCACAGTCTA
s2_R_525_TCGATGAGAA	CAAGCAGAAGACGGCATACGAGATTCGATGAGAAAGGGTCAAGTGCACAGTCTA
s2_R_526_TCCACCGAGA	CAAGCAGAAGACGGCATACGAGATTCCACCGAGAAGGGTCAAGTGCACAGTCTA
s2_R_527_TCGAGGAACT	CAAGCAGAAGACGGCATACGAGATTCGAGGAACTAGGGTCAAGTGCACAGTCTA
s2_R_528_TCTCCACCTC	CAAGCAGAAGACGGCATACGAGATTCTCCACCTCAGGGTCAAGTGCACAGTCTA
s2_R_529_TCGTATTCCT	CAAGCAGAAGACGGCATACGAGATTCGTATTCCTAGGGTCAAGTGCACAGTCTA
s2_R_530_TCACCGATGG	CAAGCAGAAGACGGCATACGAGATTCACCGATGGAGGGTCAAGTGCACAGTCTA
s2_R_531_TAAGTCGTGG	CAAGCAGAAGACGGCATACGAGATTAAGTCGTGGAGGGTCAAGTGCACAGTCTA
s2_R_532_CAGGTATGTC	CAAGCAGAAGACGGCATACGAGATCAGGTATGTCAGGGTCAAGTGCACAGTCTA
s2_R_533_TACCAGACGG	CAAGCAGAAGACGGCATACGAGATTACCAGACGGAGGGTCAAGTGCACAGTCTA
s2_R_534_TGTAGCTATC	CAAGCAGAAGACGGCATACGAGATTGTAGCTATCAGGGTCAAGTGCACAGTCTA
s2_R_535_ACCTTGTCGT	CAAGCAGAAGACGGCATACGAGATACCTTGTCGTAGGGTCAAGTGCACAGTCTA
s2_R_536_GTACGTTGTT	CAAGCAGAAGACGGCATACGAGATGTACGTTGTTAGGGTCAAGTGCACAGTCTA
s2_R_537_CATGTTCGAA	CAAGCAGAAGACGGCATACGAGATCATGTTCGAAAGGGTCAAGTGCACAGTCTA
s2_R_538_TGTGTCGGAG	CAAGCAGAAGACGGCATACGAGATTGTGTCGGAGAGGGTCAAGTGCACAGTCTA
s2_R_539_GTCATGTGCG	CAAGCAGAAGACGGCATACGAGATGTCATGTGCGAGGGTCAAGTGCACAGTCTA
s2_R_540_GCATCGTAAG	CAAGCAGAAGACGGCATACGAGATGCATCGTAAGAGGGTCAAGTGCACAGTCTA
s2_R_541_GTGTATGTGG	CAAGCAGAAGACGGCATACGAGATGTGTATGTGGAGGGTCAAGTGCACAGTCTA
s2_R_542_TCGACTAACC	CAAGCAGAAGACGGCATACGAGATTCGACTAACCAGGGTCAAGTGCACAGTCTA
s2_R_543_ACACCATATC	CAAGCAGAAGACGGCATACGAGATACACCATATCAGGGTCAAGTGCACAGTCTA
s2_R_544_CGTAACTCAG	CAAGCAGAAGACGGCATACGAGATCGTAACTCAGAGGGTCAAGTGCACAGTCTA
s2_R_545_TCCGTGCGTA	CAAGCAGAAGACGGCATACGAGATTCCGTGCGTAAGGGTCAAGTGCACAGTCTA
s2_R_546_CTACGAGGTT	CAAGCAGAAGACGGCATACGAGATCTACGAGGTTAGGGTCAAGTGCACAGTCTA
s2_R_547_CCGTTCTTCA	CAAGCAGAAGACGGCATACGAGATCCGTTCTTCAAGGGTCAAGTGCACAGTCTA
s2_R_548_GGTCACGATC	CAAGCAGAAGACGGCATACGAGATGGTCACGATCAGGGTCAAGTGCACAGTCTA
s2_R_549_CGTATCAGGA	CAAGCAGAAGACGGCATACGAGATCGTATCAGGAAGGGTCAAGTGCACAGTCTA
s2_R_550_GTGCCATTGC	CAAGCAGAAGACGGCATACGAGATGTGCCATTGCAGGGTCAAGTGCACAGTCTA
s2_R_551_GTACAGAAGG	CAAGCAGAAGACGGCATACGAGATGTACAGAAGGAGGGTCAAGTGCACAGTCTA
s2_R_552_TGGTATCATG	CAAGCAGAAGACGGCATACGAGATTGGTATCATGAGGGTCAAGTGCACAGTCTA
s2_R_553_GTCTATCATG	CAAGCAGAAGACGGCATACGAGATGTCTATCATGAGGGTCAAGTGCACAGTCTA
s2_R_554_CTATCAGTCC	CAAGCAGAAGACGGCATACGAGATCTATCAGTCCAGGGTCAAGTGCACAGTCTA
s2_R_555_TCCTTAGCAA	CAAGCAGAAGACGGCATACGAGATTCCTTAGCAAAGGGTCAAGTGCACAGTCTA
s2_R_556_TGATGGACGG	CAAGCAGAAGACGGCATACGAGATTGATGGACGGAGGGTCAAGTGCACAGTCTA
s2_R_557_TTCTAAGTCG	CAAGCAGAAGACGGCATACGAGATTTCTAAGTCGAGGGTCAAGTGCACAGTCTA
s2_R_558_TTCACGTGCT	CAAGCAGAAGACGGCATACGAGATTTCACGTGCTAGGGTCAAGTGCACAGTCTA
s2_R_559_CATCTGCTCG	CAAGCAGAAGACGGCATACGAGATCATCTGCTCGAGGGTCAAGTGCACAGTCTA
s2_R_560_GATCGACGAT	CAAGCAGAAGACGGCATACGAGATGATCGACGATAGGGTCAAGTGCACAGTCTA
s2_R_561_TCGTCGGTAC	CAAGCAGAAGACGGCATACGAGATTCGTCGGTACAGGGTCAAGTGCACAGTCTA
s2_R_562_TGTGGTAGTT	CAAGCAGAAGACGGCATACGAGATTGTGGTAGTTAGGGTCAAGTGCACAGTCTA
s2_R_563_TTGGTGTCCG	CAAGCAGAAGACGGCATACGAGATTTGGTGTCCGAGGGTCAAGTGCACAGTCTA
s2_R_564_TGGTTCTCCG	CAAGCAGAAGACGGCATACGAGATTGGTTCTCCGAGGGTCAAGTGCACAGTCTA
s2_R_565_TCATCTACCG	CAAGCAGAAGACGGCATACGAGATTCATCTACCGAGGGTCAAGTGCACAGTCTA
s2_R_566_CTTAAGGCAT	CAAGCAGAAGACGGCATACGAGATCTTAAGGCATAGGGTCAAGTGCACAGTCTA
s2_R_567_CAGTGTGGTG	CAAGCAGAAGACGGCATACGAGATCAGTGTGGTGAGGGTCAAGTGCACAGTCTA
s2_R_568_TCCAGGTATT	CAAGCAGAAGACGGCATACGAGATTCCAGGTATTAGGGTCAAGTGCACAGTCTA
s2_R_569_GGCCTACACA	CAAGCAGAAGACGGCATACGAGATGGCCTACACAAGGGTCAAGTGCACAGTCTA
s2_R_570_TTAGAGCTTC	CAAGCAGAAGACGGCATACGAGATTTAGAGCTTCAGGGTCAAGTGCACAGTCTA
s2_R_571_CTTACGGAGC	CAAGCAGAAGACGGCATACGAGATCTTACGGAGCAGGGTCAAGTGCACAGTCTA
s2_R_572_GTGTGTTAAC	CAAGCAGAAGACGGCATACGAGATGTGTGTTAACAGGGTCAAGTGCACAGTCTA
s2_R_573_CAACCGATAT	CAAGCAGAAGACGGCATACGAGATCAACCGATATAGGGTCAAGTGCACAGTCTA
s2_R_574_GACCTGAGTT	CAAGCAGAAGACGGCATACGAGATGACCTGAGTTAGGGTCAAGTGCACAGTCTA
s2_R_575_CGGTGTTATT	CAAGCAGAAGACGGCATACGAGATCGGTGTTATTAGGGTCAAGTGCACAGTCTA
s2_R_576_TGCCTTGCAT	CAAGCAGAAGACGGCATACGAGATTGCCTTGCATAGGGTCAAGTGCACAGTCTA
s2_R_577_CTAACCTCTA	CAAGCAGAAGACGGCATACGAGATCTAACCTCTAAGGGTCAAGTGCACAGTCTA
s2_R_578_GACCTTCAGT	CAAGCAGAAGACGGCATACGAGATGACCTTCAGTAGGGTCAAGTGCACAGTCTA
s2_R_579_CACTTCGCCT	CAAGCAGAAGACGGCATACGAGATCACTTCGCCTAGGGTCAAGTGCACAGTCTA
s2_R_580_TTCAGGTAAC	CAAGCAGAAGACGGCATACGAGATTTCAGGTAACAGGGTCAAGTGCACAGTCTA
s2_R_581_GCGTGCTATG	CAAGCAGAAGACGGCATACGAGATGCGTGCTATGAGGGTCAAGTGCACAGTCTA
s2_R_582_TACCACACCT	CAAGCAGAAGACGGCATACGAGATTACCACACCTAGGGTCAAGTGCACAGTCTA
s2_R_583_TCTTCTAGAG	CAAGCAGAAGACGGCATACGAGATTCTTCTAGAGAGGGTCAAGTGCACAGTCTA
s2_R_584_TACCGATGAC	CAAGCAGAAGACGGCATACGAGATTACCGATGACAGGGTCAAGTGCACAGTCTA
s2_R_585_ACTCGGAGAG	CAAGCAGAAGACGGCATACGAGATACTCGGAGAGAGGGTCAAGTGCACAGTCTA
s2_R_586_GTATGTGTCA	CAAGCAGAAGACGGCATACGAGATGTATGTGTCAAGGGTCAAGTGCACAGTCTA
s2_R_587_CATAAGGCTG	CAAGCAGAAGACGGCATACGAGATCATAAGGCTGAGGGTCAAGTGCACAGTCTA
s2_R_588_TGGAGGCCTT	CAAGCAGAAGACGGCATACGAGATTGGAGGCCTTAGGGTCAAGTGCACAGTCTA
s2_R_589_GATCTAGGCG	CAAGCAGAAGACGGCATACGAGATGATCTAGGCGAGGGTCAAGTGCACAGTCTA
s2_R_590_TGACTCCAAC	CAAGCAGAAGACGGCATACGAGATTGACTCCAACAGGGTCAAGTGCACAGTCTA
s2_R_591_TCTACATGCT	CAAGCAGAAGACGGCATACGAGATTCTACATGCTAGGGTCAAGTGCACAGTCTA
s2_R_592_TCCAAGGTAC	CAAGCAGAAGACGGCATACGAGATTCCAAGGTACAGGGTCAAGTGCACAGTCTA
s2_R_593_TCTACGTGAA	CAAGCAGAAGACGGCATACGAGATTCTACGTGAAAGGGTCAAGTGCACAGTCTA
s2_R_594_GTCCACTAGT	CAAGCAGAAGACGGCATACGAGATGTCCACTAGTAGGGTCAAGTGCACAGTCTA
s2_R_595_CATGGAGCCA	CAAGCAGAAGACGGCATACGAGATCATGGAGCCAAGGGTCAAGTGCACAGTCTA
s2_R_596_GCTGCATTGT	CAAGCAGAAGACGGCATACGAGATGCTGCATTGTAGGGTCAAGTGCACAGTCTA
s2_R_597_TGCGGCTAAC	CAAGCAGAAGACGGCATACGAGATTGCGGCTAACAGGGTCAAGTGCACAGTCTA
s2_R_598_ACGGATGTTG	CAAGCAGAAGACGGCATACGAGATACGGATGTTGAGGGTCAAGTGCACAGTCTA
s2_R_599_ATAGGTATCG	CAAGCAGAAGACGGCATACGAGATATAGGTATCGAGGGTCAAGTGCACAGTCTA
s2_R_600_GTTAACCGAC	CAAGCAGAAGACGGCATACGAGATGTTAACCGACAGGGTCAAGTGCACAGTCTA
s2_R_601_GTAAGCTCAA	CAAGCAGAAGACGGCATACGAGATGTAAGCTCAAAGGGTCAAGTGCACAGTCTA
s2_R_602_TCTCAGAGAA	CAAGCAGAAGACGGCATACGAGATTCTCAGAGAAAGGGTCAAGTGCACAGTCTA
s2_R_603_TTCGGTTGAC	CAAGCAGAAGACGGCATACGAGATTTCGGTTGACAGGGTCAAGTGCACAGTCTA
s2_R_604_GGACTTGCGA	CAAGCAGAAGACGGCATACGAGATGGACTTGCGAAGGGTCAAGTGCACAGTCTA
s2_R_605_ACGGTAGTCC	CAAGCAGAAGACGGCATACGAGATACGGTAGTCCAGGGTCAAGTGCACAGTCTA
s2_R_606_TCCGAGACTT	CAAGCAGAAGACGGCATACGAGATTCCGAGACTTAGGGTCAAGTGCACAGTCTA
s2_R_607_CAGGATATGA	CAAGCAGAAGACGGCATACGAGATCAGGATATGAAGGGTCAAGTGCACAGTCTA
s2_R_608_CGGTATTAGA	CAAGCAGAAGACGGCATACGAGATCGGTATTAGAAGGGTCAAGTGCACAGTCTA
s2_R_609_TGAAGAGTGG	CAAGCAGAAGACGGCATACGAGATTGAAGAGTGGAGGGTCAAGTGCACAGTCTA
s2_R_610_TCGGTAAGGA	CAAGCAGAAGACGGCATACGAGATTCGGTAAGGAAGGGTCAAGTGCACAGTCTA
s2_R_611_TTGGATTGGT	CAAGCAGAAGACGGCATACGAGATTTGGATTGGTAGGGTCAAGTGCACAGTCTA
s2_R_612_TCGCCACACA	CAAGCAGAAGACGGCATACGAGATTCGCCACACAAGGGTCAAGTGCACAGTCTA
s2_R_613_TGAGTGAGAT	CAAGCAGAAGACGGCATACGAGATTGAGTGAGATAGGGTCAAGTGCACAGTCTA
s2_R_614_GTGGCAATGT	CAAGCAGAAGACGGCATACGAGATGTGGCAATGTAGGGTCAAGTGCACAGTCTA
s2_R_615_AGAAGTGGAA	CAAGCAGAAGACGGCATACGAGATAGAAGTGGAAAGGGTCAAGTGCACAGTCTA
s2_R_616_GTGAGTTGAT	CAAGCAGAAGACGGCATACGAGATGTGAGTTGATAGGGTCAAGTGCACAGTCTA
s2_R_617_GAAGTGAAGT	CAAGCAGAAGACGGCATACGAGATGAAGTGAAGTAGGGTCAAGTGCACAGTCTA
s2_R_618_CAGAGGTGTT	CAAGCAGAAGACGGCATACGAGATCAGAGGTGTTAGGGTCAAGTGCACAGTCTA
s2_R_619_TTGTGTAGAG	CAAGCAGAAGACGGCATACGAGATTTGTGTAGAGAGGGTCAAGTGCACAGTCTA
s2_R_620_TCATGGTGGT	CAAGCAGAAGACGGCATACGAGATTCATGGTGGTAGGGTCAAGTGCACAGTCTA
s2_R_621_CAGAGTTAGT	CAAGCAGAAGACGGCATACGAGATCAGAGTTAGTAGGGTCAAGTGCACAGTCTA
s2_R_622_GTGTTGTGTT	CAAGCAGAAGACGGCATACGAGATGTGTTGTGTTAGGGTCAAGTGCACAGTCTA
s2_R_623_GGTTGCGGTT	CAAGCAGAAGACGGCATACGAGATGGTTGCGGTTAGGGTCAAGTGCACAGTCTA
s2_R_624_GTCAATGGTT	CAAGCAGAAGACGGCATACGAGATGTCAATGGTTAGGGTCAAGTGCACAGTCTA
s2_R_625_GGTATTGTGA	CAAGCAGAAGACGGCATACGAGATGGTATTGTGAAGGGTCAAGTGCACAGTCTA
s2_R_626_GGAATGGAGT	CAAGCAGAAGACGGCATACGAGATGGAATGGAGTAGGGTCAAGTGCACAGTCTA
s2_R_627_TGAGATCAGT	CAAGCAGAAGACGGCATACGAGATTGAGATCAGTAGGGTCAAGTGCACAGTCTA
s2_R_628_TTAGCAGATC	CAAGCAGAAGACGGCATACGAGATTTAGCAGATCAGGGTCAAGTGCACAGTCTA
s2_R_629_GTGGTGATTG	CAAGCAGAAGACGGCATACGAGATGTGGTGATTGAGGGTCAAGTGCACAGTCTA
s2_R_630_TGATGTCTGT	CAAGCAGAAGACGGCATACGAGATTGATGTCTGTAGGGTCAAGTGCACAGTCTA
s2_R_631_TGTTCGGCAA	CAAGCAGAAGACGGCATACGAGATTGTTCGGCAAAGGGTCAAGTGCACAGTCTA
s2_R_632_TCGGTATCCA	CAAGCAGAAGACGGCATACGAGATTCGGTATCCAAGGGTCAAGTGCACAGTCTA
s2_R_633_GTGGTTGGTG	CAAGCAGAAGACGGCATACGAGATGTGGTTGGTGAGGGTCAAGTGCACAGTCTA
s2_R_634_GAGGATCTTG	CAAGCAGAAGACGGCATACGAGATGAGGATCTTGAGGGTCAAGTGCACAGTCTA
s2_R_635_TCGGTTATAG	CAAGCAGAAGACGGCATACGAGATTCGGTTATAGAGGGTCAAGTGCACAGTCTA
s2_R_636_GGATGGTATC	CAAGCAGAAGACGGCATACGAGATGGATGGTATCAGGGTCAAGTGCACAGTCTA
s2_R_637_TACGAACGAG	CAAGCAGAAGACGGCATACGAGATTACGAACGAGAGGGTCAAGTGCACAGTCTA
s2_R_638_GAACAGTTGT	CAAGCAGAAGACGGCATACGAGATGAACAGTTGTAGGGTCAAGTGCACAGTCTA
s2_R_639_GTGGTTCATT	CAAGCAGAAGACGGCATACGAGATGTGGTTCATTAGGGTCAAGTGCACAGTCTA
s2_R_640_GTCTAGATGT	CAAGCAGAAGACGGCATACGAGATGTCTAGATGTAGGGTCAAGTGCACAGTCTA
s2_R_641_GGTGAATTGA	CAAGCAGAAGACGGCATACGAGATGGTGAATTGAAGGGTCAAGTGCACAGTCTA
s2_R_642_TGGACGATAA	CAAGCAGAAGACGGCATACGAGATTGGACGATAAAGGGTCAAGTGCACAGTCTA
s2_R_643_GGTGATAAGA	CAAGCAGAAGACGGCATACGAGATGGTGATAAGAAGGGTCAAGTGCACAGTCTA
s2_R_644_TGCATGTAGG	CAAGCAGAAGACGGCATACGAGATTGCATGTAGGAGGGTCAAGTGCACAGTCTA
s2_R_645_TCCAGTGTGT	CAAGCAGAAGACGGCATACGAGATTCCAGTGTGTAGGGTCAAGTGCACAGTCTA
s2_R_646_GTCAACTACA	CAAGCAGAAGACGGCATACGAGATGTCAACTACAAGGGTCAAGTGCACAGTCTA
s2_R_647_TCCTCTCCAT	CAAGCAGAAGACGGCATACGAGATTCCTCTCCATAGGGTCAAGTGCACAGTCTA
s2_R_648_GTAATCGACT	CAAGCAGAAGACGGCATACGAGATGTAATCGACTAGGGTCAAGTGCACAGTCTA
s2_R_649_TAGCGTGACT	CAAGCAGAAGACGGCATACGAGATTAGCGTGACTAGGGTCAAGTGCACAGTCTA
s2_R_650_GTATAGGTGA	CAAGCAGAAGACGGCATACGAGATGTATAGGTGAAGGGTCAAGTGCACAGTCTA
s2_R_651_TGACGGTATA	CAAGCAGAAGACGGCATACGAGATTGACGGTATAAGGGTCAAGTGCACAGTCTA
s2_R_652_TACCTAATGG	CAAGCAGAAGACGGCATACGAGATTACCTAATGGAGGGTCAAGTGCACAGTCTA
s2_R_653_TCATTACGAG	CAAGCAGAAGACGGCATACGAGATTCATTACGAGAGGGTCAAGTGCACAGTCTA
s2_R_654_TTCACCATGT	CAAGCAGAAGACGGCATACGAGATTTCACCATGTAGGGTCAAGTGCACAGTCTA
s2_R_655_GTCTGTAGAA	CAAGCAGAAGACGGCATACGAGATGTCTGTAGAAAGGGTCAAGTGCACAGTCTA
s2_R_656_GTTCACAACT	CAAGCAGAAGACGGCATACGAGATGTTCACAACTAGGGTCAAGTGCACAGTCTA
s2_R_657_TACTCCTATC	CAAGCAGAAGACGGCATACGAGATTACTCCTATCAGGGTCAAGTGCACAGTCTA
s2_R_658_GTAGCGATAG	CAAGCAGAAGACGGCATACGAGATGTAGCGATAGAGGGTCAAGTGCACAGTCTA
s2_R_659_GGAGAGCGTT	CAAGCAGAAGACGGCATACGAGATGGAGAGCGTTAGGGTCAAGTGCACAGTCTA
s2_R_660_TATGCGTTAG	CAAGCAGAAGACGGCATACGAGATTATGCGTTAGAGGGTCAAGTGCACAGTCTA
s2_R_661_TTGACAGACA	CAAGCAGAAGACGGCATACGAGATTTGACAGACAAGGGTCAAGTGCACAGTCTA
s2_R_662_TGGATGACAT	CAAGCAGAAGACGGCATACGAGATTGGATGACATAGGGTCAAGTGCACAGTCTA
s2_R_663_GGTCTGAGAT	CAAGCAGAAGACGGCATACGAGATGGTCTGAGATAGGGTCAAGTGCACAGTCTA
s2_R_664_GGTAATTCTC	CAAGCAGAAGACGGCATACGAGATGGTAATTCTCAGGGTCAAGTGCACAGTCTA
s2_R_665_GGTAGTGTAT	CAAGCAGAAGACGGCATACGAGATGGTAGTGTATAGGGTCAAGTGCACAGTCTA
s2_R_666_TTCCTGTAGT	CAAGCAGAAGACGGCATACGAGATTTCCTGTAGTAGGGTCAAGTGCACAGTCTA
s2_R_667_GTGGTAAGAA	CAAGCAGAAGACGGCATACGAGATGTGGTAAGAAAGGGTCAAGTGCACAGTCTA
s2_R_668_TGTCTCCTCA	CAAGCAGAAGACGGCATACGAGATTGTCTCCTCAAGGGTCAAGTGCACAGTCTA
s2_R_669_GGTGAAGAGT	CAAGCAGAAGACGGCATACGAGATGGTGAAGAGTAGGGTCAAGTGCACAGTCTA
s2_R_670_TTGTGTGTTG	CAAGCAGAAGACGGCATACGAGATTTGTGTGTTGAGGGTCAAGTGCACAGTCTA
s2_R_671_GTAGAGAGGA	CAAGCAGAAGACGGCATACGAGATGTAGAGAGGAAGGGTCAAGTGCACAGTCTA
s2_R_672_TCCAACGAAG	CAAGCAGAAGACGGCATACGAGATTCCAACGAAGAGGGTCAAGTGCACAGTCTA
s2_R_673_TACGGTTACT	CAAGCAGAAGACGGCATACGAGATTACGGTTACTAGGGTCAAGTGCACAGTCTA
s2_R_674_TACCAGTAAG	CAAGCAGAAGACGGCATACGAGATTACCAGTAAGAGGGTCAAGTGCACAGTCTA
s2_R_675_GTGTTCCAAT	CAAGCAGAAGACGGCATACGAGATGTGTTCCAATAGGGTCAAGTGCACAGTCTA
s2_R_676_TGGCTGGATC	CAAGCAGAAGACGGCATACGAGATTGGCTGGATCAGGGTCAAGTGCACAGTCTA
s2_R_677_GTTGGCATTC	CAAGCAGAAGACGGCATACGAGATGTTGGCATTCAGGGTCAAGTGCACAGTCTA
s2_R_678_TAGGTACTAG	CAAGCAGAAGACGGCATACGAGATTAGGTACTAGAGGGTCAAGTGCACAGTCTA
s2_R_679_GTTCACAGAA	CAAGCAGAAGACGGCATACGAGATGTTCACAGAAAGGGTCAAGTGCACAGTCTA
s2_R_680_TGCTTCGGAT	CAAGCAGAAGACGGCATACGAGATTGCTTCGGATAGGGTCAAGTGCACAGTCTA
s2_R_681_TTCAACTTCC	CAAGCAGAAGACGGCATACGAGATTTCAACTTCCAGGGTCAAGTGCACAGTCTA
s2_R_682_TGTCACATAG	CAAGCAGAAGACGGCATACGAGATTGTCACATAGAGGGTCAAGTGCACAGTCTA
s2_R_683_TGCTACCATT	CAAGCAGAAGACGGCATACGAGATTGCTACCATTAGGGTCAAGTGCACAGTCTA
s2_R_684_TTGGAAGAGT	CAAGCAGAAGACGGCATACGAGATTTGGAAGAGTAGGGTCAAGTGCACAGTCTA
s2_R_685_TTCTCCTACT	CAAGCAGAAGACGGCATACGAGATTTCTCCTACTAGGGTCAAGTGCACAGTCTA
s2_R_686_TGCATGGATA	CAAGCAGAAGACGGCATACGAGATTGCATGGATAAGGGTCAAGTGCACAGTCTA
s2_R_687_TTAGCGATGA	CAAGCAGAAGACGGCATACGAGATTTAGCGATGAAGGGTCAAGTGCACAGTCTA
s2_R_688_TTCAAGGCTA	CAAGCAGAAGACGGCATACGAGATTTCAAGGCTAAGGGTCAAGTGCACAGTCTA
s2_R_689_GTAGGTATGC	CAAGCAGAAGACGGCATACGAGATGTAGGTATGCAGGGTCAAGTGCACAGTCTA
s2_R_690_GTCAACCAAG	CAAGCAGAAGACGGCATACGAGATGTCAACCAAGAGGGTCAAGTGCACAGTCTA
s2_R_691_TCGATCAGGC	CAAGCAGAAGACGGCATACGAGATTCGATCAGGCAGGGTCAAGTGCACAGTCTA
s2_R_692_TGTCTGACTC	CAAGCAGAAGACGGCATACGAGATTGTCTGACTCAGGGTCAAGTGCACAGTCTA
s2_R_693_CTTGCGCCAT	CAAGCAGAAGACGGCATACGAGATCTTGCGCCATAGGGTCAAGTGCACAGTCTA
s2_R_694_TCTCTCTGAC	CAAGCAGAAGACGGCATACGAGATTCTCTCTGACAGGGTCAAGTGCACAGTCTA
s2_R_695_TCCTTAAGCC	CAAGCAGAAGACGGCATACGAGATTCCTTAAGCCAGGGTCAAGTGCACAGTCTA
s2_R_696_AGCTATGCCA	CAAGCAGAAGACGGCATACGAGATAGCTATGCCAAGGGTCAAGTGCACAGTCTA
s2_R_697_AGCAGTCCTG	CAAGCAGAAGACGGCATACGAGATAGCAGTCCTGAGGGTCAAGTGCACAGTCTA
s2_R_698_TACCGCCAGT	CAAGCAGAAGACGGCATACGAGATTACCGCCAGTAGGGTCAAGTGCACAGTCTA
s2_R_699_TCTCCAGTGT	CAAGCAGAAGACGGCATACGAGATTCTCCAGTGTAGGGTCAAGTGCACAGTCTA
s2_R_700_TCGTCATAAC	CAAGCAGAAGACGGCATACGAGATTCGTCATAACAGGGTCAAGTGCACAGTCTA
s2_R_701_TGTCTACGTT	CAAGCAGAAGACGGCATACGAGATTGTCTACGTTAGGGTCAAGTGCACAGTCTA
s2_R_702_GTCCAACGTG	CAAGCAGAAGACGGCATACGAGATGTCCAACGTGAGGGTCAAGTGCACAGTCTA
s2_R_703_TCTCTTGAAG	CAAGCAGAAGACGGCATACGAGATTCTCTTGAAGAGGGTCAAGTGCACAGTCTA
s2_R_704_TAACATGAGC	CAAGCAGAAGACGGCATACGAGATTAACATGAGCAGGGTCAAGTGCACAGTCTA
s2_R_705_TCTGTTCGTT	CAAGCAGAAGACGGCATACGAGATTCTGTTCGTTAGGGTCAAGTGCACAGTCTA
s2_R_706_GGAGGCAATA	CAAGCAGAAGACGGCATACGAGATGGAGGCAATAAGGGTCAAGTGCACAGTCTA
s2_R_707_TTGATACTCG	CAAGCAGAAGACGGCATACGAGATTTGATACTCGAGGGTCAAGTGCACAGTCTA
s2_R_708_TTCAGAGATG	CAAGCAGAAGACGGCATACGAGATTTCAGAGATGAGGGTCAAGTGCACAGTCTA
s2_R_709_TGAGTCAACG	CAAGCAGAAGACGGCATACGAGATTGAGTCAACGAGGGTCAAGTGCACAGTCTA
s2_R_710_CCTTACGTTG	CAAGCAGAAGACGGCATACGAGATCCTTACGTTGAGGGTCAAGTGCACAGTCTA
s2_R_711_TGGAACTACA	CAAGCAGAAGACGGCATACGAGATTGGAACTACAAGGGTCAAGTGCACAGTCTA
s2_R_712_TAGCGTCCTA	CAAGCAGAAGACGGCATACGAGATTAGCGTCCTAAGGGTCAAGTGCACAGTCTA
s2_R_713_GTTGAGCAAT	CAAGCAGAAGACGGCATACGAGATGTTGAGCAATAGGGTCAAGTGCACAGTCTA
s2_R_714_GGCTATTGGT	CAAGCAGAAGACGGCATACGAGATGGCTATTGGTAGGGTCAAGTGCACAGTCTA
s2_R_715_TCGTTGACAC	CAAGCAGAAGACGGCATACGAGATTCGTTGACACAGGGTCAAGTGCACAGTCTA
s2_R_716_TGCCAGATGT	CAAGCAGAAGACGGCATACGAGATTGCCAGATGTAGGGTCAAGTGCACAGTCTA
s2_R_717_GTCAGGCTAC	CAAGCAGAAGACGGCATACGAGATGTCAGGCTACAGGGTCAAGTGCACAGTCTA
s2_R_718_TGCTACTGTC	CAAGCAGAAGACGGCATACGAGATTGCTACTGTCAGGGTCAAGTGCACAGTCTA
s2_R_719_TGCTCGTCAT	CAAGCAGAAGACGGCATACGAGATTGCTCGTCATAGGGTCAAGTGCACAGTCTA
s2_R_720_TGCTGTGTAA	CAAGCAGAAGACGGCATACGAGATTGCTGTGTAAAGGGTCAAGTGCACAGTCTA
s2_R_721_TAGAACTCGT	CAAGCAGAAGACGGCATACGAGATTAGAACTCGTAGGGTCAAGTGCACAGTCTA
s2_R_722_TCACATCCTG	CAAGCAGAAGACGGCATACGAGATTCACATCCTGAGGGTCAAGTGCACAGTCTA
s2_R_723_AGAGAAGTGG	CAAGCAGAAGACGGCATACGAGATAGAGAAGTGGAGGGTCAAGTGCACAGTCTA
s2_R_724_TCACGTCTGG	CAAGCAGAAGACGGCATACGAGATTCACGTCTGGAGGGTCAAGTGCACAGTCTA
s2_R_725_TCGCGACGTT	CAAGCAGAAGACGGCATACGAGATTCGCGACGTTAGGGTCAAGTGCACAGTCTA
s2_R_726_TGTACTAAGC	CAAGCAGAAGACGGCATACGAGATTGTACTAAGCAGGGTCAAGTGCACAGTCTA
s2_R_727_GGTCATGGAA	CAAGCAGAAGACGGCATACGAGATGGTCATGGAAAGGGTCAAGTGCACAGTCTA
s2_R_728_GGTCAAGTAG	CAAGCAGAAGACGGCATACGAGATGGTCAAGTAGAGGGTCAAGTGCACAGTCTA
s2_R_729_TCAGCATGGA	CAAGCAGAAGACGGCATACGAGATTCAGCATGGAAGGGTCAAGTGCACAGTCTA
s2_R_730_TAACGCTGTT	CAAGCAGAAGACGGCATACGAGATTAACGCTGTTAGGGTCAAGTGCACAGTCTA
s2_R_731_GTAGAACTGG	CAAGCAGAAGACGGCATACGAGATGTAGAACTGGAGGGTCAAGTGCACAGTCTA
s2_R_732_TGGCTACCTG	CAAGCAGAAGACGGCATACGAGATTGGCTACCTGAGGGTCAAGTGCACAGTCTA
s2_R_733_CGTACCAACT	CAAGCAGAAGACGGCATACGAGATCGTACCAACTAGGGTCAAGTGCACAGTCTA
s2_R_734_TAGAGAGTAG	CAAGCAGAAGACGGCATACGAGATTAGAGAGTAGAGGGTCAAGTGCACAGTCTA
s2_R_735_TGTGTTAGCG	CAAGCAGAAGACGGCATACGAGATTGTGTTAGCGAGGGTCAAGTGCACAGTCTA
s2_R_736_TACAACGGCT	CAAGCAGAAGACGGCATACGAGATTACAACGGCTAGGGTCAAGTGCACAGTCTA
s2_R_737_GGCTGGTGAA	CAAGCAGAAGACGGCATACGAGATGGCTGGTGAAAGGGTCAAGTGCACAGTCTA
s2_R_738_TGAGTAGAGG	CAAGCAGAAGACGGCATACGAGATTGAGTAGAGGAGGGTCAAGTGCACAGTCTA
s2_R_739_GGCTTAGGTA	CAAGCAGAAGACGGCATACGAGATGGCTTAGGTAAGGGTCAAGTGCACAGTCTA
s2_R_740_TCTAAGCTCA	CAAGCAGAAGACGGCATACGAGATTCTAAGCTCAAGGGTCAAGTGCACAGTCTA
s2_R_741_CGACTTCTTG	CAAGCAGAAGACGGCATACGAGATCGACTTCTTGAGGGTCAAGTGCACAGTCTA
s2_R_742_GTTGAGATGG	CAAGCAGAAGACGGCATACGAGATGTTGAGATGGAGGGTCAAGTGCACAGTCTA
s2_R_743_TTGGATACAG	CAAGCAGAAGACGGCATACGAGATTTGGATACAGAGGGTCAAGTGCACAGTCTA
s2_R_744_TTATCCAGGA	CAAGCAGAAGACGGCATACGAGATTTATCCAGGAAGGGTCAAGTGCACAGTCTA
s2_R_745_TTGCAACTGT	CAAGCAGAAGACGGCATACGAGATTTGCAACTGTAGGGTCAAGTGCACAGTCTA
s2_R_746_ACGACCGATA	CAAGCAGAAGACGGCATACGAGATACGACCGATAAGGGTCAAGTGCACAGTCTA
s2_R_747_CTCAGGCCTT	CAAGCAGAAGACGGCATACGAGATCTCAGGCCTTAGGGTCAAGTGCACAGTCTA
s2_R_748_TTACACGAGG	CAAGCAGAAGACGGCATACGAGATTTACACGAGGAGGGTCAAGTGCACAGTCTA
s2_R_749_TAACTCCTTG	CAAGCAGAAGACGGCATACGAGATTAACTCCTTGAGGGTCAAGTGCACAGTCTA
s2_R_750_CATTCACGAA	CAAGCAGAAGACGGCATACGAGATCATTCACGAAAGGGTCAAGTGCACAGTCTA
s2_R_751_GGTGTCACAA	CAAGCAGAAGACGGCATACGAGATGGTGTCACAAAGGGTCAAGTGCACAGTCTA
s2_R_752_TGTAGACAAC	CAAGCAGAAGACGGCATACGAGATTGTAGACAACAGGGTCAAGTGCACAGTCTA
s2_R_753_TACGGAGTAC	CAAGCAGAAGACGGCATACGAGATTACGGAGTACAGGGTCAAGTGCACAGTCTA
s2_R_754_TTAGCAGTGT	CAAGCAGAAGACGGCATACGAGATTTAGCAGTGTAGGGTCAAGTGCACAGTCTA
s2_R_755_ACTTCATCTC	CAAGCAGAAGACGGCATACGAGATACTTCATCTCAGGGTCAAGTGCACAGTCTA
s2_R_756_CTGTTAGAAC	CAAGCAGAAGACGGCATACGAGATCTGTTAGAACAGGGTCAAGTGCACAGTCTA
s2_R_757_TTCGGTACAT	CAAGCAGAAGACGGCATACGAGATTTCGGTACATAGGGTCAAGTGCACAGTCTA
s2_R_758_TTCGGAACTG	CAAGCAGAAGACGGCATACGAGATTTCGGAACTGAGGGTCAAGTGCACAGTCTA
s2_R_759_GTTAACTGGT	CAAGCAGAAGACGGCATACGAGATGTTAACTGGTAGGGTCAAGTGCACAGTCTA
s2_R_760_TGGTAGGCTC	CAAGCAGAAGACGGCATACGAGATTGGTAGGCTCAGGGTCAAGTGCACAGTCTA
s2_R_761_TTATGGAACC	CAAGCAGAAGACGGCATACGAGATTTATGGAACCAGGGTCAAGTGCACAGTCTA
s2_R_762_GAGGCGTTGT	CAAGCAGAAGACGGCATACGAGATGAGGCGTTGTAGGGTCAAGTGCACAGTCTA
s2_R_763_TACCGGCTAC	CAAGCAGAAGACGGCATACGAGATTACCGGCTACAGGGTCAAGTGCACAGTCTA
s2_R_764_GTTCTAGTGA	CAAGCAGAAGACGGCATACGAGATGTTCTAGTGAAGGGTCAAGTGCACAGTCTA
s2_R_765_GTTGAAGCTC	CAAGCAGAAGACGGCATACGAGATGTTGAAGCTCAGGGTCAAGTGCACAGTCTA
s2_R_766_GGAGTAACTG	CAAGCAGAAGACGGCATACGAGATGGAGTAACTGAGGGTCAAGTGCACAGTCTA
s2_R_767_CTACACTATC	CAAGCAGAAGACGGCATACGAGATCTACACTATCAGGGTCAAGTGCACAGTCTA
s2_R_768_TGCAAGTCCG	CAAGCAGAAGACGGCATACGAGATTGCAAGTCCGAGGGTCAAGTGCACAGTCTA
s2_R_769_CTTCCACCGA	CAAGCAGAAGACGGCATACGAGATCTTCCACCGAAGGGTCAAGTGCACAGTCTA
s2_R_770_TATCCTCACT	CAAGCAGAAGACGGCATACGAGATTATCCTCACTAGGGTCAAGTGCACAGTCTA
s2_R_771_CATCACGTGT	CAAGCAGAAGACGGCATACGAGATCATCACGTGTAGGGTCAAGTGCACAGTCTA
s2_R_772_ATCAGCTCAG	CAAGCAGAAGACGGCATACGAGATATCAGCTCAGAGGGTCAAGTGCACAGTCTA
s2_R_773_TTAGGTGCCT	CAAGCAGAAGACGGCATACGAGATTTAGGTGCCTAGGGTCAAGTGCACAGTCTA
s2_R_774_CTAGCTCAAT	CAAGCAGAAGACGGCATACGAGATCTAGCTCAATAGGGTCAAGTGCACAGTCTA
s2_R_775_CAACGATTGT	CAAGCAGAAGACGGCATACGAGATCAACGATTGTAGGGTCAAGTGCACAGTCTA
s2_R_776_GTCTCCATGC	CAAGCAGAAGACGGCATACGAGATGTCTCCATGCAGGGTCAAGTGCACAGTCTA
s2_R_777_TTCGGACTAA	CAAGCAGAAGACGGCATACGAGATTTCGGACTAAAGGGTCAAGTGCACAGTCTA
s2_R_778_TATGAGGCAT	CAAGCAGAAGACGGCATACGAGATTATGAGGCATAGGGTCAAGTGCACAGTCTA
s2_R_779_GCGTGTGATA	CAAGCAGAAGACGGCATACGAGATGCGTGTGATAAGGGTCAAGTGCACAGTCTA
s2_R_780_TACGCTGAAG	CAAGCAGAAGACGGCATACGAGATTACGCTGAAGAGGGTCAAGTGCACAGTCTA
s2_R_781_TACTGTCTCA	CAAGCAGAAGACGGCATACGAGATTACTGTCTCAAGGGTCAAGTGCACAGTCTA
s2_R_782_GGTTGGTCAC	CAAGCAGAAGACGGCATACGAGATGGTTGGTCACAGGGTCAAGTGCACAGTCTA
s2_R_783_GACACGGTAT	CAAGCAGAAGACGGCATACGAGATGACACGGTATAGGGTCAAGTGCACAGTCTA
s2_R_784_TTCAACCGTG	CAAGCAGAAGACGGCATACGAGATTTCAACCGTGAGGGTCAAGTGCACAGTCTA
s2_R_785_TCCAACAGCG	CAAGCAGAAGACGGCATACGAGATTCCAACAGCGAGGGTCAAGTGCACAGTCTA
s2_R_786_TCTTGTCAGC	CAAGCAGAAGACGGCATACGAGATTCTTGTCAGCAGGGTCAAGTGCACAGTCTA
s2_R_787_TATCGTCATC	CAAGCAGAAGACGGCATACGAGATTATCGTCATCAGGGTCAAGTGCACAGTCTA
s2_R_788_TTAGGATCCA	CAAGCAGAAGACGGCATACGAGATTTAGGATCCAAGGGTCAAGTGCACAGTCTA
s2_R_789_TGTGGTTCTG	CAAGCAGAAGACGGCATACGAGATTGTGGTTCTGAGGGTCAAGTGCACAGTCTA
s2_R_790_TGCGTGGTCA	CAAGCAGAAGACGGCATACGAGATTGCGTGGTCAAGGGTCAAGTGCACAGTCTA
s2_R_791_GGATTCGCTT	CAAGCAGAAGACGGCATACGAGATGGATTCGCTTAGGGTCAAGTGCACAGTCTA
s2_R_792_TTCGCGTTAA	CAAGCAGAAGACGGCATACGAGATTTCGCGTTAAAGGGTCAAGTGCACAGTCTA
s2_R_793_TCATCGTCGA	CAAGCAGAAGACGGCATACGAGATTCATCGTCGAAGGGTCAAGTGCACAGTCTA
s2_R_794_TGTCTTGCTA	CAAGCAGAAGACGGCATACGAGATTGTCTTGCTAAGGGTCAAGTGCACAGTCTA
s2_R_795_CCGAGAAGAA	CAAGCAGAAGACGGCATACGAGATCCGAGAAGAAAGGGTCAAGTGCACAGTCTA
s2_R_796_TTAGACACTC	CAAGCAGAAGACGGCATACGAGATTTAGACACTCAGGGTCAAGTGCACAGTCTA
s2_R_797_TACGTGTAGA	CAAGCAGAAGACGGCATACGAGATTACGTGTAGAAGGGTCAAGTGCACAGTCTA
s2_R_798_TTGCCAGCTT	CAAGCAGAAGACGGCATACGAGATTTGCCAGCTTAGGGTCAAGTGCACAGTCTA
s2_R_799_ACCTCTCGGA	CAAGCAGAAGACGGCATACGAGATACCTCTCGGAAGGGTCAAGTGCACAGTCTA
s2_R_800_GCTTGCTCCT	CAAGCAGAAGACGGCATACGAGATGCTTGCTCCTAGGGTCAAGTGCACAGTCTA
s2_R_801_TCCGATTCTC	CAAGCAGAAGACGGCATACGAGATTCCGATTCTCAGGGTCAAGTGCACAGTCTA
s2_R_802_TTGTGTGCGT	CAAGCAGAAGACGGCATACGAGATTTGTGTGCGTAGGGTCAAGTGCACAGTCTA
s2_R_803_GTTCCACATT	CAAGCAGAAGACGGCATACGAGATGTTCCACATTAGGGTCAAGTGCACAGTCTA
s2_R_804_GGAGAGAATC	CAAGCAGAAGACGGCATACGAGATGGAGAGAATCAGGGTCAAGTGCACAGTCTA
s2_R_805_GTGTAAGCAC	CAAGCAGAAGACGGCATACGAGATGTGTAAGCACAGGGTCAAGTGCACAGTCTA
s2_R_806_GGATTGGACG	CAAGCAGAAGACGGCATACGAGATGGATTGGACGAGGGTCAAGTGCACAGTCTA
s2_R_807_TTCACCAACG	CAAGCAGAAGACGGCATACGAGATTTCACCAACGAGGGTCAAGTGCACAGTCTA
s2_R_808_GTGATAGACG	CAAGCAGAAGACGGCATACGAGATGTGATAGACGAGGGTCAAGTGCACAGTCTA
s2_R_809_TTGTTCGACG	CAAGCAGAAGACGGCATACGAGATTTGTTCGACGAGGGTCAAGTGCACAGTCTA
s2_R_810_TTGGACAACG	CAAGCAGAAGACGGCATACGAGATTTGGACAACGAGGGTCAAGTGCACAGTCTA
s2_R_811_TGCTGTGAGT	CAAGCAGAAGACGGCATACGAGATTGCTGTGAGTAGGGTCAAGTGCACAGTCTA
s2_R_812_GAGTTCGGTA	CAAGCAGAAGACGGCATACGAGATGAGTTCGGTAAGGGTCAAGTGCACAGTCTA
s2_R_813_TACGCGTCGT	CAAGCAGAAGACGGCATACGAGATTACGCGTCGTAGGGTCAAGTGCACAGTCTA
s2_R_814_TTCCAGATCG	CAAGCAGAAGACGGCATACGAGATTTCCAGATCGAGGGTCAAGTGCACAGTCTA
s2_R_815_CACTATCCGA	CAAGCAGAAGACGGCATACGAGATCACTATCCGAAGGGTCAAGTGCACAGTCTA
s2_R_816_GACAGTAAGA	CAAGCAGAAGACGGCATACGAGATGACAGTAAGAAGGGTCAAGTGCACAGTCTA
s2_R_817_TCCATACGAT	CAAGCAGAAGACGGCATACGAGATTCCATACGATAGGGTCAAGTGCACAGTCTA
s2_R_818_TCGTGGAGTG	CAAGCAGAAGACGGCATACGAGATTCGTGGAGTGAGGGTCAAGTGCACAGTCTA
s2_R_819_TCTCACGAGT	CAAGCAGAAGACGGCATACGAGATTCTCACGAGTAGGGTCAAGTGCACAGTCTA
s2_R_820_TGATTCCAGG	CAAGCAGAAGACGGCATACGAGATTGATTCCAGGAGGGTCAAGTGCACAGTCTA
s2_R_821_TCCGGTTCGA	CAAGCAGAAGACGGCATACGAGATTCCGGTTCGAAGGGTCAAGTGCACAGTCTA
s2_R_822_CTAATGCGAC	CAAGCAGAAGACGGCATACGAGATCTAATGCGACAGGGTCAAGTGCACAGTCTA
s2_R_823_TAGGTGTGGC	CAAGCAGAAGACGGCATACGAGATTAGGTGTGGCAGGGTCAAGTGCACAGTCTA
s2_R_824_GTTACACGGC	CAAGCAGAAGACGGCATACGAGATGTTACACGGCAGGGTCAAGTGCACAGTCTA
s2_R_825_TGGAATCGGC	CAAGCAGAAGACGGCATACGAGATTGGAATCGGCAGGGTCAAGTGCACAGTCTA
s2_R_826_ATCCGTGAGT	CAAGCAGAAGACGGCATACGAGATATCCGTGAGTAGGGTCAAGTGCACAGTCTA
s2_R_827_CCGTACGCTT	CAAGCAGAAGACGGCATACGAGATCCGTACGCTTAGGGTCAAGTGCACAGTCTA
s2_R_828_TGAGAAGGTC	CAAGCAGAAGACGGCATACGAGATTGAGAAGGTCAGGGTCAAGTGCACAGTCTA
s2_R_829_TAAGGCCTAT	CAAGCAGAAGACGGCATACGAGATTAAGGCCTATAGGGTCAAGTGCACAGTCTA
s2_R_830_GGTAGGCCAT	CAAGCAGAAGACGGCATACGAGATGGTAGGCCATAGGGTCAAGTGCACAGTCTA
s2_R_831_GGCCTTCAAC	CAAGCAGAAGACGGCATACGAGATGGCCTTCAACAGGGTCAAGTGCACAGTCTA
s2_R_832_CCGAATTGAA	CAAGCAGAAGACGGCATACGAGATCCGAATTGAAAGGGTCAAGTGCACAGTCTA
s2_R_833_TATTGGTGTC	CAAGCAGAAGACGGCATACGAGATTATTGGTGTCAGGGTCAAGTGCACAGTCTA
s2_R_834_CAAGCGGTGT	CAAGCAGAAGACGGCATACGAGATCAAGCGGTGTAGGGTCAAGTGCACAGTCTA
s2_R_835_TGTCGAACAG	CAAGCAGAAGACGGCATACGAGATTGTCGAACAGAGGGTCAAGTGCACAGTCTA
s2_R_836_CTATTCCTAC	CAAGCAGAAGACGGCATACGAGATCTATTCCTACAGGGTCAAGTGCACAGTCTA
s2_R_837_TGTCGATGAT	CAAGCAGAAGACGGCATACGAGATTGTCGATGATAGGGTCAAGTGCACAGTCTA
s2_R_838_CATCGCGTTC	CAAGCAGAAGACGGCATACGAGATCATCGCGTTCAGGGTCAAGTGCACAGTCTA
s2_R_839_ATCCGCCTAT	CAAGCAGAAGACGGCATACGAGATATCCGCCTATAGGGTCAAGTGCACAGTCTA
s2_R_840_GAATGCGGAG	CAAGCAGAAGACGGCATACGAGATGAATGCGGAGAGGGTCAAGTGCACAGTCTA
s2_R_841_AGTTGGCAGT	CAAGCAGAAGACGGCATACGAGATAGTTGGCAGTAGGGTCAAGTGCACAGTCTA
s2_R_842_TCGTGTACTT	CAAGCAGAAGACGGCATACGAGATTCGTGTACTTAGGGTCAAGTGCACAGTCTA
s2_R_843_TTGAGCTGGT	CAAGCAGAAGACGGCATACGAGATTTGAGCTGGTAGGGTCAAGTGCACAGTCTA
s2_R_844_GTGCGGAGTT	CAAGCAGAAGACGGCATACGAGATGTGCGGAGTTAGGGTCAAGTGCACAGTCTA
s2_R_845_AGGCTGAATG	CAAGCAGAAGACGGCATACGAGATAGGCTGAATGAGGGTCAAGTGCACAGTCTA
s2_R_846_CTGTTCCTGG	CAAGCAGAAGACGGCATACGAGATCTGTTCCTGGAGGGTCAAGTGCACAGTCTA
s2_R_847_GGAGTCGACA	CAAGCAGAAGACGGCATACGAGATGGAGTCGACAAGGGTCAAGTGCACAGTCTA
s2_R_848_TCGCCTAATG	CAAGCAGAAGACGGCATACGAGATTCGCCTAATGAGGGTCAAGTGCACAGTCTA
s2_R_849_ACGGTGAGAG	CAAGCAGAAGACGGCATACGAGATACGGTGAGAGAGGGTCAAGTGCACAGTCTA
s2_R_850_GGTCATTAGT	CAAGCAGAAGACGGCATACGAGATGGTCATTAGTAGGGTCAAGTGCACAGTCTA
s2_R_851_TGGTGGACCT	CAAGCAGAAGACGGCATACGAGATTGGTGGACCTAGGGTCAAGTGCACAGTCTA
s2_R_852_CCAGTAGCAT	CAAGCAGAAGACGGCATACGAGATCCAGTAGCATAGGGTCAAGTGCACAGTCTA
s2_R_853_CCGCCATAGT	CAAGCAGAAGACGGCATACGAGATCCGCCATAGTAGGGTCAAGTGCACAGTCTA
s2_R_854_GAACACAGTT	CAAGCAGAAGACGGCATACGAGATGAACACAGTTAGGGTCAAGTGCACAGTCTA
s2_R_855_GACAGGCTCT	CAAGCAGAAGACGGCATACGAGATGACAGGCTCTAGGGTCAAGTGCACAGTCTA
s2_R_856_GTTACTCCTT	CAAGCAGAAGACGGCATACGAGATGTTACTCCTTAGGGTCAAGTGCACAGTCTA
s2_R_857_GATGTCGGAA	CAAGCAGAAGACGGCATACGAGATGATGTCGGAAAGGGTCAAGTGCACAGTCTA
s2_R_858_TGCCTTCTCC	CAAGCAGAAGACGGCATACGAGATTGCCTTCTCCAGGGTCAAGTGCACAGTCTA
s2_R_859_TATCAAGACG	CAAGCAGAAGACGGCATACGAGATTATCAAGACGAGGGTCAAGTGCACAGTCTA
s2_R_860_CAACATGTCC	CAAGCAGAAGACGGCATACGAGATCAACATGTCCAGGGTCAAGTGCACAGTCTA
s2_R_861_GGTCATCTTC	CAAGCAGAAGACGGCATACGAGATGGTCATCTTCAGGGTCAAGTGCACAGTCTA
s2_R_862_TAGACATCGA	CAAGCAGAAGACGGCATACGAGATTAGACATCGAAGGGTCAAGTGCACAGTCTA
s2_R_863_GCTTCGCCTA	CAAGCAGAAGACGGCATACGAGATGCTTCGCCTAAGGGTCAAGTGCACAGTCTA
s2_R_864_CAGATGGAGG	CAAGCAGAAGACGGCATACGAGATCAGATGGAGGAGGGTCAAGTGCACAGTCTA
s2_R_865_GTGATGGCTC	CAAGCAGAAGACGGCATACGAGATGTGATGGCTCAGGGTCAAGTGCACAGTCTA
s2_R_866_TAGCAGAAGA	CAAGCAGAAGACGGCATACGAGATTAGCAGAAGAAGGGTCAAGTGCACAGTCTA
s2_R_867_AGTCTCGCCA	CAAGCAGAAGACGGCATACGAGATAGTCTCGCCAAGGGTCAAGTGCACAGTCTA
s2_R_868_TAGTGTAAGC	CAAGCAGAAGACGGCATACGAGATTAGTGTAAGCAGGGTCAAGTGCACAGTCTA
s2_R_869_TTGTAGGAGC	CAAGCAGAAGACGGCATACGAGATTTGTAGGAGCAGGGTCAAGTGCACAGTCTA
s2_R_870_TCATGGCTCA	CAAGCAGAAGACGGCATACGAGATTCATGGCTCAAGGGTCAAGTGCACAGTCTA
s2_R_871_GATGACACTT	CAAGCAGAAGACGGCATACGAGATGATGACACTTAGGGTCAAGTGCACAGTCTA
s2_R_872_TGTGAGAGGT	CAAGCAGAAGACGGCATACGAGATTGTGAGAGGTAGGGTCAAGTGCACAGTCTA
s2_R_873_CAACGGAGTT	CAAGCAGAAGACGGCATACGAGATCAACGGAGTTAGGGTCAAGTGCACAGTCTA
s2_R_874_GTTCCGCTAA	CAAGCAGAAGACGGCATACGAGATGTTCCGCTAAAGGGTCAAGTGCACAGTCTA
s2_R_875_CCTCCGAGAT	CAAGCAGAAGACGGCATACGAGATCCTCCGAGATAGGGTCAAGTGCACAGTCTA
s2_R_876_CAATGGAAGC	CAAGCAGAAGACGGCATACGAGATCAATGGAAGCAGGGTCAAGTGCACAGTCTA
s2_R_877_TGTTCCAGCT	CAAGCAGAAGACGGCATACGAGATTGTTCCAGCTAGGGTCAAGTGCACAGTCTA
s2_R_878_CTGAACGGCT	CAAGCAGAAGACGGCATACGAGATCTGAACGGCTAGGGTCAAGTGCACAGTCTA
s2_R_879_TGCCATCCTC	CAAGCAGAAGACGGCATACGAGATTGCCATCCTCAGGGTCAAGTGCACAGTCTA
s2_R_880_GGCACAACTA	CAAGCAGAAGACGGCATACGAGATGGCACAACTAAGGGTCAAGTGCACAGTCTA
s2_R_881_TACGCCATCC	CAAGCAGAAGACGGCATACGAGATTACGCCATCCAGGGTCAAGTGCACAGTCTA
s2_R_882_GGTCGGTAAT	CAAGCAGAAGACGGCATACGAGATGGTCGGTAATAGGGTCAAGTGCACAGTCTA
s2_R_883_GGTCTATGAC	CAAGCAGAAGACGGCATACGAGATGGTCTATGACAGGGTCAAGTGCACAGTCTA
s2_R_884_TGTCGACCGA	CAAGCAGAAGACGGCATACGAGATTGTCGACCGAAGGGTCAAGTGCACAGTCTA
s2_R_885_AGTATTCGCC	CAAGCAGAAGACGGCATACGAGATAGTATTCGCCAGGGTCAAGTGCACAGTCTA
s2_R_886_TGCGTCTCTC	CAAGCAGAAGACGGCATACGAGATTGCGTCTCTCAGGGTCAAGTGCACAGTCTA
s2_R_887_GCGTGAAGGA	CAAGCAGAAGACGGCATACGAGATGCGTGAAGGAAGGGTCAAGTGCACAGTCTA
s2_R_888_TCACACGATC	CAAGCAGAAGACGGCATACGAGATTCACACGATCAGGGTCAAGTGCACAGTCTA
s2_R_889_GATCTGCAAT	CAAGCAGAAGACGGCATACGAGATGATCTGCAATAGGGTCAAGTGCACAGTCTA
s2_R_890_TGCCATACAA	CAAGCAGAAGACGGCATACGAGATTGCCATACAAAGGGTCAAGTGCACAGTCTA
s2_R_891_ATCGCCATCG	CAAGCAGAAGACGGCATACGAGATATCGCCATCGAGGGTCAAGTGCACAGTCTA
s2_R_892_TGGAACGGAG	CAAGCAGAAGACGGCATACGAGATTGGAACGGAGAGGGTCAAGTGCACAGTCTA
s2_R_893_CAACACGGTC	CAAGCAGAAGACGGCATACGAGATCAACACGGTCAGGGTCAAGTGCACAGTCTA
s2_R_894_GGAATACGAC	CAAGCAGAAGACGGCATACGAGATGGAATACGACAGGGTCAAGTGCACAGTCTA
s2_R_895_TTACGTGATG	CAAGCAGAAGACGGCATACGAGATTTACGTGATGAGGGTCAAGTGCACAGTCTA
s2_R_896_GATCGCTATA	CAAGCAGAAGACGGCATACGAGATGATCGCTATAAGGGTCAAGTGCACAGTCTA
s2_R_897_GAACTTGTGT	CAAGCAGAAGACGGCATACGAGATGAACTTGTGTAGGGTCAAGTGCACAGTCTA
s2_R_898_CTATTCCAGT	CAAGCAGAAGACGGCATACGAGATCTATTCCAGTAGGGTCAAGTGCACAGTCTA
s2_R_899_GAATGCCATA	CAAGCAGAAGACGGCATACGAGATGAATGCCATAAGGGTCAAGTGCACAGTCTA
s2_R_900_TTAATGGAGG	CAAGCAGAAGACGGCATACGAGATTTAATGGAGGAGGGTCAAGTGCACAGTCTA
s2_R_901_TACTGCGAGG	CAAGCAGAAGACGGCATACGAGATTACTGCGAGGAGGGTCAAGTGCACAGTCTA
s2_R_902_TGGTGCTATA	CAAGCAGAAGACGGCATACGAGATTGGTGCTATAAGGGTCAAGTGCACAGTCTA
s2_R_903_GCTAACAAGT	CAAGCAGAAGACGGCATACGAGATGCTAACAAGTAGGGTCAAGTGCACAGTCTA
s2_R_904_TCGACACGAA	CAAGCAGAAGACGGCATACGAGATTCGACACGAAAGGGTCAAGTGCACAGTCTA
s2_R_905_ATACCTTGCC	CAAGCAGAAGACGGCATACGAGATATACCTTGCCAGGGTCAAGTGCACAGTCTA
s2_R_906_GTGACGACTA	CAAGCAGAAGACGGCATACGAGATGTGACGACTAAGGGTCAAGTGCACAGTCTA
s2_R_907_TAGGCGTACA	CAAGCAGAAGACGGCATACGAGATTAGGCGTACAAGGGTCAAGTGCACAGTCTA
s2_R_908_CGGATTGAAC	CAAGCAGAAGACGGCATACGAGATCGGATTGAACAGGGTCAAGTGCACAGTCTA
s2_R_909_CTAACGGCAC	CAAGCAGAAGACGGCATACGAGATCTAACGGCACAGGGTCAAGTGCACAGTCTA
s2_R_910_CATAGGCTAC	CAAGCAGAAGACGGCATACGAGATCATAGGCTACAGGGTCAAGTGCACAGTCTA
s2_R_911_TGAGCGCTTA	CAAGCAGAAGACGGCATACGAGATTGAGCGCTTAAGGGTCAAGTGCACAGTCTA
s2_R_912_GACACGACGA	CAAGCAGAAGACGGCATACGAGATGACACGACGAAGGGTCAAGTGCACAGTCTA
s2_R_913_GTCATACTGA	CAAGCAGAAGACGGCATACGAGATGTCATACTGAAGGGTCAAGTGCACAGTCTA
s2_R_914_GAGGAATTGC	CAAGCAGAAGACGGCATACGAGATGAGGAATTGCAGGGTCAAGTGCACAGTCTA
s2_R_915_TAGGCATGAG	CAAGCAGAAGACGGCATACGAGATTAGGCATGAGAGGGTCAAGTGCACAGTCTA
s2_R_916_AGAACGTGCC	CAAGCAGAAGACGGCATACGAGATAGAACGTGCCAGGGTCAAGTGCACAGTCTA
s2_R_917_TACAGGTTGT	CAAGCAGAAGACGGCATACGAGATTACAGGTTGTAGGGTCAAGTGCACAGTCTA
s2_R_918_TCTTCCACAT	CAAGCAGAAGACGGCATACGAGATTCTTCCACATAGGGTCAAGTGCACAGTCTA
s2_R_919_GCTTGCTGAC	CAAGCAGAAGACGGCATACGAGATGCTTGCTGACAGGGTCAAGTGCACAGTCTA
s2_R_920_CCTTCAGTGG	CAAGCAGAAGACGGCATACGAGATCCTTCAGTGGAGGGTCAAGTGCACAGTCTA
s2_R_921_CGTCGGTTCT	CAAGCAGAAGACGGCATACGAGATCGTCGGTTCTAGGGTCAAGTGCACAGTCTA
s2_R_922_CATTCGACTA	CAAGCAGAAGACGGCATACGAGATCATTCGACTAAGGGTCAAGTGCACAGTCTA
s2_R_923_GGAGGAACAT	CAAGCAGAAGACGGCATACGAGATGGAGGAACATAGGGTCAAGTGCACAGTCTA
s2_R_924_GTCACACATA	CAAGCAGAAGACGGCATACGAGATGTCACACATAAGGGTCAAGTGCACAGTCTA
s2_R_925_TGGTTACTGG	CAAGCAGAAGACGGCATACGAGATTGGTTACTGGAGGGTCAAGTGCACAGTCTA
s2_R_926_TGTAAGTGCT	CAAGCAGAAGACGGCATACGAGATTGTAAGTGCTAGGGTCAAGTGCACAGTCTA
s2_R_927_CTGTCTGAGT	CAAGCAGAAGACGGCATACGAGATCTGTCTGAGTAGGGTCAAGTGCACAGTCTA
s2_R_928_TTAGCCTCCT	CAAGCAGAAGACGGCATACGAGATTTAGCCTCCTAGGGTCAAGTGCACAGTCTA
s2_R_929_GTATCGTGAC	CAAGCAGAAGACGGCATACGAGATGTATCGTGACAGGGTCAAGTGCACAGTCTA
s2_R_930_TAGGTACACA	CAAGCAGAAGACGGCATACGAGATTAGGTACACAAGGGTCAAGTGCACAGTCTA
s2_R_931_GAGCTTCGTT	CAAGCAGAAGACGGCATACGAGATGAGCTTCGTTAGGGTCAAGTGCACAGTCTA
s2_R_932_CTACTTCGGC	CAAGCAGAAGACGGCATACGAGATCTACTTCGGCAGGGTCAAGTGCACAGTCTA
s2_R_933_GTCCAGATTC	CAAGCAGAAGACGGCATACGAGATGTCCAGATTCAGGGTCAAGTGCACAGTCTA
s2_R_934_GTCTGGAAGA	CAAGCAGAAGACGGCATACGAGATGTCTGGAAGAAGGGTCAAGTGCACAGTCTA
s2_R_935_TAGCGGAGAG	CAAGCAGAAGACGGCATACGAGATTAGCGGAGAGAGGGTCAAGTGCACAGTCTA
s2_R_936_CCACCTACAG	CAAGCAGAAGACGGCATACGAGATCCACCTACAGAGGGTCAAGTGCACAGTCTA
s2_R_937_TAAGCGACAG	CAAGCAGAAGACGGCATACGAGATTAAGCGACAGAGGGTCAAGTGCACAGTCTA
s2_R_938_TCGGCCTAGT	CAAGCAGAAGACGGCATACGAGATTCGGCCTAGTAGGGTCAAGTGCACAGTCTA
s2_R_939_TGAGTACTCC	CAAGCAGAAGACGGCATACGAGATTGAGTACTCCAGGGTCAAGTGCACAGTCTA
s2_R_940_GTGAACGTCG	CAAGCAGAAGACGGCATACGAGATGTGAACGTCGAGGGTCAAGTGCACAGTCTA
s2_R_941_TGTAGAAGCG	CAAGCAGAAGACGGCATACGAGATTGTAGAAGCGAGGGTCAAGTGCACAGTCTA
s2_R_942_TGAGCGACCA	CAAGCAGAAGACGGCATACGAGATTGAGCGACCAAGGGTCAAGTGCACAGTCTA
s2_R_943_TGCGACGACA	CAAGCAGAAGACGGCATACGAGATTGCGACGACAAGGGTCAAGTGCACAGTCTA
s2_R_944_GTCACCAGGA	CAAGCAGAAGACGGCATACGAGATGTCACCAGGAAGGGTCAAGTGCACAGTCTA
s2_R_945_GCTAACGCTT	CAAGCAGAAGACGGCATACGAGATGCTAACGCTTAGGGTCAAGTGCACAGTCTA
s2_R_946_TCTGAGCGAT	CAAGCAGAAGACGGCATACGAGATTCTGAGCGATAGGGTCAAGTGCACAGTCTA
s2_R_947_TGGAACAAGT	CAAGCAGAAGACGGCATACGAGATTGGAACAAGTAGGGTCAAGTGCACAGTCTA
s2_R_948_GGTTGCACTG	CAAGCAGAAGACGGCATACGAGATGGTTGCACTGAGGGTCAAGTGCACAGTCTA
s2_R_949_ACTTACGCTA	CAAGCAGAAGACGGCATACGAGATACTTACGCTAAGGGTCAAGTGCACAGTCTA
s2_R_950_GGAGTAGTCG	CAAGCAGAAGACGGCATACGAGATGGAGTAGTCGAGGGTCAAGTGCACAGTCTA
s2_R_951_GTGTCTGCTT	CAAGCAGAAGACGGCATACGAGATGTGTCTGCTTAGGGTCAAGTGCACAGTCTA
s2_R_952_TACCACCTTC	CAAGCAGAAGACGGCATACGAGATTACCACCTTCAGGGTCAAGTGCACAGTCTA
s2_R_953_GACATCACTG	CAAGCAGAAGACGGCATACGAGATGACATCACTGAGGGTCAAGTGCACAGTCTA
s2_R_954_TGAATCTGAC	CAAGCAGAAGACGGCATACGAGATTGAATCTGACAGGGTCAAGTGCACAGTCTA
s2_R_955_GAGACTACTC	CAAGCAGAAGACGGCATACGAGATGAGACTACTCAGGGTCAAGTGCACAGTCTA
s2_R_956_TACAGCGCAC	CAAGCAGAAGACGGCATACGAGATTACAGCGCACAGGGTCAAGTGCACAGTCTA
s2_R_957_CTTCCGGTGT	CAAGCAGAAGACGGCATACGAGATCTTCCGGTGTAGGGTCAAGTGCACAGTCTA
s2_R_958_GTACTACAGT	CAAGCAGAAGACGGCATACGAGATGTACTACAGTAGGGTCAAGTGCACAGTCTA
s2_R_959_CCAAGGCTCT	CAAGCAGAAGACGGCATACGAGATCCAAGGCTCTAGGGTCAAGTGCACAGTCTA
s2_R_960_TCCGGAGCAT	CAAGCAGAAGACGGCATACGAGATTCCGGAGCATAGGGTCAAGTGCACAGTCTA
s2_R_961_GACACATTGG	CAAGCAGAAGACGGCATACGAGATGACACATTGGAGGGTCAAGTGCACAGTCTA
s2_R_962_TTGAAGCGTT	CAAGCAGAAGACGGCATACGAGATTTGAAGCGTTAGGGTCAAGTGCACAGTCTA
s2_R_963_GATAGCCAGT	CAAGCAGAAGACGGCATACGAGATGATAGCCAGTAGGGTCAAGTGCACAGTCTA
s2_R_964_TCAACAGACC	CAAGCAGAAGACGGCATACGAGATTCAACAGACCAGGGTCAAGTGCACAGTCTA
s2_R_965_GGAGTGATAC	CAAGCAGAAGACGGCATACGAGATGGAGTGATACAGGGTCAAGTGCACAGTCTA
s2_R_966_TTGATCTGTC	CAAGCAGAAGACGGCATACGAGATTTGATCTGTCAGGGTCAAGTGCACAGTCTA
s2_R_967_TTCGCATCTC	CAAGCAGAAGACGGCATACGAGATTTCGCATCTCAGGGTCAAGTGCACAGTCTA
s2_R_968_GAGGAAGGAC	CAAGCAGAAGACGGCATACGAGATGAGGAAGGACAGGGTCAAGTGCACAGTCTA
s2_R_969_GGTATGTACA	CAAGCAGAAGACGGCATACGAGATGGTATGTACAAGGGTCAAGTGCACAGTCTA
s2_R_970_GAGAGGTGAC	CAAGCAGAAGACGGCATACGAGATGAGAGGTGACAGGGTCAAGTGCACAGTCTA
s2_R_971_GATGTCTCAC	CAAGCAGAAGACGGCATACGAGATGATGTCTCACAGGGTCAAGTGCACAGTCTA
s2_R_972_TGGTAGACGA	CAAGCAGAAGACGGCATACGAGATTGGTAGACGAAGGGTCAAGTGCACAGTCTA
s2_R_973_CTAGTCGCAC	CAAGCAGAAGACGGCATACGAGATCTAGTCGCACAGGGTCAAGTGCACAGTCTA
s2_R_974_GAACGAGCTG	CAAGCAGAAGACGGCATACGAGATGAACGAGCTGAGGGTCAAGTGCACAGTCTA
s2_R_975_CTTGGACATT	CAAGCAGAAGACGGCATACGAGATCTTGGACATTAGGGTCAAGTGCACAGTCTA
s2_R_976_CAAGTCGCCA	CAAGCAGAAGACGGCATACGAGATCAAGTCGCCAAGGGTCAAGTGCACAGTCTA
s2_R_977_CGATAAGTGT	CAAGCAGAAGACGGCATACGAGATCGATAAGTGTAGGGTCAAGTGCACAGTCTA
s2_R_978_TCCGCAATTC	CAAGCAGAAGACGGCATACGAGATTCCGCAATTCAGGGTCAAGTGCACAGTCTA
s2_R_979_CTAAGAGACC	CAAGCAGAAGACGGCATACGAGATCTAAGAGACCAGGGTCAAGTGCACAGTCTA
s2_R_980_GCTAAGTTGT	CAAGCAGAAGACGGCATACGAGATGCTAAGTTGTAGGGTCAAGTGCACAGTCTA
s2_R_981_CTGACCAACC	CAAGCAGAAGACGGCATACGAGATCTGACCAACCAGGGTCAAGTGCACAGTCTA
s2_R_982_TGTTACGATG	CAAGCAGAAGACGGCATACGAGATTGTTACGATGAGGGTCAAGTGCACAGTCTA
s2_R_983_GAGAGTCTGA	CAAGCAGAAGACGGCATACGAGATGAGAGTCTGAAGGGTCAAGTGCACAGTCTA
s2_R_984_AGCAGACCGA	CAAGCAGAAGACGGCATACGAGATAGCAGACCGAAGGGTCAAGTGCACAGTCTA
s2_R_985_TAGTCGAAGG	CAAGCAGAAGACGGCATACGAGATTAGTCGAAGGAGGGTCAAGTGCACAGTCTA
s2_R_986_AGAGCGACAC	CAAGCAGAAGACGGCATACGAGATAGAGCGACACAGGGTCAAGTGCACAGTCTA
s2_R_987_TCTGACGCAC	CAAGCAGAAGACGGCATACGAGATTCTGACGCACAGGGTCAAGTGCACAGTCTA
s2_R_988_GTCGCATCAT	CAAGCAGAAGACGGCATACGAGATGTCGCATCATAGGGTCAAGTGCACAGTCTA
s2_R_989_GTCGCAAGTA	CAAGCAGAAGACGGCATACGAGATGTCGCAAGTAAGGGTCAAGTGCACAGTCTA
s2_R_990_TAAGCACACT	CAAGCAGAAGACGGCATACGAGATTAAGCACACTAGGGTCAAGTGCACAGTCTA
s2_R_991_CCTCACAAGC	CAAGCAGAAGACGGCATACGAGATCCTCACAAGCAGGGTCAAGTGCACAGTCTA
s2_R_992_ATGCGATCAC	CAAGCAGAAGACGGCATACGAGATATGCGATCACAGGGTCAAGTGCACAGTCTA
s2_R_993_TTACGAGACT	CAAGCAGAAGACGGCATACGAGATTTACGAGACTAGGGTCAAGTGCACAGTCTA
s2_R_994_GTAAGATGCC	CAAGCAGAAGACGGCATACGAGATGTAAGATGCCAGGGTCAAGTGCACAGTCTA
s2_R_995_CGTATCTCTC	CAAGCAGAAGACGGCATACGAGATCGTATCTCTCAGGGTCAAGTGCACAGTCTA
s2_R_996_TTAGACGCCA	CAAGCAGAAGACGGCATACGAGATTTAGACGCCAAGGGTCAAGTGCACAGTCTA
s2_R_997_CTGCCTTCAC	CAAGCAGAAGACGGCATACGAGATCTGCCTTCACAGGGTCAAGTGCACAGTCTA
s2_R_998_CCTCTGTGAA	CAAGCAGAAGACGGCATACGAGATCCTCTGTGAAAGGGTCAAGTGCACAGTCTA
s2_R_999_GTAACGAACA	CAAGCAGAAGACGGCATACGAGATGTAACGAACAAGGGTCAAGTGCACAGTCTA
s2_R_1000_TTCCTGGCTG	CAAGCAGAAGACGGCATACGAGATTTCCTGGCTGAGGGTCAAGTGCACAGTCTA
s2_R_1001_GTAGGTCATA	CAAGCAGAAGACGGCATACGAGATGTAGGTCATAAGGGTCAAGTGCACAGTCTA
s2_R_1002_TTGCCTGTCT	CAAGCAGAAGACGGCATACGAGATTTGCCTGTCTAGGGTCAAGTGCACAGTCTA
s2_R_1003_TAGACTCAGC	CAAGCAGAAGACGGCATACGAGATTAGACTCAGCAGGGTCAAGTGCACAGTCTA
s2_R_1004_GCATGTAGAT	CAAGCAGAAGACGGCATACGAGATGCATGTAGATAGGGTCAAGTGCACAGTCTA
s2_R_1005_GTGAAGGACT	CAAGCAGAAGACGGCATACGAGATGTGAAGGACTAGGGTCAAGTGCACAGTCTA
s2_R_1006_TGGAGTTCAA	CAAGCAGAAGACGGCATACGAGATTGGAGTTCAAAGGGTCAAGTGCACAGTCTA
s2_R_1007_GTCAGCTAAT	CAAGCAGAAGACGGCATACGAGATGTCAGCTAATAGGGTCAAGTGCACAGTCTA
s2_R_1008_CAACGACATA	CAAGCAGAAGACGGCATACGAGATCAACGACATAAGGGTCAAGTGCACAGTCTA
s2_R_1009_CCGAGACATA	CAAGCAGAAGACGGCATACGAGATCCGAGACATAAGGGTCAAGTGCACAGTCTA
s2_R_1010_CTTCAAGCTG	CAAGCAGAAGACGGCATACGAGATCTTCAAGCTGAGGGTCAAGTGCACAGTCTA
s2_R_1011_TCCTGCTCAA	CAAGCAGAAGACGGCATACGAGATTCCTGCTCAAAGGGTCAAGTGCACAGTCTA
s2_R_1012_CATACGTCAG	CAAGCAGAAGACGGCATACGAGATCATACGTCAGAGGGTCAAGTGCACAGTCTA
s2_R_1013_GAGAAGGCAA	CAAGCAGAAGACGGCATACGAGATGAGAAGGCAAAGGGTCAAGTGCACAGTCTA
s2_R_1014_ATTGTGCTCG	CAAGCAGAAGACGGCATACGAGATATTGTGCTCGAGGGTCAAGTGCACAGTCTA
s2_R_1015_TCCAATGATC	CAAGCAGAAGACGGCATACGAGATTCCAATGATCAGGGTCAAGTGCACAGTCTA
s2_R_1016_GCACTCATGG	CAAGCAGAAGACGGCATACGAGATGCACTCATGGAGGGTCAAGTGCACAGTCTA
s2_R_1017_CTTAGTCAGG	CAAGCAGAAGACGGCATACGAGATCTTAGTCAGGAGGGTCAAGTGCACAGTCTA
s2_R_1018_GACGCATTCA	CAAGCAGAAGACGGCATACGAGATGACGCATTCAAGGGTCAAGTGCACAGTCTA
s2_R_1019_GCAATAGCTT	CAAGCAGAAGACGGCATACGAGATGCAATAGCTTAGGGTCAAGTGCACAGTCTA
s2_R_1020_CACCATAACA	CAAGCAGAAGACGGCATACGAGATCACCATAACAAGGGTCAAGTGCACAGTCTA
s2_R_1021_TTGGCAAGGC	CAAGCAGAAGACGGCATACGAGATTTGGCAAGGCAGGGTCAAGTGCACAGTCTA
s2_R_1022_CAACGTCGCT	CAAGCAGAAGACGGCATACGAGATCAACGTCGCTAGGGTCAAGTGCACAGTCTA
s2_R_1023_GGATACTCTC	CAAGCAGAAGACGGCATACGAGATGGATACTCTCAGGGTCAAGTGCACAGTCTA
s2_R_1024_CCGATGTAAC	CAAGCAGAAGACGGCATACGAGATCCGATGTAACAGGGTCAAGTGCACAGTCTA
s2_R_1025_GACCAGTTAA	CAAGCAGAAGACGGCATACGAGATGACCAGTTAAAGGGTCAAGTGCACAGTCTA
s2_R_1026_TACACGGAGC	CAAGCAGAAGACGGCATACGAGATTACACGGAGCAGGGTCAAGTGCACAGTCTA
s2_R_1027_TGTATCGACC	CAAGCAGAAGACGGCATACGAGATTGTATCGACCAGGGTCAAGTGCACAGTCTA
s2_R_1028_TGACTCGAGT	CAAGCAGAAGACGGCATACGAGATTGACTCGAGTAGGGTCAAGTGCACAGTCTA
s2_R_1029_GGTGTGGTAA	CAAGCAGAAGACGGCATACGAGATGGTGTGGTAAAGGGTCAAGTGCACAGTCTA
s2_R_1030_AGGTTACGGT	CAAGCAGAAGACGGCATACGAGATAGGTTACGGTAGGGTCAAGTGCACAGTCTA
s2_R_1031_CACGGACTTC	CAAGCAGAAGACGGCATACGAGATCACGGACTTCAGGGTCAAGTGCACAGTCTA
s2_R_1032_TTCATCGATC	CAAGCAGAAGACGGCATACGAGATTTCATCGATCAGGGTCAAGTGCACAGTCTA
s2_R_1033_AGTGCTGTGA	CAAGCAGAAGACGGCATACGAGATAGTGCTGTGAAGGGTCAAGTGCACAGTCTA
s2_R_1034_TTCGAGTCAG	CAAGCAGAAGACGGCATACGAGATTTCGAGTCAGAGGGTCAAGTGCACAGTCTA
s2_R_1035_TTACTACGTG	CAAGCAGAAGACGGCATACGAGATTTACTACGTGAGGGTCAAGTGCACAGTCTA
s2_R_1036_TTAGAACGAC	CAAGCAGAAGACGGCATACGAGATTTAGAACGACAGGGTCAAGTGCACAGTCTA
s2_R_1037_CCAAGGCATG	CAAGCAGAAGACGGCATACGAGATCCAAGGCATGAGGGTCAAGTGCACAGTCTA
s2_R_1038_TTCTTCGTCT	CAAGCAGAAGACGGCATACGAGATTTCTTCGTCTAGGGTCAAGTGCACAGTCTA
s2_R_1039_TTCGAGGTGT	CAAGCAGAAGACGGCATACGAGATTTCGAGGTGTAGGGTCAAGTGCACAGTCTA
s2_R_1040_GACAAGCACA	CAAGCAGAAGACGGCATACGAGATGACAAGCACAAGGGTCAAGTGCACAGTCTA
s2_R_1041_GTAGCAATCC	CAAGCAGAAGACGGCATACGAGATGTAGCAATCCAGGGTCAAGTGCACAGTCTA
s2_R_1042_CGCATGGCTT	CAAGCAGAAGACGGCATACGAGATCGCATGGCTTAGGGTCAAGTGCACAGTCTA
s2_R_1043_CGACCATTCT	CAAGCAGAAGACGGCATACGAGATCGACCATTCTAGGGTCAAGTGCACAGTCTA
s2_R_1044_CTGTTGGTAA	CAAGCAGAAGACGGCATACGAGATCTGTTGGTAAAGGGTCAAGTGCACAGTCTA
s2_R_1045_CTACACTCCT	CAAGCAGAAGACGGCATACGAGATCTACACTCCTAGGGTCAAGTGCACAGTCTA
s2_R_1046_GCATAGCTGG	CAAGCAGAAGACGGCATACGAGATGCATAGCTGGAGGGTCAAGTGCACAGTCTA
s2_R_1047_GTCGATCGAG	CAAGCAGAAGACGGCATACGAGATGTCGATCGAGAGGGTCAAGTGCACAGTCTA
s2_R_1048_CGATCGGTAT	CAAGCAGAAGACGGCATACGAGATCGATCGGTATAGGGTCAAGTGCACAGTCTA
s2_R_1049_TTCGACCATC	CAAGCAGAAGACGGCATACGAGATTTCGACCATCAGGGTCAAGTGCACAGTCTA
s2_R_1050_CGTTCTGTGT	CAAGCAGAAGACGGCATACGAGATCGTTCTGTGTAGGGTCAAGTGCACAGTCTA
s2_R_1051_AAGCGAACCA	CAAGCAGAAGACGGCATACGAGATAAGCGAACCAAGGGTCAAGTGCACAGTCTA
s2_R_1052_ATGCTAAGCC	CAAGCAGAAGACGGCATACGAGATATGCTAAGCCAGGGTCAAGTGCACAGTCTA
s2_R_1053_GAAGCCACTG	CAAGCAGAAGACGGCATACGAGATGAAGCCACTGAGGGTCAAGTGCACAGTCTA
s2_R_1054_GAAGCATCAC	CAAGCAGAAGACGGCATACGAGATGAAGCATCACAGGGTCAAGTGCACAGTCTA
s2_R_1055_GACCATGATA	CAAGCAGAAGACGGCATACGAGATGACCATGATAAGGGTCAAGTGCACAGTCTA
s2_R_1056_GCATACCTCA	CAAGCAGAAGACGGCATACGAGATGCATACCTCAAGGGTCAAGTGCACAGTCTA
s2_R_1057_TGAACTCACC	CAAGCAGAAGACGGCATACGAGATTGAACTCACCAGGGTCAAGTGCACAGTCTA
s2_R_1058_TCCACCATAG	CAAGCAGAAGACGGCATACGAGATTCCACCATAGAGGGTCAAGTGCACAGTCTA
s2_R_1059_TAGCAACGTC	CAAGCAGAAGACGGCATACGAGATTAGCAACGTCAGGGTCAAGTGCACAGTCTA
s2_R_1060_TCCATGCCAG	CAAGCAGAAGACGGCATACGAGATTCCATGCCAGAGGGTCAAGTGCACAGTCTA
s2_R_1061_TCAGAACCGA	CAAGCAGAAGACGGCATACGAGATTCAGAACCGAAGGGTCAAGTGCACAGTCTA
s2_R_1062_TTGCTAACGA	CAAGCAGAAGACGGCATACGAGATTTGCTAACGAAGGGTCAAGTGCACAGTCTA
s2_R_1063_TAAGTCCTCA	CAAGCAGAAGACGGCATACGAGATTAAGTCCTCAAGGGTCAAGTGCACAGTCTA
s2_R_1064_TGCAACCTAC	CAAGCAGAAGACGGCATACGAGATTGCAACCTACAGGGTCAAGTGCACAGTCTA
s2_R_1065_TCTAACACTG	CAAGCAGAAGACGGCATACGAGATTCTAACACTGAGGGTCAAGTGCACAGTCTA
s2_R_1066_TCTGACAGGA	CAAGCAGAAGACGGCATACGAGATTCTGACAGGAAGGGTCAAGTGCACAGTCTA
s2_R_1067_TGGATAGGAC	CAAGCAGAAGACGGCATACGAGATTGGATAGGACAGGGTCAAGTGCACAGTCTA
s2_R_1068_TGTGAACCTT	CAAGCAGAAGACGGCATACGAGATTGTGAACCTTAGGGTCAAGTGCACAGTCTA
s2_R_1069_TTCGAACACT	CAAGCAGAAGACGGCATACGAGATTTCGAACACTAGGGTCAAGTGCACAGTCTA
s2_R_1070_TTGACGGTTG	CAAGCAGAAGACGGCATACGAGATTTGACGGTTGAGGGTCAAGTGCACAGTCTA
s2_R_1071_TTAGATTGCC	CAAGCAGAAGACGGCATACGAGATTTAGATTGCCAGGGTCAAGTGCACAGTCTA
s2_R_1072_TTAACGTGTC	CAAGCAGAAGACGGCATACGAGATTTAACGTGTCAGGGTCAAGTGCACAGTCTA
s2_R_1073_CTGTGAGTGT	CAAGCAGAAGACGGCATACGAGATCTGTGAGTGTAGGGTCAAGTGCACAGTCTA
s2_R_1074_CACCATGCGT	CAAGCAGAAGACGGCATACGAGATCACCATGCGTAGGGTCAAGTGCACAGTCTA
s2_R_1075_CGTACCTGGT	CAAGCAGAAGACGGCATACGAGATCGTACCTGGTAGGGTCAAGTGCACAGTCTA
s2_R_1076_TAAGTGCATG	CAAGCAGAAGACGGCATACGAGATTAAGTGCATGAGGGTCAAGTGCACAGTCTA
s2_R_1077_GCTACACCGT	CAAGCAGAAGACGGCATACGAGATGCTACACCGTAGGGTCAAGTGCACAGTCTA
s2_R_1078_TTATCGGCTC	CAAGCAGAAGACGGCATACGAGATTTATCGGCTCAGGGTCAAGTGCACAGTCTA
s2_R_1079_TCAGCTACAC	CAAGCAGAAGACGGCATACGAGATTCAGCTACACAGGGTCAAGTGCACAGTCTA
s2_R_1080_TATGCATGTC	CAAGCAGAAGACGGCATACGAGATTATGCATGTCAGGGTCAAGTGCACAGTCTA
s2_R_1081_TGATGAATCC	CAAGCAGAAGACGGCATACGAGATTGATGAATCCAGGGTCAAGTGCACAGTCTA
s2_R_1082_GCAAGTTAGA	CAAGCAGAAGACGGCATACGAGATGCAAGTTAGAAGGGTCAAGTGCACAGTCTA
s2_R_1083_CCGTTCCATT	CAAGCAGAAGACGGCATACGAGATCCGTTCCATTAGGGTCAAGTGCACAGTCTA
s2_R_1084_TTCGTAGCCT	CAAGCAGAAGACGGCATACGAGATTTCGTAGCCTAGGGTCAAGTGCACAGTCTA
s2_R_1085_GCTAATATGC	CAAGCAGAAGACGGCATACGAGATGCTAATATGCAGGGTCAAGTGCACAGTCTA
s2_R_1086_TGAGAGTAAC	CAAGCAGAAGACGGCATACGAGATTGAGAGTAACAGGGTCAAGTGCACAGTCTA
s2_R_1087_ATCCTCGTCA	CAAGCAGAAGACGGCATACGAGATATCCTCGTCAAGGGTCAAGTGCACAGTCTA
s2_R_1088_TCAGCGTAGC	CAAGCAGAAGACGGCATACGAGATTCAGCGTAGCAGGGTCAAGTGCACAGTCTA
s2_R_1089_GCTACAGATA	CAAGCAGAAGACGGCATACGAGATGCTACAGATAAGGGTCAAGTGCACAGTCTA
s2_R_1090_TGAATCACAG	CAAGCAGAAGACGGCATACGAGATTGAATCACAGAGGGTCAAGTGCACAGTCTA
s2_R_1091_TAGCCACCAC	CAAGCAGAAGACGGCATACGAGATTAGCCACCACAGGGTCAAGTGCACAGTCTA
s2_R_1092_TTAGAAGTCC	CAAGCAGAAGACGGCATACGAGATTTAGAAGTCCAGGGTCAAGTGCACAGTCTA
s2_R_1093_GTGAACATTC	CAAGCAGAAGACGGCATACGAGATGTGAACATTCAGGGTCAAGTGCACAGTCTA
s2_R_1094_TATGCGACTC	CAAGCAGAAGACGGCATACGAGATTATGCGACTCAGGGTCAAGTGCACAGTCTA
s2_R_1095_TCAGACATAC	CAAGCAGAAGACGGCATACGAGATTCAGACATACAGGGTCAAGTGCACAGTCTA
s2_R_1096_GTAGCCAGAA	CAAGCAGAAGACGGCATACGAGATGTAGCCAGAAAGGGTCAAGTGCACAGTCTA
s2_R_1097_GTGGATATAC	CAAGCAGAAGACGGCATACGAGATGTGGATATACAGGGTCAAGTGCACAGTCTA
s2_R_1098_TTGTCTCACA	CAAGCAGAAGACGGCATACGAGATTTGTCTCACAAGGGTCAAGTGCACAGTCTA
s2_R_1099_GGCAGTGGTA	CAAGCAGAAGACGGCATACGAGATGGCAGTGGTAAGGGTCAAGTGCACAGTCTA
s2_R_1100_GCGAACTGTC	CAAGCAGAAGACGGCATACGAGATGCGAACTGTCAGGGTCAAGTGCACAGTCTA
s2_R_1101_GTCTAAGGTC	CAAGCAGAAGACGGCATACGAGATGTCTAAGGTCAGGGTCAAGTGCACAGTCTA
s2_R_1102_TGTTGCGAAT	CAAGCAGAAGACGGCATACGAGATTGTTGCGAATAGGGTCAAGTGCACAGTCTA
s2_R_1103_TAATGACAGG	CAAGCAGAAGACGGCATACGAGATTAATGACAGGAGGGTCAAGTGCACAGTCTA
s2_R_1104_TTCGCCTCGA	CAAGCAGAAGACGGCATACGAGATTTCGCCTCGAAGGGTCAAGTGCACAGTCTA
s2_R_1105_GTACTAGCAA	CAAGCAGAAGACGGCATACGAGATGTACTAGCAAAGGGTCAAGTGCACAGTCTA
s2_R_1106_TATGCCATGA	CAAGCAGAAGACGGCATACGAGATTATGCCATGAAGGGTCAAGTGCACAGTCTA
s2_R_1107_AGAAGCGATA	CAAGCAGAAGACGGCATACGAGATAGAAGCGATAAGGGTCAAGTGCACAGTCTA
s2_R_1108_GTTGTGGCAC	CAAGCAGAAGACGGCATACGAGATGTTGTGGCACAGGGTCAAGTGCACAGTCTA
s2_R_1109_AGGACCTTCA	CAAGCAGAAGACGGCATACGAGATAGGACCTTCAAGGGTCAAGTGCACAGTCTA
s2_R_1110_CACTATGAAC	CAAGCAGAAGACGGCATACGAGATCACTATGAACAGGGTCAAGTGCACAGTCTA
s2_R_1111_GTGATCTTAC	CAAGCAGAAGACGGCATACGAGATGTGATCTTACAGGGTCAAGTGCACAGTCTA
s2_R_1112_CCAAGCCAGA	CAAGCAGAAGACGGCATACGAGATCCAAGCCAGAAGGGTCAAGTGCACAGTCTA
s2_R_1113_CACTAGGTGG	CAAGCAGAAGACGGCATACGAGATCACTAGGTGGAGGGTCAAGTGCACAGTCTA
s2_R_1114_TCCTAGTTGA	CAAGCAGAAGACGGCATACGAGATTCCTAGTTGAAGGGTCAAGTGCACAGTCTA
s2_R_1115_ACCGTTCGAG	CAAGCAGAAGACGGCATACGAGATACCGTTCGAGAGGGTCAAGTGCACAGTCTA
s2_R_1116_TTAGCTGGAC	CAAGCAGAAGACGGCATACGAGATTTAGCTGGACAGGGTCAAGTGCACAGTCTA
s2_R_1117_TACTCGGTTA	CAAGCAGAAGACGGCATACGAGATTACTCGGTTAAGGGTCAAGTGCACAGTCTA
s2_R_1118_GAAGCAGAGT	CAAGCAGAAGACGGCATACGAGATGAAGCAGAGTAGGGTCAAGTGCACAGTCTA
s2_R_1119_TTAACCACAC	CAAGCAGAAGACGGCATACGAGATTTAACCACACAGGGTCAAGTGCACAGTCTA
s2_R_1120_GTTAGGAAGG	CAAGCAGAAGACGGCATACGAGATGTTAGGAAGGAGGGTCAAGTGCACAGTCTA
s2_R_1121_GATCCTACGA	CAAGCAGAAGACGGCATACGAGATGATCCTACGAAGGGTCAAGTGCACAGTCTA
s2_R_1122_TCTAGACACA	CAAGCAGAAGACGGCATACGAGATTCTAGACACAAGGGTCAAGTGCACAGTCTA
s2_R_1123_CGTCTGATCA	CAAGCAGAAGACGGCATACGAGATCGTCTGATCAAGGGTCAAGTGCACAGTCTA
s2_R_1124_GCATTCAACC	CAAGCAGAAGACGGCATACGAGATGCATTCAACCAGGGTCAAGTGCACAGTCTA
s2_R_1125_GTAACTACTG	CAAGCAGAAGACGGCATACGAGATGTAACTACTGAGGGTCAAGTGCACAGTCTA
s2_R_1126_CTGGCTGAAC	CAAGCAGAAGACGGCATACGAGATCTGGCTGAACAGGGTCAAGTGCACAGTCTA
s2_R_1127_CCATTAATCC	CAAGCAGAAGACGGCATACGAGATCCATTAATCCAGGGTCAAGTGCACAGTCTA
s2_R_1128_AGCTTGAGCT	CAAGCAGAAGACGGCATACGAGATAGCTTGAGCTAGGGTCAAGTGCACAGTCTA
s2_R_1129_AGTCCGAGTA	CAAGCAGAAGACGGCATACGAGATAGTCCGAGTAAGGGTCAAGTGCACAGTCTA
s2_R_1130_GACCTGGACA	CAAGCAGAAGACGGCATACGAGATGACCTGGACAAGGGTCAAGTGCACAGTCTA
s2_R_1131_GCAAGGTAAC	CAAGCAGAAGACGGCATACGAGATGCAAGGTAACAGGGTCAAGTGCACAGTCTA
s2_R_1132_TGCTAAGTTC	CAAGCAGAAGACGGCATACGAGATTGCTAAGTTCAGGGTCAAGTGCACAGTCTA
s2_R_1133_ATACAAGCAC	CAAGCAGAAGACGGCATACGAGATATACAAGCACAGGGTCAAGTGCACAGTCTA
s2_R_1134_TGACATGCAG	CAAGCAGAAGACGGCATACGAGATTGACATGCAGAGGGTCAAGTGCACAGTCTA
s2_R_1135_CACGTAGTTG	CAAGCAGAAGACGGCATACGAGATCACGTAGTTGAGGGTCAAGTGCACAGTCTA
s2_R_1136_CTTACTAGGA	CAAGCAGAAGACGGCATACGAGATCTTACTAGGAAGGGTCAAGTGCACAGTCTA
s2_R_1137_ATTCTTGTGG	CAAGCAGAAGACGGCATACGAGATATTCTTGTGGAGGGTCAAGTGCACAGTCTA
s2_R_1138_GCAAGGAATT	CAAGCAGAAGACGGCATACGAGATGCAAGGAATTAGGGTCAAGTGCACAGTCTA
s2_R_1139_GATTCAAGGC	CAAGCAGAAGACGGCATACGAGATGATTCAAGGCAGGGTCAAGTGCACAGTCTA
s2_R_1140_GACCAACCTC	CAAGCAGAAGACGGCATACGAGATGACCAACCTCAGGGTCAAGTGCACAGTCTA
s2_R_1141_GGTAAGTCGG	CAAGCAGAAGACGGCATACGAGATGGTAAGTCGGAGGGTCAAGTGCACAGTCTA
s2_R_1142_ATCAGATGGT	CAAGCAGAAGACGGCATACGAGATATCAGATGGTAGGGTCAAGTGCACAGTCTA
s2_R_1143_TTCCACGACC	CAAGCAGAAGACGGCATACGAGATTTCCACGACCAGGGTCAAGTGCACAGTCTA
s2_R_1144_CCGACAACGA	CAAGCAGAAGACGGCATACGAGATCCGACAACGAAGGGTCAAGTGCACAGTCTA
s2_R_1145_CACTTCCACC	CAAGCAGAAGACGGCATACGAGATCACTTCCACCAGGGTCAAGTGCACAGTCTA
s2_R_1146_CACCACAATG	CAAGCAGAAGACGGCATACGAGATCACCACAATGAGGGTCAAGTGCACAGTCTA
s2_R_1147_TTACGTTAGC	CAAGCAGAAGACGGCATACGAGATTTACGTTAGCAGGGTCAAGTGCACAGTCTA
s2_R_1148_TAGGATGGAA	CAAGCAGAAGACGGCATACGAGATTAGGATGGAAAGGGTCAAGTGCACAGTCTA
s2_R_1149_TAGGAACTCC	CAAGCAGAAGACGGCATACGAGATTAGGAACTCCAGGGTCAAGTGCACAGTCTA
s2_R_1150_GACCTTGCAC	CAAGCAGAAGACGGCATACGAGATGACCTTGCACAGGGTCAAGTGCACAGTCTA
s2_R_1151_CAGACCTATA	CAAGCAGAAGACGGCATACGAGATCAGACCTATAAGGGTCAAGTGCACAGTCTA
s2_R_1152_TTAGGAACGT	CAAGCAGAAGACGGCATACGAGATTTAGGAACGTAGGGTCAAGTGCACAGTCTA
s2_R_1153_CAGTAATCCG	CAAGCAGAAGACGGCATACGAGATCAGTAATCCGAGGGTCAAGTGCACAGTCTA
s2_R_1154_GTTAAGTAGC	CAAGCAGAAGACGGCATACGAGATGTTAAGTAGCAGGGTCAAGTGCACAGTCTA
s2_R_1155_TTCTCTCGTA	CAAGCAGAAGACGGCATACGAGATTTCTCTCGTAAGGGTCAAGTGCACAGTCTA
s2_R_1156_TTAGTCAGCT	CAAGCAGAAGACGGCATACGAGATTTAGTCAGCTAGGGTCAAGTGCACAGTCTA
s2_R_1157_CCGACTGTTC	CAAGCAGAAGACGGCATACGAGATCCGACTGTTCAGGGTCAAGTGCACAGTCTA
s2_R_1158_TATACAGCTC	CAAGCAGAAGACGGCATACGAGATTATACAGCTCAGGGTCAAGTGCACAGTCTA
s2_R_1159_CAGTTGCGTC	CAAGCAGAAGACGGCATACGAGATCAGTTGCGTCAGGGTCAAGTGCACAGTCTA
s2_R_1160_TTAGGACATG	CAAGCAGAAGACGGCATACGAGATTTAGGACATGAGGGTCAAGTGCACAGTCTA
s2_R_1161_TACAAGGTCG	CAAGCAGAAGACGGCATACGAGATTACAAGGTCGAGGGTCAAGTGCACAGTCTA
s2_R_1162_CCATGCAATT	CAAGCAGAAGACGGCATACGAGATCCATGCAATTAGGGTCAAGTGCACAGTCTA
s2_R_1163_GTCAGTACAG	CAAGCAGAAGACGGCATACGAGATGTCAGTACAGAGGGTCAAGTGCACAGTCTA
s2_R_1164_TCTAAGACCT	CAAGCAGAAGACGGCATACGAGATTCTAAGACCTAGGGTCAAGTGCACAGTCTA
s2_R_1165_GATGCCTAAT	CAAGCAGAAGACGGCATACGAGATGATGCCTAATAGGGTCAAGTGCACAGTCTA
s2_R_1166_ACTACGATAG	CAAGCAGAAGACGGCATACGAGATACTACGATAGAGGGTCAAGTGCACAGTCTA
s2_R_1167_AGGACAATGC	CAAGCAGAAGACGGCATACGAGATAGGACAATGCAGGGTCAAGTGCACAGTCTA
s2_R_1168_ACATCTCTCA	CAAGCAGAAGACGGCATACGAGATACATCTCTCAAGGGTCAAGTGCACAGTCTA
s2_R_1169_CGGACATTAC	CAAGCAGAAGACGGCATACGAGATCGGACATTACAGGGTCAAGTGCACAGTCTA
s2_R_1170_CCTAGTGACC	CAAGCAGAAGACGGCATACGAGATCCTAGTGACCAGGGTCAAGTGCACAGTCTA
s2_R_1171_TTCGTTATCC	CAAGCAGAAGACGGCATACGAGATTTCGTTATCCAGGGTCAAGTGCACAGTCTA
s2_R_1172_GCAGTTACTC	CAAGCAGAAGACGGCATACGAGATGCAGTTACTCAGGGTCAAGTGCACAGTCTA
s2_R_1173_TTGGCGTTGG	CAAGCAGAAGACGGCATACGAGATTTGGCGTTGGAGGGTCAAGTGCACAGTCTA
s2_R_1174_CTAACACCTT	CAAGCAGAAGACGGCATACGAGATCTAACACCTTAGGGTCAAGTGCACAGTCTA
s2_R_1175_TCACCATTGC	CAAGCAGAAGACGGCATACGAGATTCACCATTGCAGGGTCAAGTGCACAGTCTA
s2_R_1176_CATACAATGC	CAAGCAGAAGACGGCATACGAGATCATACAATGCAGGGTCAAGTGCACAGTCTA
s2_R_1177_TAGGATCCTC	CAAGCAGAAGACGGCATACGAGATTAGGATCCTCAGGGTCAAGTGCACAGTCTA
s2_R_1178_TAGTACCACC	CAAGCAGAAGACGGCATACGAGATTAGTACCACCAGGGTCAAGTGCACAGTCTA
s2_R_1179_GTTCAAGAGG	CAAGCAGAAGACGGCATACGAGATGTTCAAGAGGAGGGTCAAGTGCACAGTCTA
s2_R_1180_TAAGTCAGAG	CAAGCAGAAGACGGCATACGAGATTAAGTCAGAGAGGGTCAAGTGCACAGTCTA
s2_R_1181_CCAAGTGATA	CAAGCAGAAGACGGCATACGAGATCCAAGTGATAAGGGTCAAGTGCACAGTCTA
s2_R_1182_CTCTCCGAAC	CAAGCAGAAGACGGCATACGAGATCTCTCCGAACAGGGTCAAGTGCACAGTCTA
s2_R_1183_TGTCAAGCCT	CAAGCAGAAGACGGCATACGAGATTGTCAAGCCTAGGGTCAAGTGCACAGTCTA
s2_R_1184_GCACACTTCC	CAAGCAGAAGACGGCATACGAGATGCACACTTCCAGGGTCAAGTGCACAGTCTA
s2_R_1185_TCAAGGTTGC	CAAGCAGAAGACGGCATACGAGATTCAAGGTTGCAGGGTCAAGTGCACAGTCTA
s2_R_1186_TCAGACTATG	CAAGCAGAAGACGGCATACGAGATTCAGACTATGAGGGTCAAGTGCACAGTCTA
s2_R_1187_TACATGCCTT	CAAGCAGAAGACGGCATACGAGATTACATGCCTTAGGGTCAAGTGCACAGTCTA
s2_R_1188_CTGGTGTTAG	CAAGCAGAAGACGGCATACGAGATCTGGTGTTAGAGGGTCAAGTGCACAGTCTA
s2_R_1189_TGATAGCCAC	CAAGCAGAAGACGGCATACGAGATTGATAGCCACAGGGTCAAGTGCACAGTCTA
s2_R_1190_TAGGACGAAC	CAAGCAGAAGACGGCATACGAGATTAGGACGAACAGGGTCAAGTGCACAGTCTA
s2_R_1191_TAAGAGTTCC	CAAGCAGAAGACGGCATACGAGATTAAGAGTTCCAGGGTCAAGTGCACAGTCTA
s2_R_1192_TCATAGGATG	CAAGCAGAAGACGGCATACGAGATTCATAGGATGAGGGTCAAGTGCACAGTCTA
s2_R_1193_TTGATCAGCG	CAAGCAGAAGACGGCATACGAGATTTGATCAGCGAGGGTCAAGTGCACAGTCTA
s2_R_1194_TATCTAAGGC	CAAGCAGAAGACGGCATACGAGATTATCTAAGGCAGGGTCAAGTGCACAGTCTA
s2_R_1195_GGATTACGTG	CAAGCAGAAGACGGCATACGAGATGGATTACGTGAGGGTCAAGTGCACAGTCTA
s2_R_1196_CATAAGCGGT	CAAGCAGAAGACGGCATACGAGATCATAAGCGGTAGGGTCAAGTGCACAGTCTA
s2_R_1197_TTACTCTACC	CAAGCAGAAGACGGCATACGAGATTTACTCTACCAGGGTCAAGTGCACAGTCTA
s2_R_1198_CATGTGCCTA	CAAGCAGAAGACGGCATACGAGATCATGTGCCTAAGGGTCAAGTGCACAGTCTA
s2_R_1199_TTGTGATCGG	CAAGCAGAAGACGGCATACGAGATTTGTGATCGGAGGGTCAAGTGCACAGTCTA
s2_R_1200_GAGGACTGAT	CAAGCAGAAGACGGCATACGAGATGAGGACTGATAGGGTCAAGTGCACAGTCTA
s2_R_1201_GCGTGCCTTA	CAAGCAGAAGACGGCATACGAGATGCGTGCCTTAAGGGTCAAGTGCACAGTCTA
s2_R_1202_CGAGCGAATA	CAAGCAGAAGACGGCATACGAGATCGAGCGAATAAGGGTCAAGTGCACAGTCTA
s2_R_1203_TCTAGACTGG	CAAGCAGAAGACGGCATACGAGATTCTAGACTGGAGGGTCAAGTGCACAGTCTA
s2_R_1204_TCGCCAACGT	CAAGCAGAAGACGGCATACGAGATTCGCCAACGTAGGGTCAAGTGCACAGTCTA
s2_R_1205_TGATTGGCAT	CAAGCAGAAGACGGCATACGAGATTGATTGGCATAGGGTCAAGTGCACAGTCTA
s2_R_1206_TATCCAGTTG	CAAGCAGAAGACGGCATACGAGATTATCCAGTTGAGGGTCAAGTGCACAGTCTA
s2_R_1207_TCACCATACT	CAAGCAGAAGACGGCATACGAGATTCACCATACTAGGGTCAAGTGCACAGTCTA
s2_R_1208_CATACGGTGA	CAAGCAGAAGACGGCATACGAGATCATACGGTGAAGGGTCAAGTGCACAGTCTA
s2_R_1209_GTCGGTTACC	CAAGCAGAAGACGGCATACGAGATGTCGGTTACCAGGGTCAAGTGCACAGTCTA
s2_R_1210_TTGTCCACTG	CAAGCAGAAGACGGCATACGAGATTTGTCCACTGAGGGTCAAGTGCACAGTCTA
s2_R_1211_TGCGACCTTG	CAAGCAGAAGACGGCATACGAGATTGCGACCTTGAGGGTCAAGTGCACAGTCTA
s2_R_1212_GCATCTTAGC	CAAGCAGAAGACGGCATACGAGATGCATCTTAGCAGGGTCAAGTGCACAGTCTA
s2_R_1213_AGCGGTGTAT	CAAGCAGAAGACGGCATACGAGATAGCGGTGTATAGGGTCAAGTGCACAGTCTA
s2_R_1214_TCAATTGGCG	CAAGCAGAAGACGGCATACGAGATTCAATTGGCGAGGGTCAAGTGCACAGTCTA
s2_R_1215_GATCGGTGAA	CAAGCAGAAGACGGCATACGAGATGATCGGTGAAAGGGTCAAGTGCACAGTCTA
s2_R_1216_GAGGTGAGAC	CAAGCAGAAGACGGCATACGAGATGAGGTGAGACAGGGTCAAGTGCACAGTCTA
s2_R_1217_CACTGACTGG	CAAGCAGAAGACGGCATACGAGATCACTGACTGGAGGGTCAAGTGCACAGTCTA
s2_R_1218_ATGCAAGGTT	CAAGCAGAAGACGGCATACGAGATATGCAAGGTTAGGGTCAAGTGCACAGTCTA
s2_R_1219_GAGATAGTGA	CAAGCAGAAGACGGCATACGAGATGAGATAGTGAAGGGTCAAGTGCACAGTCTA
s2_R_1220_TCGAGTTAAC	CAAGCAGAAGACGGCATACGAGATTCGAGTTAACAGGGTCAAGTGCACAGTCTA
s2_R_1221_AGTCACAACA	CAAGCAGAAGACGGCATACGAGATAGTCACAACAAGGGTCAAGTGCACAGTCTA
s2_R_1222_GTCAAGCATT	CAAGCAGAAGACGGCATACGAGATGTCAAGCATTAGGGTCAAGTGCACAGTCTA
s2_R_1223_GACAACGGAC	CAAGCAGAAGACGGCATACGAGATGACAACGGACAGGGTCAAGTGCACAGTCTA
s2_R_1224_ATGCATGACA	CAAGCAGAAGACGGCATACGAGATATGCATGACAAGGGTCAAGTGCACAGTCTA
s2_R_1225_CTATGCACAC	CAAGCAGAAGACGGCATACGAGATCTATGCACACAGGGTCAAGTGCACAGTCTA
s2_R_1226_CTACCAAGGA	CAAGCAGAAGACGGCATACGAGATCTACCAAGGAAGGGTCAAGTGCACAGTCTA
s2_R_1227_TACTTACCGA	CAAGCAGAAGACGGCATACGAGATTACTTACCGAAGGGTCAAGTGCACAGTCTA
s2_R_1228_AAGCGAGGAG	CAAGCAGAAGACGGCATACGAGATAAGCGAGGAGAGGGTCAAGTGCACAGTCTA
s2_R_1229_TGAAGCAAGA	CAAGCAGAAGACGGCATACGAGATTGAAGCAAGAAGGGTCAAGTGCACAGTCTA
s2_R_1230_ATGACTTCCA	CAAGCAGAAGACGGCATACGAGATATGACTTCCAAGGGTCAAGTGCACAGTCTA
s2_R_1231_GTCTCTGAAT	CAAGCAGAAGACGGCATACGAGATGTCTCTGAATAGGGTCAAGTGCACAGTCTA
s2_R_1232_GTAGCTTGAG	CAAGCAGAAGACGGCATACGAGATGTAGCTTGAGAGGGTCAAGTGCACAGTCTA
s2_R_1233_GCTACGTAGG	CAAGCAGAAGACGGCATACGAGATGCTACGTAGGAGGGTCAAGTGCACAGTCTA
s2_R_1234_TACGCAATGT	CAAGCAGAAGACGGCATACGAGATTACGCAATGTAGGGTCAAGTGCACAGTCTA
s2_R_1235_GCTTCTCCAG	CAAGCAGAAGACGGCATACGAGATGCTTCTCCAGAGGGTCAAGTGCACAGTCTA
s2_R_1236_TATATGCGGC	CAAGCAGAAGACGGCATACGAGATTATATGCGGCAGGGTCAAGTGCACAGTCTA
s2_R_1237_CTCCAACCTT	CAAGCAGAAGACGGCATACGAGATCTCCAACCTTAGGGTCAAGTGCACAGTCTA
s2_R_1238_CACACAGATA	CAAGCAGAAGACGGCATACGAGATCACACAGATAAGGGTCAAGTGCACAGTCTA
s2_R_1239_AGAGCTGATT	CAAGCAGAAGACGGCATACGAGATAGAGCTGATTAGGGTCAAGTGCACAGTCTA
s2_R_1240_GAGAGCATAG	CAAGCAGAAGACGGCATACGAGATGAGAGCATAGAGGGTCAAGTGCACAGTCTA
s2_R_1241_TCTGTGTGCC	CAAGCAGAAGACGGCATACGAGATTCTGTGTGCCAGGGTCAAGTGCACAGTCTA
s2_R_1242_CAACAAGCGA	CAAGCAGAAGACGGCATACGAGATCAACAAGCGAAGGGTCAAGTGCACAGTCTA
s2_R_1243_GAGTTAGTAG	CAAGCAGAAGACGGCATACGAGATGAGTTAGTAGAGGGTCAAGTGCACAGTCTA
s2_R_1244_GATAGCAATG	CAAGCAGAAGACGGCATACGAGATGATAGCAATGAGGGTCAAGTGCACAGTCTA
s2_R_1245_TCATAACGGC	CAAGCAGAAGACGGCATACGAGATTCATAACGGCAGGGTCAAGTGCACAGTCTA
s2_R_1246_TCGACATTCC	CAAGCAGAAGACGGCATACGAGATTCGACATTCCAGGGTCAAGTGCACAGTCTA
s2_R_1247_ACCAGAGATA	CAAGCAGAAGACGGCATACGAGATACCAGAGATAAGGGTCAAGTGCACAGTCTA
s2_R_1248_TGTTGCAACG	CAAGCAGAAGACGGCATACGAGATTGTTGCAACGAGGGTCAAGTGCACAGTCTA
s2_R_1249_CGTGCAGTAT	CAAGCAGAAGACGGCATACGAGATCGTGCAGTATAGGGTCAAGTGCACAGTCTA
s2_R_1250_TGAGAGCGAA	CAAGCAGAAGACGGCATACGAGATTGAGAGCGAAAGGGTCAAGTGCACAGTCTA
s2_R_1251_CATATCCTCC	CAAGCAGAAGACGGCATACGAGATCATATCCTCCAGGGTCAAGTGCACAGTCTA
s2_R_1252_CTGGTGAAGG	CAAGCAGAAGACGGCATACGAGATCTGGTGAAGGAGGGTCAAGTGCACAGTCTA
s2_R_1253_GCCTAGTGTC	CAAGCAGAAGACGGCATACGAGATGCCTAGTGTCAGGGTCAAGTGCACAGTCTA
s2_R_1254_GACTAAGCTG	CAAGCAGAAGACGGCATACGAGATGACTAAGCTGAGGGTCAAGTGCACAGTCTA
s2_R_1255_CCTATACCAT	CAAGCAGAAGACGGCATACGAGATCCTATACCATAGGGTCAAGTGCACAGTCTA
s2_R_1256_AGCCTAACAA	CAAGCAGAAGACGGCATACGAGATAGCCTAACAAAGGGTCAAGTGCACAGTCTA
s2_R_1257_CACTCGCTAT	CAAGCAGAAGACGGCATACGAGATCACTCGCTATAGGGTCAAGTGCACAGTCTA
s2_R_1258_ACCGACTAAT	CAAGCAGAAGACGGCATACGAGATACCGACTAATAGGGTCAAGTGCACAGTCTA
s2_R_1259_ATCTACCTAC	CAAGCAGAAGACGGCATACGAGATATCTACCTACAGGGTCAAGTGCACAGTCTA
s2_R_1260_CCTCACTTAT	CAAGCAGAAGACGGCATACGAGATCCTCACTTATAGGGTCAAGTGCACAGTCTA
s2_R_1261_TAGCGAGCGT	CAAGCAGAAGACGGCATACGAGATTAGCGAGCGTAGGGTCAAGTGCACAGTCTA
s2_R_1262_GCATACAGCG	CAAGCAGAAGACGGCATACGAGATGCATACAGCGAGGGTCAAGTGCACAGTCTA
s2_R_1263_CACGCTCATA	CAAGCAGAAGACGGCATACGAGATCACGCTCATAAGGGTCAAGTGCACAGTCTA
s2_R_1264_CAATAGCTCC	CAAGCAGAAGACGGCATACGAGATCAATAGCTCCAGGGTCAAGTGCACAGTCTA
s2_R_1265_CTTCACTGTT	CAAGCAGAAGACGGCATACGAGATCTTCACTGTTAGGGTCAAGTGCACAGTCTA
s2_R_1266_ATCGCCACAT	CAAGCAGAAGACGGCATACGAGATATCGCCACATAGGGTCAAGTGCACAGTCTA
s2_R_1267_CAACTCAGAA	CAAGCAGAAGACGGCATACGAGATCAACTCAGAAAGGGTCAAGTGCACAGTCTA
s2_R_1268_GCGGTATAGC	CAAGCAGAAGACGGCATACGAGATGCGGTATAGCAGGGTCAAGTGCACAGTCTA
s2_R_1269_TTGAAGTGGC	CAAGCAGAAGACGGCATACGAGATTTGAAGTGGCAGGGTCAAGTGCACAGTCTA
s2_R_1270_CCGATGATGA	CAAGCAGAAGACGGCATACGAGATCCGATGATGAAGGGTCAAGTGCACAGTCTA
s2_R_1271_GGTCCTACTC	CAAGCAGAAGACGGCATACGAGATGGTCCTACTCAGGGTCAAGTGCACAGTCTA
s2_R_1272_CCGTTACTCT	CAAGCAGAAGACGGCATACGAGATCCGTTACTCTAGGGTCAAGTGCACAGTCTA
s2_R_1273_AACCTAGACC	CAAGCAGAAGACGGCATACGAGATAACCTAGACCAGGGTCAAGTGCACAGTCTA
s2_R_1274_CGCAAGAATA	CAAGCAGAAGACGGCATACGAGATCGCAAGAATAAGGGTCAAGTGCACAGTCTA
s2_R_1275_TACGATCACC	CAAGCAGAAGACGGCATACGAGATTACGATCACCAGGGTCAAGTGCACAGTCTA
s2_R_1276_CCACAAGTAT	CAAGCAGAAGACGGCATACGAGATCCACAAGTATAGGGTCAAGTGCACAGTCTA
s2_R_1277_GATCCTGACC	CAAGCAGAAGACGGCATACGAGATGATCCTGACCAGGGTCAAGTGCACAGTCTA
s2_R_1278_AGCTAACGAG	CAAGCAGAAGACGGCATACGAGATAGCTAACGAGAGGGTCAAGTGCACAGTCTA
s2_R_1279_CTTGTCCATA	CAAGCAGAAGACGGCATACGAGATCTTGTCCATAAGGGTCAAGTGCACAGTCTA
s2_R_1280_TGGAGTCTTA	CAAGCAGAAGACGGCATACGAGATTGGAGTCTTAAGGGTCAAGTGCACAGTCTA
s2_R_1281_CCAACACGAT	CAAGCAGAAGACGGCATACGAGATCCAACACGATAGGGTCAAGTGCACAGTCTA
s2_R_1282_ACTAGTCAAG	CAAGCAGAAGACGGCATACGAGATACTAGTCAAGAGGGTCAAGTGCACAGTCTA
s2_R_1283_TGAAGGAGAG	CAAGCAGAAGACGGCATACGAGATTGAAGGAGAGAGGGTCAAGTGCACAGTCTA
s2_R_1284_GCTATGACTC	CAAGCAGAAGACGGCATACGAGATGCTATGACTCAGGGTCAAGTGCACAGTCTA
s2_R_1285_GCACTAGTCA	CAAGCAGAAGACGGCATACGAGATGCACTAGTCAAGGGTCAAGTGCACAGTCTA
s2_R_1286_GTCGGCCATT	CAAGCAGAAGACGGCATACGAGATGTCGGCCATTAGGGTCAAGTGCACAGTCTA
s2_R_1287_TTCGACAGAT	CAAGCAGAAGACGGCATACGAGATTTCGACAGATAGGGTCAAGTGCACAGTCTA
s2_R_1288_CGACTAGCAG	CAAGCAGAAGACGGCATACGAGATCGACTAGCAGAGGGTCAAGTGCACAGTCTA
s2_R_1289_CACGTTGCTT	CAAGCAGAAGACGGCATACGAGATCACGTTGCTTAGGGTCAAGTGCACAGTCTA
s2_R_1290_GTACGAGGAC	CAAGCAGAAGACGGCATACGAGATGTACGAGGACAGGGTCAAGTGCACAGTCTA
s2_R_1291_ATGGACATCT	CAAGCAGAAGACGGCATACGAGATATGGACATCTAGGGTCAAGTGCACAGTCTA
s2_R_1292_GCAAGTCCTA	CAAGCAGAAGACGGCATACGAGATGCAAGTCCTAAGGGTCAAGTGCACAGTCTA
s2_R_1293_GGAAGTCGAT	CAAGCAGAAGACGGCATACGAGATGGAAGTCGATAGGGTCAAGTGCACAGTCTA
s2_R_1294_TAGGACTTGG	CAAGCAGAAGACGGCATACGAGATTAGGACTTGGAGGGTCAAGTGCACAGTCTA
s2_R_1295_GCAGACATGT	CAAGCAGAAGACGGCATACGAGATGCAGACATGTAGGGTCAAGTGCACAGTCTA
s2_R_1296_CTCCTGTCTT	CAAGCAGAAGACGGCATACGAGATCTCCTGTCTTAGGGTCAAGTGCACAGTCTA
s2_R_1297_TAGTCCAGGC	CAAGCAGAAGACGGCATACGAGATTAGTCCAGGCAGGGTCAAGTGCACAGTCTA
s2_R_1298_TCCACAGCTT	CAAGCAGAAGACGGCATACGAGATTCCACAGCTTAGGGTCAAGTGCACAGTCTA
s2_R_1299_TTATGCAAGG	CAAGCAGAAGACGGCATACGAGATTTATGCAAGGAGGGTCAAGTGCACAGTCTA
s2_R_1300_CAACAGGCTT	CAAGCAGAAGACGGCATACGAGATCAACAGGCTTAGGGTCAAGTGCACAGTCTA
s2_R_1301_TTGCGAGGAT	CAAGCAGAAGACGGCATACGAGATTTGCGAGGATAGGGTCAAGTGCACAGTCTA
s2_R_1302_TGCAATGCTG	CAAGCAGAAGACGGCATACGAGATTGCAATGCTGAGGGTCAAGTGCACAGTCTA
s2_R_1303_CTGACGCATA	CAAGCAGAAGACGGCATACGAGATCTGACGCATAAGGGTCAAGTGCACAGTCTA
s2_R_1304_CTACGTTGAG	CAAGCAGAAGACGGCATACGAGATCTACGTTGAGAGGGTCAAGTGCACAGTCTA
s2_R_1305_CGACTTATGT	CAAGCAGAAGACGGCATACGAGATCGACTTATGTAGGGTCAAGTGCACAGTCTA
s2_R_1306_AGTCAGGTGT	CAAGCAGAAGACGGCATACGAGATAGTCAGGTGTAGGGTCAAGTGCACAGTCTA
s2_R_1307_GCTGCGATCA	CAAGCAGAAGACGGCATACGAGATGCTGCGATCAAGGGTCAAGTGCACAGTCTA
s2_R_1308_CCACCGAACA	CAAGCAGAAGACGGCATACGAGATCCACCGAACAAGGGTCAAGTGCACAGTCTA
s2_R_1309_TTAAGGCCAC	CAAGCAGAAGACGGCATACGAGATTTAAGGCCACAGGGTCAAGTGCACAGTCTA
s2_R_1310_TGGCTCAACC	CAAGCAGAAGACGGCATACGAGATTGGCTCAACCAGGGTCAAGTGCACAGTCTA
s2_R_1311_TCGTAGTACC	CAAGCAGAAGACGGCATACGAGATTCGTAGTACCAGGGTCAAGTGCACAGTCTA
s2_R_1312_CGTGATAGCT	CAAGCAGAAGACGGCATACGAGATCGTGATAGCTAGGGTCAAGTGCACAGTCTA
s2_R_1313_CCAGTCAATG	CAAGCAGAAGACGGCATACGAGATCCAGTCAATGAGGGTCAAGTGCACAGTCTA
s2_R_1314_GTCCTTACAT	CAAGCAGAAGACGGCATACGAGATGTCCTTACATAGGGTCAAGTGCACAGTCTA
s2_R_1315_CTCTCAGTGA	CAAGCAGAAGACGGCATACGAGATCTCTCAGTGAAGGGTCAAGTGCACAGTCTA
s2_R_1316_CTCTAGTCCT	CAAGCAGAAGACGGCATACGAGATCTCTAGTCCTAGGGTCAAGTGCACAGTCTA
s2_R_1317_CTCCGATTGA	CAAGCAGAAGACGGCATACGAGATCTCCGATTGAAGGGTCAAGTGCACAGTCTA
s2_R_1318_CAAGAGGCAA	CAAGCAGAAGACGGCATACGAGATCAAGAGGCAAAGGGTCAAGTGCACAGTCTA
s2_R_1319_CTCTGGATAC	CAAGCAGAAGACGGCATACGAGATCTCTGGATACAGGGTCAAGTGCACAGTCTA
s2_R_1320_GAGCTGCTGT	CAAGCAGAAGACGGCATACGAGATGAGCTGCTGTAGGGTCAAGTGCACAGTCTA
s2_R_1321_GACTAGGCAC	CAAGCAGAAGACGGCATACGAGATGACTAGGCACAGGGTCAAGTGCACAGTCTA
s2_R_1322_CGGTTGCCTT	CAAGCAGAAGACGGCATACGAGATCGGTTGCCTTAGGGTCAAGTGCACAGTCTA
s2_R_1323_CGATGCTAGT	CAAGCAGAAGACGGCATACGAGATCGATGCTAGTAGGGTCAAGTGCACAGTCTA
s2_R_1324_GCGGAGATCT	CAAGCAGAAGACGGCATACGAGATGCGGAGATCTAGGGTCAAGTGCACAGTCTA
s2_R_1325_GCAATGCGGT	CAAGCAGAAGACGGCATACGAGATGCAATGCGGTAGGGTCAAGTGCACAGTCTA
s2_R_1326_GCACACGAAG	CAAGCAGAAGACGGCATACGAGATGCACACGAAGAGGGTCAAGTGCACAGTCTA
s2_R_1327_ACGCTGAACC	CAAGCAGAAGACGGCATACGAGATACGCTGAACCAGGGTCAAGTGCACAGTCTA
s2_R_1328_TGTCTAGCAC	CAAGCAGAAGACGGCATACGAGATTGTCTAGCACAGGGTCAAGTGCACAGTCTA
s2_R_1329_GTCGTTCTAC	CAAGCAGAAGACGGCATACGAGATGTCGTTCTACAGGGTCAAGTGCACAGTCTA
s2_R_1330_CCTAACATCT	CAAGCAGAAGACGGCATACGAGATCCTAACATCTAGGGTCAAGTGCACAGTCTA
s2_R_1331_CAGTGAGCAA	CAAGCAGAAGACGGCATACGAGATCAGTGAGCAAAGGGTCAAGTGCACAGTCTA
s2_R_1332_CCTGCCTACT	CAAGCAGAAGACGGCATACGAGATCCTGCCTACTAGGGTCAAGTGCACAGTCTA
s2_R_1333_GTAACGCATC	CAAGCAGAAGACGGCATACGAGATGTAACGCATCAGGGTCAAGTGCACAGTCTA
s2_R_1334_CATGTACTCA	CAAGCAGAAGACGGCATACGAGATCATGTACTCAAGGGTCAAGTGCACAGTCTA
s2_R_1335_GTATCAGAAC	CAAGCAGAAGACGGCATACGAGATGTATCAGAACAGGGTCAAGTGCACAGTCTA
s2_R_1336_GAACAAGCAT	CAAGCAGAAGACGGCATACGAGATGAACAAGCATAGGGTCAAGTGCACAGTCTA
s2_R_1337_TCAAGAGCAC	CAAGCAGAAGACGGCATACGAGATTCAAGAGCACAGGGTCAAGTGCACAGTCTA
s2_R_1338_GAGATTAGGC	CAAGCAGAAGACGGCATACGAGATGAGATTAGGCAGGGTCAAGTGCACAGTCTA
s2_R_1339_GTATTGAAGC	CAAGCAGAAGACGGCATACGAGATGTATTGAAGCAGGGTCAAGTGCACAGTCTA
s2_R_1340_GGAACTATAC	CAAGCAGAAGACGGCATACGAGATGGAACTATACAGGGTCAAGTGCACAGTCTA
s2_R_1341_ATGCACACTA	CAAGCAGAAGACGGCATACGAGATATGCACACTAAGGGTCAAGTGCACAGTCTA
s2_R_1342_GAATACTCCT	CAAGCAGAAGACGGCATACGAGATGAATACTCCTAGGGTCAAGTGCACAGTCTA
s2_R_1343_ACTAGAGCAA	CAAGCAGAAGACGGCATACGAGATACTAGAGCAAAGGGTCAAGTGCACAGTCTA
s2_R_1344_ACGGAAGCTC	CAAGCAGAAGACGGCATACGAGATACGGAAGCTCAGGGTCAAGTGCACAGTCTA
s2_R_1345_ATAGTGAGGT	CAAGCAGAAGACGGCATACGAGATATAGTGAGGTAGGGTCAAGTGCACAGTCTA
s2_R_1346_CATGAATAGG	CAAGCAGAAGACGGCATACGAGATCATGAATAGGAGGGTCAAGTGCACAGTCTA
s2_R_1347_GAGTTAAGCT	CAAGCAGAAGACGGCATACGAGATGAGTTAAGCTAGGGTCAAGTGCACAGTCTA
s2_R_1348_TGTCGTCGAC	CAAGCAGAAGACGGCATACGAGATTGTCGTCGACAGGGTCAAGTGCACAGTCTA
s2_R_1349_GGATAAGATC	CAAGCAGAAGACGGCATACGAGATGGATAAGATCAGGGTCAAGTGCACAGTCTA
s2_R_1350_CACGAATGAT	CAAGCAGAAGACGGCATACGAGATCACGAATGATAGGGTCAAGTGCACAGTCTA
s2_R_1351_CTAGCTGACG	CAAGCAGAAGACGGCATACGAGATCTAGCTGACGAGGGTCAAGTGCACAGTCTA
s2_R_1352_GACATAGCTA	CAAGCAGAAGACGGCATACGAGATGACATAGCTAAGGGTCAAGTGCACAGTCTA
s2_R_1353_AGGCATCCTA	CAAGCAGAAGACGGCATACGAGATAGGCATCCTAAGGGTCAAGTGCACAGTCTA
s2_R_1354_CGACAGAATG	CAAGCAGAAGACGGCATACGAGATCGACAGAATGAGGGTCAAGTGCACAGTCTA
s2_R_1355_TAGCTTCACC	CAAGCAGAAGACGGCATACGAGATTAGCTTCACCAGGGTCAAGTGCACAGTCTA
s2_R_1356_ATACCATCGA	CAAGCAGAAGACGGCATACGAGATATACCATCGAAGGGTCAAGTGCACAGTCTA
s2_R_1357_CACGAGATTA	CAAGCAGAAGACGGCATACGAGATCACGAGATTAAGGGTCAAGTGCACAGTCTA
s2_R_1358_TACCACAAGC	CAAGCAGAAGACGGCATACGAGATTACCACAAGCAGGGTCAAGTGCACAGTCTA
s2_R_1359_TCACAGGACT	CAAGCAGAAGACGGCATACGAGATTCACAGGACTAGGGTCAAGTGCACAGTCTA
s2_R_1360_TCGTTGCCTG	CAAGCAGAAGACGGCATACGAGATTCGTTGCCTGAGGGTCAAGTGCACAGTCTA
s2_R_1361_TGACTTAGAG	CAAGCAGAAGACGGCATACGAGATTGACTTAGAGAGGGTCAAGTGCACAGTCTA
s2_R_1362_AGTCTATCCT	CAAGCAGAAGACGGCATACGAGATAGTCTATCCTAGGGTCAAGTGCACAGTCTA
s2_R_1363_ATCCATCACC	CAAGCAGAAGACGGCATACGAGATATCCATCACCAGGGTCAAGTGCACAGTCTA
s2_R_1364_CATCTTCGGT	CAAGCAGAAGACGGCATACGAGATCATCTTCGGTAGGGTCAAGTGCACAGTCTA
s2_R_1365_CAATTAGCAC	CAAGCAGAAGACGGCATACGAGATCAATTAGCACAGGGTCAAGTGCACAGTCTA
s2_R_1366_ATTACAGCGT	CAAGCAGAAGACGGCATACGAGATATTACAGCGTAGGGTCAAGTGCACAGTCTA
s2_R_1367_AGGATGCATA	CAAGCAGAAGACGGCATACGAGATAGGATGCATAAGGGTCAAGTGCACAGTCTA
s2_R_1368_CGCTGTATCG	CAAGCAGAAGACGGCATACGAGATCGCTGTATCGAGGGTCAAGTGCACAGTCTA
s2_R_1369_GGTTACCAAC	CAAGCAGAAGACGGCATACGAGATGGTTACCAACAGGGTCAAGTGCACAGTCTA
s2_R_1370_TCTAACTTGC	CAAGCAGAAGACGGCATACGAGATTCTAACTTGCAGGGTCAAGTGCACAGTCTA
s2_R_1371_GAGTTACAGG	CAAGCAGAAGACGGCATACGAGATGAGTTACAGGAGGGTCAAGTGCACAGTCTA
s2_R_1372_CCTAGCAATA	CAAGCAGAAGACGGCATACGAGATCCTAGCAATAAGGGTCAAGTGCACAGTCTA
s2_R_1373_TTCAGTCCTA	CAAGCAGAAGACGGCATACGAGATTTCAGTCCTAAGGGTCAAGTGCACAGTCTA
s2_R_1374_TACCAATCTG	CAAGCAGAAGACGGCATACGAGATTACCAATCTGAGGGTCAAGTGCACAGTCTA
s2_R_1375_ACACAGGCAA	CAAGCAGAAGACGGCATACGAGATACACAGGCAAAGGGTCAAGTGCACAGTCTA
s2_R_1376_ATTCAGGCAG	CAAGCAGAAGACGGCATACGAGATATTCAGGCAGAGGGTCAAGTGCACAGTCTA
s2_R_1377_CTTCGTGACT	CAAGCAGAAGACGGCATACGAGATCTTCGTGACTAGGGTCAAGTGCACAGTCTA
s2_R_1378_GCAATCATAC	CAAGCAGAAGACGGCATACGAGATGCAATCATACAGGGTCAAGTGCACAGTCTA
s2_R_1379_GCAGAGACTG	CAAGCAGAAGACGGCATACGAGATGCAGAGACTGAGGGTCAAGTGCACAGTCTA
s2_R_1380_GCAACTAATC	CAAGCAGAAGACGGCATACGAGATGCAACTAATCAGGGTCAAGTGCACAGTCTA
s2_R_1381_GCACGATTAG	CAAGCAGAAGACGGCATACGAGATGCACGATTAGAGGGTCAAGTGCACAGTCTA
s2_R_1382_GCAATGGCAC	CAAGCAGAAGACGGCATACGAGATGCAATGGCACAGGGTCAAGTGCACAGTCTA
s2_R_1383_GCACGAACAA	CAAGCAGAAGACGGCATACGAGATGCACGAACAAAGGGTCAAGTGCACAGTCTA
s2_R_1384_GCATACGCAA	CAAGCAGAAGACGGCATACGAGATGCATACGCAAAGGGTCAAGTGCACAGTCTA
s2_R_1385_AGCCAATTGC	CAAGCAGAAGACGGCATACGAGATAGCCAATTGCAGGGTCAAGTGCACAGTCTA
s2_R_1386_GTTACCTACT	CAAGCAGAAGACGGCATACGAGATGTTACCTACTAGGGTCAAGTGCACAGTCTA
s2_R_1387_GCGGATGGTT	CAAGCAGAAGACGGCATACGAGATGCGGATGGTTAGGGTCAAGTGCACAGTCTA
s2_R_1388_ATCGGTGCTT	CAAGCAGAAGACGGCATACGAGATATCGGTGCTTAGGGTCAAGTGCACAGTCTA
s2_R_1389_CTCCAAGCAA	CAAGCAGAAGACGGCATACGAGATCTCCAAGCAAAGGGTCAAGTGCACAGTCTA
s2_R_1390_ATCGAAGCTA	CAAGCAGAAGACGGCATACGAGATATCGAAGCTAAGGGTCAAGTGCACAGTCTA
s2_R_1391_GAGTTGTCAT	CAAGCAGAAGACGGCATACGAGATGAGTTGTCATAGGGTCAAGTGCACAGTCTA
s2_R_1392_TCGTCCTCCA	CAAGCAGAAGACGGCATACGAGATTCGTCCTCCAAGGGTCAAGTGCACAGTCTA
s2_R_1393_TCACTGACAG	CAAGCAGAAGACGGCATACGAGATTCACTGACAGAGGGTCAAGTGCACAGTCTA
s2_R_1394_CTCACCGACT	CAAGCAGAAGACGGCATACGAGATCTCACCGACTAGGGTCAAGTGCACAGTCTA
s2_R_1395_GCTACTAACT	CAAGCAGAAGACGGCATACGAGATGCTACTAACTAGGGTCAAGTGCACAGTCTA
s2_R_1396_CGAAGATTGC	CAAGCAGAAGACGGCATACGAGATCGAAGATTGCAGGGTCAAGTGCACAGTCTA
s2_R_1397_CCTATGGCAG	CAAGCAGAAGACGGCATACGAGATCCTATGGCAGAGGGTCAAGTGCACAGTCTA
s2_R_1398_CCTTAAGGTC	CAAGCAGAAGACGGCATACGAGATCCTTAAGGTCAGGGTCAAGTGCACAGTCTA
s2_R_1399_GGCAAGTTAC	CAAGCAGAAGACGGCATACGAGATGGCAAGTTACAGGGTCAAGTGCACAGTCTA
s2_R_1400_GAATGCAACT	CAAGCAGAAGACGGCATACGAGATGAATGCAACTAGGGTCAAGTGCACAGTCTA
s2_R_1401_GCATAACATG	CAAGCAGAAGACGGCATACGAGATGCATAACATGAGGGTCAAGTGCACAGTCTA
s2_R_1402_GAATGTTGGT	CAAGCAGAAGACGGCATACGAGATGAATGTTGGTAGGGTCAAGTGCACAGTCTA
s2_R_1403_GCAATGTTCC	CAAGCAGAAGACGGCATACGAGATGCAATGTTCCAGGGTCAAGTGCACAGTCTA
s2_R_1404_AGCTAGGCAG	CAAGCAGAAGACGGCATACGAGATAGCTAGGCAGAGGGTCAAGTGCACAGTCTA
s2_R_1405_TTCCATTGGC	CAAGCAGAAGACGGCATACGAGATTTCCATTGGCAGGGTCAAGTGCACAGTCTA
s2_R_1406_GGAGAGCACA	CAAGCAGAAGACGGCATACGAGATGGAGAGCACAAGGGTCAAGTGCACAGTCTA
s2_R_1407_CCAACACTCC	CAAGCAGAAGACGGCATACGAGATCCAACACTCCAGGGTCAAGTGCACAGTCTA
s2_R_1408_TCACGAAGAC	CAAGCAGAAGACGGCATACGAGATTCACGAAGACAGGGTCAAGTGCACAGTCTA
s2_R_1409_GTGTCTTCGG	CAAGCAGAAGACGGCATACGAGATGTGTCTTCGGAGGGTCAAGTGCACAGTCTA
s2_R_1410_CTCAGATTAG	CAAGCAGAAGACGGCATACGAGATCTCAGATTAGAGGGTCAAGTGCACAGTCTA
s2_R_1411_CTCAACGGTC	CAAGCAGAAGACGGCATACGAGATCTCAACGGTCAGGGTCAAGTGCACAGTCTA
s2_R_1412_GGAACCTAGC	CAAGCAGAAGACGGCATACGAGATGGAACCTAGCAGGGTCAAGTGCACAGTCTA
s2_R_1413_TATACCTAGC	CAAGCAGAAGACGGCATACGAGATTATACCTAGCAGGGTCAAGTGCACAGTCTA
s2_R_1414_GTTGAACAGC	CAAGCAGAAGACGGCATACGAGATGTTGAACAGCAGGGTCAAGTGCACAGTCTA
s2_R_1415_GCAACATTGA	CAAGCAGAAGACGGCATACGAGATGCAACATTGAAGGGTCAAGTGCACAGTCTA
s2_R_1416_CTATCAGCAA	CAAGCAGAAGACGGCATACGAGATCTATCAGCAAAGGGTCAAGTGCACAGTCTA
s2_R_1417_CTTCTCTTGC	CAAGCAGAAGACGGCATACGAGATCTTCTCTTGCAGGGTCAAGTGCACAGTCTA
s2_R_1418_GTCTCAATCA	CAAGCAGAAGACGGCATACGAGATGTCTCAATCAAGGGTCAAGTGCACAGTCTA
s2_R_1419_CGTGATGAGG	CAAGCAGAAGACGGCATACGAGATCGTGATGAGGAGGGTCAAGTGCACAGTCTA
s2_R_1420_CTCACGATCC	CAAGCAGAAGACGGCATACGAGATCTCACGATCCAGGGTCAAGTGCACAGTCTA
s2_R_1421_ATCCTGCGGT	CAAGCAGAAGACGGCATACGAGATATCCTGCGGTAGGGTCAAGTGCACAGTCTA
s2_R_1422_GCAACGTCTC	CAAGCAGAAGACGGCATACGAGATGCAACGTCTCAGGGTCAAGTGCACAGTCTA
s2_R_1423_GCAGGAGGAT	CAAGCAGAAGACGGCATACGAGATGCAGGAGGATAGGGTCAAGTGCACAGTCTA
s2_R_1424_GCAATCGAGA	CAAGCAGAAGACGGCATACGAGATGCAATCGAGAAGGGTCAAGTGCACAGTCTA
s2_R_1425_GCACATAGAA	CAAGCAGAAGACGGCATACGAGATGCACATAGAAAGGGTCAAGTGCACAGTCTA
s2_R_1426_CTTAGTGCTG	CAAGCAGAAGACGGCATACGAGATCTTAGTGCTGAGGGTCAAGTGCACAGTCTA
s2_R_1427_GACATTCTTC	CAAGCAGAAGACGGCATACGAGATGACATTCTTCAGGGTCAAGTGCACAGTCTA
s2_R_1428_TGATGGTTAC	CAAGCAGAAGACGGCATACGAGATTGATGGTTACAGGGTCAAGTGCACAGTCTA
s2_R_1429_TTGGCGAATC	CAAGCAGAAGACGGCATACGAGATTTGGCGAATCAGGGTCAAGTGCACAGTCTA
s2_R_1430_ATGACGAGTT	CAAGCAGAAGACGGCATACGAGATATGACGAGTTAGGGTCAAGTGCACAGTCTA
s2_R_1431_GACTTAGCAT	CAAGCAGAAGACGGCATACGAGATGACTTAGCATAGGGTCAAGTGCACAGTCTA
s2_R_1432_TCTACACAGC	CAAGCAGAAGACGGCATACGAGATTCTACACAGCAGGGTCAAGTGCACAGTCTA
s2_R_1433_CTCTCCAATA	CAAGCAGAAGACGGCATACGAGATCTCTCCAATAAGGGTCAAGTGCACAGTCTA
s2_R_1434_CTCCACTCTA	CAAGCAGAAGACGGCATACGAGATCTCCACTCTAAGGGTCAAGTGCACAGTCTA
s2_R_1435_GGACATAAGC	CAAGCAGAAGACGGCATACGAGATGGACATAAGCAGGGTCAAGTGCACAGTCTA
s2_R_1436_GGACGACGAA	CAAGCAGAAGACGGCATACGAGATGGACGACGAAAGGGTCAAGTGCACAGTCTA
s2_R_1437_ATAGCGCATT	CAAGCAGAAGACGGCATACGAGATATAGCGCATTAGGGTCAAGTGCACAGTCTA
s2_R_1438_CGTCCTTGTT	CAAGCAGAAGACGGCATACGAGATCGTCCTTGTTAGGGTCAAGTGCACAGTCTA
s2_R_1439_TGAAGACCAA	CAAGCAGAAGACGGCATACGAGATTGAAGACCAAAGGGTCAAGTGCACAGTCTA
s2_R_1440_GAGTCAAGAA	CAAGCAGAAGACGGCATACGAGATGAGTCAAGAAAGGGTCAAGTGCACAGTCTA
s2_R_1441_TGTCTTCAGA	CAAGCAGAAGACGGCATACGAGATTGTCTTCAGAAGGGTCAAGTGCACAGTCTA
s2_R_1442_TGCTAACACC	CAAGCAGAAGACGGCATACGAGATTGCTAACACCAGGGTCAAGTGCACAGTCTA
s2_R_1443_GCTTAACTAG	CAAGCAGAAGACGGCATACGAGATGCTTAACTAGAGGGTCAAGTGCACAGTCTA
s2_R_1444_GGTAACAGCG	CAAGCAGAAGACGGCATACGAGATGGTAACAGCGAGGGTCAAGTGCACAGTCTA
s2_R_1445_GACGGTGAGT	CAAGCAGAAGACGGCATACGAGATGACGGTGAGTAGGGTCAAGTGCACAGTCTA
s2_R_1446_AGGTACAGGA	CAAGCAGAAGACGGCATACGAGATAGGTACAGGAAGGGTCAAGTGCACAGTCTA
s2_R_1447_AGACTAGAGC	CAAGCAGAAGACGGCATACGAGATAGACTAGAGCAGGGTCAAGTGCACAGTCTA
s2_R_1448_GATGCAAGAG	CAAGCAGAAGACGGCATACGAGATGATGCAAGAGAGGGTCAAGTGCACAGTCTA
s2_R_1449_AGTGCAACTT	CAAGCAGAAGACGGCATACGAGATAGTGCAACTTAGGGTCAAGTGCACAGTCTA
s2_R_1450_TGCACACATG	CAAGCAGAAGACGGCATACGAGATTGCACACATGAGGGTCAAGTGCACAGTCTA
s2_R_1451_ACTCTGGCAC	CAAGCAGAAGACGGCATACGAGATACTCTGGCACAGGGTCAAGTGCACAGTCTA
s2_R_1452_TATGTCCAAG	CAAGCAGAAGACGGCATACGAGATTATGTCCAAGAGGGTCAAGTGCACAGTCTA
s2_R_1453_TCTCATGCAA	CAAGCAGAAGACGGCATACGAGATTCTCATGCAAAGGGTCAAGTGCACAGTCTA
s2_R_1454_GATTGCTTGA	CAAGCAGAAGACGGCATACGAGATGATTGCTTGAAGGGTCAAGTGCACAGTCTA
s2_R_1455_CCATCATTAG	CAAGCAGAAGACGGCATACGAGATCCATCATTAGAGGGTCAAGTGCACAGTCTA
s2_R_1456_CTGTTATTGC	CAAGCAGAAGACGGCATACGAGATCTGTTATTGCAGGGTCAAGTGCACAGTCTA
s2_R_1457_TCCGTCAAGC	CAAGCAGAAGACGGCATACGAGATTCCGTCAAGCAGGGTCAAGTGCACAGTCTA
s2_R_1458_TTCTTCTAGC	CAAGCAGAAGACGGCATACGAGATTTCTTCTAGCAGGGTCAAGTGCACAGTCTA
s2_R_1459_TGATACGAGC	CAAGCAGAAGACGGCATACGAGATTGATACGAGCAGGGTCAAGTGCACAGTCTA
s2_R_1460_CCGAATACCT	CAAGCAGAAGACGGCATACGAGATCCGAATACCTAGGGTCAAGTGCACAGTCTA
s2_R_1461_CGACTGACAA	CAAGCAGAAGACGGCATACGAGATCGACTGACAAAGGGTCAAGTGCACAGTCTA
s2_R_1462_TGTGATATGC	CAAGCAGAAGACGGCATACGAGATTGTGATATGCAGGGTCAAGTGCACAGTCTA
s2_R_1463_TACAGCATGC	CAAGCAGAAGACGGCATACGAGATTACAGCATGCAGGGTCAAGTGCACAGTCTA
s2_R_1464_TATCGCTTCC	CAAGCAGAAGACGGCATACGAGATTATCGCTTCCAGGGTCAAGTGCACAGTCTA
s2_R_1465_ACACTCTTGC	CAAGCAGAAGACGGCATACGAGATACACTCTTGCAGGGTCAAGTGCACAGTCTA
s2_R_1466_CTCTCACACT	CAAGCAGAAGACGGCATACGAGATCTCTCACACTAGGGTCAAGTGCACAGTCTA
s2_R_1467_CTCAGAATGC	CAAGCAGAAGACGGCATACGAGATCTCAGAATGCAGGGTCAAGTGCACAGTCTA
s2_R_1468_CTCAACTAGC	CAAGCAGAAGACGGCATACGAGATCTCAACTAGCAGGGTCAAGTGCACAGTCTA
s2_R_1469_CAGGTCATGG	CAAGCAGAAGACGGCATACGAGATCAGGTCATGGAGGGTCAAGTGCACAGTCTA
s2_R_1470_GCAGGATCTC	CAAGCAGAAGACGGCATACGAGATGCAGGATCTCAGGGTCAAGTGCACAGTCTA
s2_R_1471_GCAGAAGAGC	CAAGCAGAAGACGGCATACGAGATGCAGAAGAGCAGGGTCAAGTGCACAGTCTA
s2_R_1472_GCAACTCTAT	CAAGCAGAAGACGGCATACGAGATGCAACTCTATAGGGTCAAGTGCACAGTCTA
s2_R_1473_GCAACGATAA	CAAGCAGAAGACGGCATACGAGATGCAACGATAAAGGGTCAAGTGCACAGTCTA
s2_R_1474_GCACATCTTA	CAAGCAGAAGACGGCATACGAGATGCACATCTTAAGGGTCAAGTGCACAGTCTA
s2_R_1475_GCAACCACAT	CAAGCAGAAGACGGCATACGAGATGCAACCACATAGGGTCAAGTGCACAGTCTA
s2_R_1476_GCATTGACAT	CAAGCAGAAGACGGCATACGAGATGCATTGACATAGGGTCAAGTGCACAGTCTA
s2_R_1477_GCATATGTAC	CAAGCAGAAGACGGCATACGAGATGCATATGTACAGGGTCAAGTGCACAGTCTA
s2_R_1478_GCATGTCTAA	CAAGCAGAAGACGGCATACGAGATGCATGTCTAAAGGGTCAAGTGCACAGTCTA
s2_R_1479_GCAGGATACA	CAAGCAGAAGACGGCATACGAGATGCAGGATACAAGGGTCAAGTGCACAGTCTA
s2_R_1480_GCATCGACCA	CAAGCAGAAGACGGCATACGAGATGCATCGACCAAGGGTCAAGTGCACAGTCTA
s2_R_1481_GCACCTATCT	CAAGCAGAAGACGGCATACGAGATGCACCTATCTAGGGTCAAGTGCACAGTCTA
s2_R_1482_TCCTGACTGC	CAAGCAGAAGACGGCATACGAGATTCCTGACTGCAGGGTCAAGTGCACAGTCTA
s2_R_1483_CGTATAAGCC	CAAGCAGAAGACGGCATACGAGATCGTATAAGCCAGGGTCAAGTGCACAGTCTA
s2_R_1484_GCAGGACAAC	CAAGCAGAAGACGGCATACGAGATGCAGGACAACAGGGTCAAGTGCACAGTCTA
s2_R_1485_CATACTCCTA	CAAGCAGAAGACGGCATACGAGATCATACTCCTAAGGGTCAAGTGCACAGTCTA
s2_R_1486_TTGGTTGCGG	CAAGCAGAAGACGGCATACGAGATTTGGTTGCGGAGGGTCAAGTGCACAGTCTA
s2_R_1487_CATAGCGTAT	CAAGCAGAAGACGGCATACGAGATCATAGCGTATAGGGTCAAGTGCACAGTCTA
s2_R_1488_CGGAGACAAG	CAAGCAGAAGACGGCATACGAGATCGGAGACAAGAGGGTCAAGTGCACAGTCTA
s2_R_1489_TCTCAGGCTC	CAAGCAGAAGACGGCATACGAGATTCTCAGGCTCAGGGTCAAGTGCACAGTCTA
s2_R_1490_CGCAATGCAT	CAAGCAGAAGACGGCATACGAGATCGCAATGCATAGGGTCAAGTGCACAGTCTA
s2_R_1491_GTACAATAGC	CAAGCAGAAGACGGCATACGAGATGTACAATAGCAGGGTCAAGTGCACAGTCTA
s2_R_1492_GTACCGTACG	CAAGCAGAAGACGGCATACGAGATGTACCGTACGAGGGTCAAGTGCACAGTCTA
s2_R_1493_CCGTGCTAAT	CAAGCAGAAGACGGCATACGAGATCCGTGCTAATAGGGTCAAGTGCACAGTCTA
s2_R_1494_AGAGTAGCAC	CAAGCAGAAGACGGCATACGAGATAGAGTAGCACAGGGTCAAGTGCACAGTCTA
s2_R_1495_TGATCCGTCC	CAAGCAGAAGACGGCATACGAGATTGATCCGTCCAGGGTCAAGTGCACAGTCTA
s2_R_1496_ACTGAGAAGC	CAAGCAGAAGACGGCATACGAGATACTGAGAAGCAGGGTCAAGTGCACAGTCTA
s2_R_1497_GTGCTGATAC	CAAGCAGAAGACGGCATACGAGATGTGCTGATACAGGGTCAAGTGCACAGTCTA
s2_R_1498_GAATCCAGAC	CAAGCAGAAGACGGCATACGAGATGAATCCAGACAGGGTCAAGTGCACAGTCTA
s2_R_1499_CACTGTTAGC	CAAGCAGAAGACGGCATACGAGATCACTGTTAGCAGGGTCAAGTGCACAGTCTA
s2_R_1500_TTATAGAGGC	CAAGCAGAAGACGGCATACGAGATTTATAGAGGCAGGGTCAAGTGCACAGTCTA
s2_R_1501_ATAGAGCGAT	CAAGCAGAAGACGGCATACGAGATATAGAGCGATAGGGTCAAGTGCACAGTCTA
s2_R_1502_CTCACTCCGA	CAAGCAGAAGACGGCATACGAGATCTCACTCCGAAGGGTCAAGTGCACAGTCTA
s2_R_1503_TCACTACTCT	CAAGCAGAAGACGGCATACGAGATTCACTACTCTAGGGTCAAGTGCACAGTCTA
s2_R_1504_TTCACATACC	CAAGCAGAAGACGGCATACGAGATTTCACATACCAGGGTCAAGTGCACAGTCTA
s2_R_1505_GCAACACAGG	CAAGCAGAAGACGGCATACGAGATGCAACACAGGAGGGTCAAGTGCACAGTCTA
s2_R_1506_TATAGACCTG	CAAGCAGAAGACGGCATACGAGATTATAGACCTGAGGGTCAAGTGCACAGTCTA
s2_R_1507_TGCTTGAATG	CAAGCAGAAGACGGCATACGAGATTGCTTGAATGAGGGTCAAGTGCACAGTCTA
s2_R_1508_CTAGAACACC	CAAGCAGAAGACGGCATACGAGATCTAGAACACCAGGGTCAAGTGCACAGTCTA
s2_R_1509_TGTCTGTAAC	CAAGCAGAAGACGGCATACGAGATTGTCTGTAACAGGGTCAAGTGCACAGTCTA
s2_R_1510_GAGCATTACT	CAAGCAGAAGACGGCATACGAGATGAGCATTACTAGGGTCAAGTGCACAGTCTA
s2_R_1511_TCACATGGCC	CAAGCAGAAGACGGCATACGAGATTCACATGGCCAGGGTCAAGTGCACAGTCTA
s2_R_1512_TTGCTACATC	CAAGCAGAAGACGGCATACGAGATTTGCTACATCAGGGTCAAGTGCACAGTCTA
s2_R_1513_CTGCATACTC	CAAGCAGAAGACGGCATACGAGATCTGCATACTCAGGGTCAAGTGCACAGTCTA
s2_R_1514_CACTCCAACT	CAAGCAGAAGACGGCATACGAGATCACTCCAACTAGGGTCAAGTGCACAGTCTA
s2_R_1515_CCTCGTCAGA	CAAGCAGAAGACGGCATACGAGATCCTCGTCAGAAGGGTCAAGTGCACAGTCTA
s2_R_1516_TGGTACATAC	CAAGCAGAAGACGGCATACGAGATTGGTACATACAGGGTCAAGTGCACAGTCTA
s2_R_1517_ATCTGATGCC	CAAGCAGAAGACGGCATACGAGATATCTGATGCCAGGGTCAAGTGCACAGTCTA
s2_R_1518_TCACTTCAGC	CAAGCAGAAGACGGCATACGAGATTCACTTCAGCAGGGTCAAGTGCACAGTCTA
s2_R_1519_GTGTCCTAGC	CAAGCAGAAGACGGCATACGAGATGTGTCCTAGCAGGGTCAAGTGCACAGTCTA
s2_R_1520_GAGAGGAAGC	CAAGCAGAAGACGGCATACGAGATGAGAGGAAGCAGGGTCAAGTGCACAGTCTA
s2_R_1521_GAAGACTAGC	CAAGCAGAAGACGGCATACGAGATGAAGACTAGCAGGGTCAAGTGCACAGTCTA
s2_R_1522_GCTTATGAGC	CAAGCAGAAGACGGCATACGAGATGCTTATGAGCAGGGTCAAGTGCACAGTCTA
s2_R_1523_GCTGAACCAC	CAAGCAGAAGACGGCATACGAGATGCTGAACCACAGGGTCAAGTGCACAGTCTA
s2_R_1524_GCTGATTGGC	CAAGCAGAAGACGGCATACGAGATGCTGATTGGCAGGGTCAAGTGCACAGTCTA
s2_R_1525_TGGTTCATCA	CAAGCAGAAGACGGCATACGAGATTGGTTCATCAAGGGTCAAGTGCACAGTCTA
s2_R_1526_TTGTCTGCAG	CAAGCAGAAGACGGCATACGAGATTTGTCTGCAGAGGGTCAAGTGCACAGTCTA
s2_R_1527_CGTGTTGCAC	CAAGCAGAAGACGGCATACGAGATCGTGTTGCACAGGGTCAAGTGCACAGTCTA
s2_R_1528_TGGACTGATT	CAAGCAGAAGACGGCATACGAGATTGGACTGATTAGGGTCAAGTGCACAGTCTA
s2_R_1529_ACTACATTGC	CAAGCAGAAGACGGCATACGAGATACTACATTGCAGGGTCAAGTGCACAGTCTA
s2_R_1530_CAGTCATAGC	CAAGCAGAAGACGGCATACGAGATCAGTCATAGCAGGGTCAAGTGCACAGTCTA
s2_R_1531_GAGCCTGCAA	CAAGCAGAAGACGGCATACGAGATGAGCCTGCAAAGGGTCAAGTGCACAGTCTA
s2_R_1532_TTGTACGCAT	CAAGCAGAAGACGGCATACGAGATTTGTACGCATAGGGTCAAGTGCACAGTCTA
s2_R_1533_AAGCTGGTAT	CAAGCAGAAGACGGCATACGAGATAAGCTGGTATAGGGTCAAGTGCACAGTCTA
s2_R_1534_CACTGGTACT	CAAGCAGAAGACGGCATACGAGATCACTGGTACTAGGGTCAAGTGCACAGTCTA
s2_R_1535_CCTAGGAAGC	CAAGCAGAAGACGGCATACGAGATCCTAGGAAGCAGGGTCAAGTGCACAGTCTA
s2_R_1536_GAGACCAAGT	CAAGCAGAAGACGGCATACGAGATGAGACCAAGTAGGGTCAAGTGCACAGTCTA
s2_R_1537_TCGTCTATGC	CAAGCAGAAGACGGCATACGAGATTCGTCTATGCAGGGTCAAGTGCACAGTCTA
s2_R_1538_TGCTATTGAG	CAAGCAGAAGACGGCATACGAGATTGCTATTGAGAGGGTCAAGTGCACAGTCTA
s2_R_1539_GCTAATCAGG	CAAGCAGAAGACGGCATACGAGATGCTAATCAGGAGGGTCAAGTGCACAGTCTA
s2_R_1540_CGAGATTCGA	CAAGCAGAAGACGGCATACGAGATCGAGATTCGAAGGGTCAAGTGCACAGTCTA
s2_R_1541_GGCTATCTAC	CAAGCAGAAGACGGCATACGAGATGGCTATCTACAGGGTCAAGTGCACAGTCTA
s2_R_1542_GAGCATGAAC	CAAGCAGAAGACGGCATACGAGATGAGCATGAACAGGGTCAAGTGCACAGTCTA
s2_R_1543_GACATGGAAG	CAAGCAGAAGACGGCATACGAGATGACATGGAAGAGGGTCAAGTGCACAGTCTA
s2_R_1544_TCTGTCCTAC	CAAGCAGAAGACGGCATACGAGATTCTGTCCTACAGGGTCAAGTGCACAGTCTA
s2_R_1545_TGATCACCTC	CAAGCAGAAGACGGCATACGAGATTGATCACCTCAGGGTCAAGTGCACAGTCTA
s2_R_1546_TAAGGACGTT	CAAGCAGAAGACGGCATACGAGATTAAGGACGTTAGGGTCAAGTGCACAGTCTA
s2_R_1547_ACGAACGACT	CAAGCAGAAGACGGCATACGAGATACGAACGACTAGGGTCAAGTGCACAGTCTA
s2_R_1548_GCGTTAATGC	CAAGCAGAAGACGGCATACGAGATGCGTTAATGCAGGGTCAAGTGCACAGTCTA
s2_R_1549_GACACTATGC	CAAGCAGAAGACGGCATACGAGATGACACTATGCAGGGTCAAGTGCACAGTCTA
s2_R_1550_AGCAGAACAC	CAAGCAGAAGACGGCATACGAGATAGCAGAACACAGGGTCAAGTGCACAGTCTA
s2_R_1551_TCTATGATGC	CAAGCAGAAGACGGCATACGAGATTCTATGATGCAGGGTCAAGTGCACAGTCTA
s2_R_1552_ATAGACGTAG	CAAGCAGAAGACGGCATACGAGATATAGACGTAGAGGGTCAAGTGCACAGTCTA
s2_R_1553_TTCAGACTCT	CAAGCAGAAGACGGCATACGAGATTTCAGACTCTAGGGTCAAGTGCACAGTCTA
s2_R_1554_CGTCCATCAG	CAAGCAGAAGACGGCATACGAGATCGTCCATCAGAGGGTCAAGTGCACAGTCTA
s2_R_1555_CTCAAGACTC	CAAGCAGAAGACGGCATACGAGATCTCAAGACTCAGGGTCAAGTGCACAGTCTA
s2_R_1556_TGAGGAGTCA	CAAGCAGAAGACGGCATACGAGATTGAGGAGTCAAGGGTCAAGTGCACAGTCTA
s2_R_1557_AGGAGCAACC	CAAGCAGAAGACGGCATACGAGATAGGAGCAACCAGGGTCAAGTGCACAGTCTA
s2_R_1558_GAACCAATGA	CAAGCAGAAGACGGCATACGAGATGAACCAATGAAGGGTCAAGTGCACAGTCTA
s2_R_1559_AAGGACTATG	CAAGCAGAAGACGGCATACGAGATAAGGACTATGAGGGTCAAGTGCACAGTCTA
s2_R_1560_CTGAGAACAT	CAAGCAGAAGACGGCATACGAGATCTGAGAACATAGGGTCAAGTGCACAGTCTA
s2_R_1561_AATGAACGAC	CAAGCAGAAGACGGCATACGAGATAATGAACGACAGGGTCAAGTGCACAGTCTA
s2_R_1562_CAGTCTATTC	CAAGCAGAAGACGGCATACGAGATCAGTCTATTCAGGGTCAAGTGCACAGTCTA
s2_R_1563_CGAAGTAACT	CAAGCAGAAGACGGCATACGAGATCGAAGTAACTAGGGTCAAGTGCACAGTCTA
s2_R_1564_CACGAACCTA	CAAGCAGAAGACGGCATACGAGATCACGAACCTAAGGGTCAAGTGCACAGTCTA
s2_R_1565_GACGAACTAC	CAAGCAGAAGACGGCATACGAGATGACGAACTACAGGGTCAAGTGCACAGTCTA
s2_R_1566_CTCAAGATGA	CAAGCAGAAGACGGCATACGAGATCTCAAGATGAAGGGTCAAGTGCACAGTCTA
s2_R_1567_ATGATAGCAG	CAAGCAGAAGACGGCATACGAGATATGATAGCAGAGGGTCAAGTGCACAGTCTA
s2_R_1568_GATCACCACA	CAAGCAGAAGACGGCATACGAGATGATCACCACAAGGGTCAAGTGCACAGTCTA
s2_R_1569_CCACTTCTAC	CAAGCAGAAGACGGCATACGAGATCCACTTCTACAGGGTCAAGTGCACAGTCTA
s2_R_1570_CTGGAATACT	CAAGCAGAAGACGGCATACGAGATCTGGAATACTAGGGTCAAGTGCACAGTCTA
s2_R_1571_ATCTTCAGAC	CAAGCAGAAGACGGCATACGAGATATCTTCAGACAGGGTCAAGTGCACAGTCTA
s2_R_1572_AAGAGTGCCA	CAAGCAGAAGACGGCATACGAGATAAGAGTGCCAAGGGTCAAGTGCACAGTCTA
s2_R_1573_CCAGAGTTAA	CAAGCAGAAGACGGCATACGAGATCCAGAGTTAAAGGGTCAAGTGCACAGTCTA
s2_R_1574_CCTGCCAGAA	CAAGCAGAAGACGGCATACGAGATCCTGCCAGAAAGGGTCAAGTGCACAGTCTA
s2_R_1575_TAACAGTCCT	CAAGCAGAAGACGGCATACGAGATTAACAGTCCTAGGGTCAAGTGCACAGTCTA
s2_R_1576_AATTACCAGG	CAAGCAGAAGACGGCATACGAGATAATTACCAGGAGGGTCAAGTGCACAGTCTA
s2_R_1577_CCGAAGAAGT	CAAGCAGAAGACGGCATACGAGATCCGAAGAAGTAGGGTCAAGTGCACAGTCTA
s2_R_1578_CTCCTAATTC	CAAGCAGAAGACGGCATACGAGATCTCCTAATTCAGGGTCAAGTGCACAGTCTA
s2_R_1579_ACATAGTAGC	CAAGCAGAAGACGGCATACGAGATACATAGTAGCAGGGTCAAGTGCACAGTCTA
s2_R_1580_CGATAGTCTA	CAAGCAGAAGACGGCATACGAGATCGATAGTCTAAGGGTCAAGTGCACAGTCTA
s2_R_1581_AGTTCACGTT	CAAGCAGAAGACGGCATACGAGATAGTTCACGTTAGGGTCAAGTGCACAGTCTA
s2_R_1582_CTAATGCTGG	CAAGCAGAAGACGGCATACGAGATCTAATGCTGGAGGGTCAAGTGCACAGTCTA
s2_R_1583_GACACTACCT	CAAGCAGAAGACGGCATACGAGATGACACTACCTAGGGTCAAGTGCACAGTCTA
s2_R_1584_TCTAATGTCC	CAAGCAGAAGACGGCATACGAGATTCTAATGTCCAGGGTCAAGTGCACAGTCTA
s2_R_1585_CAATGCGTCT	CAAGCAGAAGACGGCATACGAGATCAATGCGTCTAGGGTCAAGTGCACAGTCTA
s2_R_1586_ACACTTCCAA	CAAGCAGAAGACGGCATACGAGATACACTTCCAAAGGGTCAAGTGCACAGTCTA
s2_R_1587_AAGAGTAGGT	CAAGCAGAAGACGGCATACGAGATAAGAGTAGGTAGGGTCAAGTGCACAGTCTA
s2_R_1588_CAATGCTATC	CAAGCAGAAGACGGCATACGAGATCAATGCTATCAGGGTCAAGTGCACAGTCTA
s2_R_1589_AGCATCCATT	CAAGCAGAAGACGGCATACGAGATAGCATCCATTAGGGTCAAGTGCACAGTCTA
s2_R_1590_GATTCCGAGT	CAAGCAGAAGACGGCATACGAGATGATTCCGAGTAGGGTCAAGTGCACAGTCTA
s2_R_1591_AGACTAAGGT	CAAGCAGAAGACGGCATACGAGATAGACTAAGGTAGGGTCAAGTGCACAGTCTA
s2_R_1592_GCCTAATAAC	CAAGCAGAAGACGGCATACGAGATGCCTAATAACAGGGTCAAGTGCACAGTCTA
s2_R_1593_ATGCGTTGCT	CAAGCAGAAGACGGCATACGAGATATGCGTTGCTAGGGTCAAGTGCACAGTCTA
s2_R_1594_CGATTAGTTG	CAAGCAGAAGACGGCATACGAGATCGATTAGTTGAGGGTCAAGTGCACAGTCTA
s2_R_1595_TACCTAGCCA	CAAGCAGAAGACGGCATACGAGATTACCTAGCCAAGGGTCAAGTGCACAGTCTA
s2_R_1596_CCATGATTCA	CAAGCAGAAGACGGCATACGAGATCCATGATTCAAGGGTCAAGTGCACAGTCTA
s2_R_1597_CATCAGGTAG	CAAGCAGAAGACGGCATACGAGATCATCAGGTAGAGGGTCAAGTGCACAGTCTA
s2_R_1598_CCGACCTGAT	CAAGCAGAAGACGGCATACGAGATCCGACCTGATAGGGTCAAGTGCACAGTCTA
s2_R_1599_ACGATTGCAT	CAAGCAGAAGACGGCATACGAGATACGATTGCATAGGGTCAAGTGCACAGTCTA
s2_R_1600_CATCATGGCT	CAAGCAGAAGACGGCATACGAGATCATCATGGCTAGGGTCAAGTGCACAGTCTA
s2_R_1601_GAGGCTCAAC	CAAGCAGAAGACGGCATACGAGATGAGGCTCAACAGGGTCAAGTGCACAGTCTA
s2_R_1602_CGAGCTATCC	CAAGCAGAAGACGGCATACGAGATCGAGCTATCCAGGGTCAAGTGCACAGTCTA
s2_R_1603_CAATTCTTGG	CAAGCAGAAGACGGCATACGAGATCAATTCTTGGAGGGTCAAGTGCACAGTCTA
s2_R_1604_CACTACTCAA	CAAGCAGAAGACGGCATACGAGATCACTACTCAAAGGGTCAAGTGCACAGTCTA
s2_R_1605_ACAGAGGTCT	CAAGCAGAAGACGGCATACGAGATACAGAGGTCTAGGGTCAAGTGCACAGTCTA
s2_R_1606_CGTTCTACCT	CAAGCAGAAGACGGCATACGAGATCGTTCTACCTAGGGTCAAGTGCACAGTCTA
s2_R_1607_CGTCATTCCA	CAAGCAGAAGACGGCATACGAGATCGTCATTCCAAGGGTCAAGTGCACAGTCTA
s2_R_1608_GCTCCTCTAC	CAAGCAGAAGACGGCATACGAGATGCTCCTCTACAGGGTCAAGTGCACAGTCTA
s2_R_1609_AAGCCAATCC	CAAGCAGAAGACGGCATACGAGATAAGCCAATCCAGGGTCAAGTGCACAGTCTA
s2_R_1610_CAACCGTGAA	CAAGCAGAAGACGGCATACGAGATCAACCGTGAAAGGGTCAAGTGCACAGTCTA
s2_R_1611_CCACTTACGA	CAAGCAGAAGACGGCATACGAGATCCACTTACGAAGGGTCAAGTGCACAGTCTA
s2_R_1612_CAAGATCCTT	CAAGCAGAAGACGGCATACGAGATCAAGATCCTTAGGGTCAAGTGCACAGTCTA
s2_R_1613_GACCTCTTAT	CAAGCAGAAGACGGCATACGAGATGACCTCTTATAGGGTCAAGTGCACAGTCTA
s2_R_1614_ACCATTACTG	CAAGCAGAAGACGGCATACGAGATACCATTACTGAGGGTCAAGTGCACAGTCTA
s2_R_1615_AATCGTCTTG	CAAGCAGAAGACGGCATACGAGATAATCGTCTTGAGGGTCAAGTGCACAGTCTA
s2_R_1616_CGTTAGAAGT	CAAGCAGAAGACGGCATACGAGATCGTTAGAAGTAGGGTCAAGTGCACAGTCTA
s2_R_1617_ATGAGGAATG	CAAGCAGAAGACGGCATACGAGATATGAGGAATGAGGGTCAAGTGCACAGTCTA
s2_R_1618_AAGGCAGGAA	CAAGCAGAAGACGGCATACGAGATAAGGCAGGAAAGGGTCAAGTGCACAGTCTA
s2_R_1619_TATTCCTGAG	CAAGCAGAAGACGGCATACGAGATTATTCCTGAGAGGGTCAAGTGCACAGTCTA
s2_R_1620_CGAATAAGAG	CAAGCAGAAGACGGCATACGAGATCGAATAAGAGAGGGTCAAGTGCACAGTCTA
s2_R_1621_GAATTGGAAC	CAAGCAGAAGACGGCATACGAGATGAATTGGAACAGGGTCAAGTGCACAGTCTA
s2_R_1622_ACGGTGTACG	CAAGCAGAAGACGGCATACGAGATACGGTGTACGAGGGTCAAGTGCACAGTCTA
s2_R_1623_CCTATTGATG	CAAGCAGAAGACGGCATACGAGATCCTATTGATGAGGGTCAAGTGCACAGTCTA
s2_R_1624_ACGATACAGA	CAAGCAGAAGACGGCATACGAGATACGATACAGAAGGGTCAAGTGCACAGTCTA
s2_R_1625_ACATCCGAAG	CAAGCAGAAGACGGCATACGAGATACATCCGAAGAGGGTCAAGTGCACAGTCTA
s2_R_1626_ATGAACAAGC	CAAGCAGAAGACGGCATACGAGATATGAACAAGCAGGGTCAAGTGCACAGTCTA
s2_R_1627_AGAGTTATGC	CAAGCAGAAGACGGCATACGAGATAGAGTTATGCAGGGTCAAGTGCACAGTCTA
s2_R_1628_ACACGTTACT	CAAGCAGAAGACGGCATACGAGATACACGTTACTAGGGTCAAGTGCACAGTCTA
s2_R_1629_ACTGGCTATT	CAAGCAGAAGACGGCATACGAGATACTGGCTATTAGGGTCAAGTGCACAGTCTA
s2_R_1630_ATGAGAGCTC	CAAGCAGAAGACGGCATACGAGATATGAGAGCTCAGGGTCAAGTGCACAGTCTA
s2_R_1631_ACCGATCAAC	CAAGCAGAAGACGGCATACGAGATACCGATCAACAGGGTCAAGTGCACAGTCTA
s2_R_1632_ATACGACTCA	CAAGCAGAAGACGGCATACGAGATATACGACTCAAGGGTCAAGTGCACAGTCTA
s2_R_1633_GACTGACATG	CAAGCAGAAGACGGCATACGAGATGACTGACATGAGGGTCAAGTGCACAGTCTA
s2_R_1634_CAGGAAGTTA	CAAGCAGAAGACGGCATACGAGATCAGGAAGTTAAGGGTCAAGTGCACAGTCTA
s2_R_1635_ATCTGGTCTG	CAAGCAGAAGACGGCATACGAGATATCTGGTCTGAGGGTCAAGTGCACAGTCTA
s2_R_1636_TGACAACTGC	CAAGCAGAAGACGGCATACGAGATTGACAACTGCAGGGTCAAGTGCACAGTCTA
s2_R_1637_GCGTATCATC	CAAGCAGAAGACGGCATACGAGATGCGTATCATCAGGGTCAAGTGCACAGTCTA
s2_R_1638_GTCCAATTAG	CAAGCAGAAGACGGCATACGAGATGTCCAATTAGAGGGTCAAGTGCACAGTCTA
s2_R_1639_CTGCACATAC	CAAGCAGAAGACGGCATACGAGATCTGCACATACAGGGTCAAGTGCACAGTCTA
s2_R_1640_CAATAGGAGT	CAAGCAGAAGACGGCATACGAGATCAATAGGAGTAGGGTCAAGTGCACAGTCTA
s2_R_1641_CCATAACTAC	CAAGCAGAAGACGGCATACGAGATCCATAACTACAGGGTCAAGTGCACAGTCTA
s2_R_1642_CATAGAGAGG	CAAGCAGAAGACGGCATACGAGATCATAGAGAGGAGGGTCAAGTGCACAGTCTA
s2_R_1643_TCCAGAATCC	CAAGCAGAAGACGGCATACGAGATTCCAGAATCCAGGGTCAAGTGCACAGTCTA
s2_R_1644_AGAGATACCT	CAAGCAGAAGACGGCATACGAGATAGAGATACCTAGGGTCAAGTGCACAGTCTA
s2_R_1645_ATACGTGCCA	CAAGCAGAAGACGGCATACGAGATATACGTGCCAAGGGTCAAGTGCACAGTCTA
s2_R_1646_TGCATCCTGA	CAAGCAGAAGACGGCATACGAGATTGCATCCTGAAGGGTCAAGTGCACAGTCTA
s2_R_1647_AGAGTCCGTT	CAAGCAGAAGACGGCATACGAGATAGAGTCCGTTAGGGTCAAGTGCACAGTCTA
s2_R_1648_TAAGGCTCTG	CAAGCAGAAGACGGCATACGAGATTAAGGCTCTGAGGGTCAAGTGCACAGTCTA
s2_R_1649_CACCTTACAA	CAAGCAGAAGACGGCATACGAGATCACCTTACAAAGGGTCAAGTGCACAGTCTA
s2_R_1650_ATCGTTATGG	CAAGCAGAAGACGGCATACGAGATATCGTTATGGAGGGTCAAGTGCACAGTCTA
s2_R_1651_AGTCACATGC	CAAGCAGAAGACGGCATACGAGATAGTCACATGCAGGGTCAAGTGCACAGTCTA
s2_R_1652_GAACTCTCTC	CAAGCAGAAGACGGCATACGAGATGAACTCTCTCAGGGTCAAGTGCACAGTCTA
s2_R_1653_CACTATCTTC	CAAGCAGAAGACGGCATACGAGATCACTATCTTCAGGGTCAAGTGCACAGTCTA
s2_R_1654_AGAGGTGCAG	CAAGCAGAAGACGGCATACGAGATAGAGGTGCAGAGGGTCAAGTGCACAGTCTA
s2_R_1655_CATCTACCTT	CAAGCAGAAGACGGCATACGAGATCATCTACCTTAGGGTCAAGTGCACAGTCTA
s2_R_1656_TGAGAATGAG	CAAGCAGAAGACGGCATACGAGATTGAGAATGAGAGGGTCAAGTGCACAGTCTA
s2_R_1657_AGAACTGTCT	CAAGCAGAAGACGGCATACGAGATAGAACTGTCTAGGGTCAAGTGCACAGTCTA
s2_R_1658_CTAGCACTGA	CAAGCAGAAGACGGCATACGAGATCTAGCACTGAAGGGTCAAGTGCACAGTCTA
s2_R_1659_TGTTAACGCT	CAAGCAGAAGACGGCATACGAGATTGTTAACGCTAGGGTCAAGTGCACAGTCTA
s2_R_1660_TATAGTGAGC	CAAGCAGAAGACGGCATACGAGATTATAGTGAGCAGGGTCAAGTGCACAGTCTA
s2_R_1661_CAACGAACTC	CAAGCAGAAGACGGCATACGAGATCAACGAACTCAGGGTCAAGTGCACAGTCTA
s2_R_1662_CCAGTGCTAG	CAAGCAGAAGACGGCATACGAGATCCAGTGCTAGAGGGTCAAGTGCACAGTCTA
s2_R_1663_CTCTAACAAC	CAAGCAGAAGACGGCATACGAGATCTCTAACAACAGGGTCAAGTGCACAGTCTA
s2_R_1664_TAAGCCTAGG	CAAGCAGAAGACGGCATACGAGATTAAGCCTAGGAGGGTCAAGTGCACAGTCTA
s2_R_1665_TGGCCTACAT	CAAGCAGAAGACGGCATACGAGATTGGCCTACATAGGGTCAAGTGCACAGTCTA
s2_R_1666_ATCTCTCCAA	CAAGCAGAAGACGGCATACGAGATATCTCTCCAAAGGGTCAAGTGCACAGTCTA
s2_R_1667_ACCAAGGATT	CAAGCAGAAGACGGCATACGAGATACCAAGGATTAGGGTCAAGTGCACAGTCTA
s2_R_1668_CCAATACAGT	CAAGCAGAAGACGGCATACGAGATCCAATACAGTAGGGTCAAGTGCACAGTCTA
s2_R_1669_ATCAGCAAGT	CAAGCAGAAGACGGCATACGAGATATCAGCAAGTAGGGTCAAGTGCACAGTCTA
s2_R_1670_GATACAGGAT	CAAGCAGAAGACGGCATACGAGATGATACAGGATAGGGTCAAGTGCACAGTCTA
s2_R_1671_AGCAATGAGT	CAAGCAGAAGACGGCATACGAGATAGCAATGAGTAGGGTCAAGTGCACAGTCTA
s2_R_1672_TGGCTCAGTG	CAAGCAGAAGACGGCATACGAGATTGGCTCAGTGAGGGTCAAGTGCACAGTCTA
s2_R_1673_CCGACTTACT	CAAGCAGAAGACGGCATACGAGATCCGACTTACTAGGGTCAAGTGCACAGTCTA
s2_R_1674_ATCACGGTTC	CAAGCAGAAGACGGCATACGAGATATCACGGTTCAGGGTCAAGTGCACAGTCTA
s2_R_1675_ATTGCAGAAG	CAAGCAGAAGACGGCATACGAGATATTGCAGAAGAGGGTCAAGTGCACAGTCTA
s2_R_1676_ACTGGTAAGT	CAAGCAGAAGACGGCATACGAGATACTGGTAAGTAGGGTCAAGTGCACAGTCTA
s2_R_1677_CGAAGATGAA	CAAGCAGAAGACGGCATACGAGATCGAAGATGAAAGGGTCAAGTGCACAGTCTA
s2_R_1678_GAGACAGGTA	CAAGCAGAAGACGGCATACGAGATGAGACAGGTAAGGGTCAAGTGCACAGTCTA
s2_R_1679_GACTTATCCA	CAAGCAGAAGACGGCATACGAGATGACTTATCCAAGGGTCAAGTGCACAGTCTA
s2_R_1680_AGACGTAACC	CAAGCAGAAGACGGCATACGAGATAGACGTAACCAGGGTCAAGTGCACAGTCTA
s2_R_1681_TAGCCAGTAT	CAAGCAGAAGACGGCATACGAGATTAGCCAGTATAGGGTCAAGTGCACAGTCTA
s2_R_1682_TAGGCAACTA	CAAGCAGAAGACGGCATACGAGATTAGGCAACTAAGGGTCAAGTGCACAGTCTA
s2_R_1683_GTAAGACAAG	CAAGCAGAAGACGGCATACGAGATGTAAGACAAGAGGGTCAAGTGCACAGTCTA
s2_R_1684_CCGTTAGTGA	CAAGCAGAAGACGGCATACGAGATCCGTTAGTGAAGGGTCAAGTGCACAGTCTA
s2_R_1685_CTCATCAAGG	CAAGCAGAAGACGGCATACGAGATCTCATCAAGGAGGGTCAAGTGCACAGTCTA
s2_R_1686_ATACGTAGGC	CAAGCAGAAGACGGCATACGAGATATACGTAGGCAGGGTCAAGTGCACAGTCTA
s2_R_1687_CACATTCGTG	CAAGCAGAAGACGGCATACGAGATCACATTCGTGAGGGTCAAGTGCACAGTCTA
s2_R_1688_CGCGGCATAT	CAAGCAGAAGACGGCATACGAGATCGCGGCATATAGGGTCAAGTGCACAGTCTA
s2_R_1689_ATGGATAACC	CAAGCAGAAGACGGCATACGAGATATGGATAACCAGGGTCAAGTGCACAGTCTA
s2_R_1690_CTGAACTCTC	CAAGCAGAAGACGGCATACGAGATCTGAACTCTCAGGGTCAAGTGCACAGTCTA
s2_R_1691_AGTGCGTCAT	CAAGCAGAAGACGGCATACGAGATAGTGCGTCATAGGGTCAAGTGCACAGTCTA
s2_R_1692_CACACCACTA	CAAGCAGAAGACGGCATACGAGATCACACCACTAAGGGTCAAGTGCACAGTCTA
s2_R_1693_CCTTACACGA	CAAGCAGAAGACGGCATACGAGATCCTTACACGAAGGGTCAAGTGCACAGTCTA
s2_R_1694_AGGCAATCGT	CAAGCAGAAGACGGCATACGAGATAGGCAATCGTAGGGTCAAGTGCACAGTCTA
s2_R_1695_CTAGATGCTC	CAAGCAGAAGACGGCATACGAGATCTAGATGCTCAGGGTCAAGTGCACAGTCTA
s2_R_1696_AGGTCTCATA	CAAGCAGAAGACGGCATACGAGATAGGTCTCATAAGGGTCAAGTGCACAGTCTA
s2_R_1697_CTGTCCACAA	CAAGCAGAAGACGGCATACGAGATCTGTCCACAAAGGGTCAAGTGCACAGTCTA
s2_R_1698_TCATACATGG	CAAGCAGAAGACGGCATACGAGATTCATACATGGAGGGTCAAGTGCACAGTCTA
s2_R_1699_TATTCTCTCC	CAAGCAGAAGACGGCATACGAGATTATTCTCTCCAGGGTCAAGTGCACAGTCTA
s2_R_1700_CAGGCTGGTA	CAAGCAGAAGACGGCATACGAGATCAGGCTGGTAAGGGTCAAGTGCACAGTCTA
s2_R_1701_ACGTAAGAGT	CAAGCAGAAGACGGCATACGAGATACGTAAGAGTAGGGTCAAGTGCACAGTCTA
s2_R_1702_CACTTATTCC	CAAGCAGAAGACGGCATACGAGATCACTTATTCCAGGGTCAAGTGCACAGTCTA
s2_R_1703_TCGTACAACA	CAAGCAGAAGACGGCATACGAGATTCGTACAACAAGGGTCAAGTGCACAGTCTA
s2_R_1704_TCTGGAACAC	CAAGCAGAAGACGGCATACGAGATTCTGGAACACAGGGTCAAGTGCACAGTCTA
s2_R_1705_CATGCGACCT	CAAGCAGAAGACGGCATACGAGATCATGCGACCTAGGGTCAAGTGCACAGTCTA
s2_R_1706_CTATGACGAT	CAAGCAGAAGACGGCATACGAGATCTATGACGATAGGGTCAAGTGCACAGTCTA
s2_R_1707_CACAACTTCA	CAAGCAGAAGACGGCATACGAGATCACAACTTCAAGGGTCAAGTGCACAGTCTA
s2_R_1708_TTGACTTACG	CAAGCAGAAGACGGCATACGAGATTTGACTTACGAGGGTCAAGTGCACAGTCTA
s2_R_1709_ATAGCGAAGC	CAAGCAGAAGACGGCATACGAGATATAGCGAAGCAGGGTCAAGTGCACAGTCTA
s2_R_1710_AGAAGCTTGG	CAAGCAGAAGACGGCATACGAGATAGAAGCTTGGAGGGTCAAGTGCACAGTCTA
s2_R_1711_CGAACTGAAT	CAAGCAGAAGACGGCATACGAGATCGAACTGAATAGGGTCAAGTGCACAGTCTA
s2_R_1712_CCAGATAAGA	CAAGCAGAAGACGGCATACGAGATCCAGATAAGAAGGGTCAAGTGCACAGTCTA
s2_R_1713_CCTCAACCAA	CAAGCAGAAGACGGCATACGAGATCCTCAACCAAAGGGTCAAGTGCACAGTCTA
s2_R_1714_ATCCGTCTGA	CAAGCAGAAGACGGCATACGAGATATCCGTCTGAAGGGTCAAGTGCACAGTCTA
s2_R_1715_CACCAATTAC	CAAGCAGAAGACGGCATACGAGATCACCAATTACAGGGTCAAGTGCACAGTCTA
s2_R_1716_ATTGTCATCC	CAAGCAGAAGACGGCATACGAGATATTGTCATCCAGGGTCAAGTGCACAGTCTA
s2_R_1717_CGTTATCTCA	CAAGCAGAAGACGGCATACGAGATCGTTATCTCAAGGGTCAAGTGCACAGTCTA
s2_R_1718_GACTTAGTTC	CAAGCAGAAGACGGCATACGAGATGACTTAGTTCAGGGTCAAGTGCACAGTCTA
s2_R_1719_CGTTACAATC	CAAGCAGAAGACGGCATACGAGATCGTTACAATCAGGGTCAAGTGCACAGTCTA
s2_R_1720_AGAGAGTCGT	CAAGCAGAAGACGGCATACGAGATAGAGAGTCGTAGGGTCAAGTGCACAGTCTA
s2_R_1721_CGTGAGTTGG	CAAGCAGAAGACGGCATACGAGATCGTGAGTTGGAGGGTCAAGTGCACAGTCTA
s2_R_1722_AGACTACTAG	CAAGCAGAAGACGGCATACGAGATAGACTACTAGAGGGTCAAGTGCACAGTCTA
s2_R_1723_GTCACATTAC	CAAGCAGAAGACGGCATACGAGATGTCACATTACAGGGTCAAGTGCACAGTCTA
s2_R_1724_AGAATACAGG	CAAGCAGAAGACGGCATACGAGATAGAATACAGGAGGGTCAAGTGCACAGTCTA
s2_R_1725_TAGGCTAGAC	CAAGCAGAAGACGGCATACGAGATTAGGCTAGACAGGGTCAAGTGCACAGTCTA
s2_R_1726_ATGGAGTGAA	CAAGCAGAAGACGGCATACGAGATATGGAGTGAAAGGGTCAAGTGCACAGTCTA
s2_R_1727_CACAGACTAT	CAAGCAGAAGACGGCATACGAGATCACAGACTATAGGGTCAAGTGCACAGTCTA
s2_R_1728_CCATTGTTGC	CAAGCAGAAGACGGCATACGAGATCCATTGTTGCAGGGTCAAGTGCACAGTCTA
s2_R_1729_GTCCGAATAT	CAAGCAGAAGACGGCATACGAGATGTCCGAATATAGGGTCAAGTGCACAGTCTA
s2_R_1730_CGTGATCCAA	CAAGCAGAAGACGGCATACGAGATCGTGATCCAAAGGGTCAAGTGCACAGTCTA
s2_R_1731_CCAACCACTG	CAAGCAGAAGACGGCATACGAGATCCAACCACTGAGGGTCAAGTGCACAGTCTA
s2_R_1732_CCTGGATTAA	CAAGCAGAAGACGGCATACGAGATCCTGGATTAAAGGGTCAAGTGCACAGTCTA
s2_R_1733_ATTAGAGAGC	CAAGCAGAAGACGGCATACGAGATATTAGAGAGCAGGGTCAAGTGCACAGTCTA
s2_R_1734_GACACGCAAC	CAAGCAGAAGACGGCATACGAGATGACACGCAACAGGGTCAAGTGCACAGTCTA
s2_R_1735_CGTCTGAATT	CAAGCAGAAGACGGCATACGAGATCGTCTGAATTAGGGTCAAGTGCACAGTCTA
s2_R_1736_CGTTCGAGTT	CAAGCAGAAGACGGCATACGAGATCGTTCGAGTTAGGGTCAAGTGCACAGTCTA
s2_R_1737_AGTTCGATAC	CAAGCAGAAGACGGCATACGAGATAGTTCGATACAGGGTCAAGTGCACAGTCTA
s2_R_1738_ACTCGACTGA	CAAGCAGAAGACGGCATACGAGATACTCGACTGAAGGGTCAAGTGCACAGTCTA
s2_R_1739_CGACTCACTT	CAAGCAGAAGACGGCATACGAGATCGACTCACTTAGGGTCAAGTGCACAGTCTA
s2_R_1740_ATGCGATAGT	CAAGCAGAAGACGGCATACGAGATATGCGATAGTAGGGTCAAGTGCACAGTCTA
s2_R_1741_GACCTCAACT	CAAGCAGAAGACGGCATACGAGATGACCTCAACTAGGGTCAAGTGCACAGTCTA
s2_R_1742_ACTCTGCTCT	CAAGCAGAAGACGGCATACGAGATACTCTGCTCTAGGGTCAAGTGCACAGTCTA
s2_R_1743_CTGAACCATT	CAAGCAGAAGACGGCATACGAGATCTGAACCATTAGGGTCAAGTGCACAGTCTA
s2_R_1744_GATAACGAGG	CAAGCAGAAGACGGCATACGAGATGATAACGAGGAGGGTCAAGTGCACAGTCTA
s2_R_1745_TGACAATCCA	CAAGCAGAAGACGGCATACGAGATTGACAATCCAAGGGTCAAGTGCACAGTCTA
s2_R_1746_AGAAGCATTC	CAAGCAGAAGACGGCATACGAGATAGAAGCATTCAGGGTCAAGTGCACAGTCTA
s2_R_1747_ATCATGCCTG	CAAGCAGAAGACGGCATACGAGATATCATGCCTGAGGGTCAAGTGCACAGTCTA
s2_R_1748_GAATTGTCTG	CAAGCAGAAGACGGCATACGAGATGAATTGTCTGAGGGTCAAGTGCACAGTCTA
s2_R_1749_CTCCTGAACA	CAAGCAGAAGACGGCATACGAGATCTCCTGAACAAGGGTCAAGTGCACAGTCTA
s2_R_1750_GATACCAACC	CAAGCAGAAGACGGCATACGAGATGATACCAACCAGGGTCAAGTGCACAGTCTA
s2_R_1751_GATCATAAGG	CAAGCAGAAGACGGCATACGAGATGATCATAAGGAGGGTCAAGTGCACAGTCTA
s2_R_1752_ATTACGCCAC	CAAGCAGAAGACGGCATACGAGATATTACGCCACAGGGTCAAGTGCACAGTCTA
s2_R_1753_GAAGTTCACT	CAAGCAGAAGACGGCATACGAGATGAAGTTCACTAGGGTCAAGTGCACAGTCTA
s2_R_1754_TACACACTAC	CAAGCAGAAGACGGCATACGAGATTACACACTACAGGGTCAAGTGCACAGTCTA
s2_R_1755_TTGCCAATAC	CAAGCAGAAGACGGCATACGAGATTTGCCAATACAGGGTCAAGTGCACAGTCTA
s2_R_1756_GACTCGACTC	CAAGCAGAAGACGGCATACGAGATGACTCGACTCAGGGTCAAGTGCACAGTCTA
s2_R_1757_AGAGTCACTC	CAAGCAGAAGACGGCATACGAGATAGAGTCACTCAGGGTCAAGTGCACAGTCTA
s2_R_1758_CTACCTTACT	CAAGCAGAAGACGGCATACGAGATCTACCTTACTAGGGTCAAGTGCACAGTCTA
s2_R_1759_CACAACTCTG	CAAGCAGAAGACGGCATACGAGATCACAACTCTGAGGGTCAAGTGCACAGTCTA
s2_R_1760_TCGACAGTTA	CAAGCAGAAGACGGCATACGAGATTCGACAGTTAAGGGTCAAGTGCACAGTCTA
s2_R_1761_CTCATCGTGC	CAAGCAGAAGACGGCATACGAGATCTCATCGTGCAGGGTCAAGTGCACAGTCTA
s2_R_1762_CGCACAATTG	CAAGCAGAAGACGGCATACGAGATCGCACAATTGAGGGTCAAGTGCACAGTCTA
s2_R_1763_ATCTCCACGA	CAAGCAGAAGACGGCATACGAGATATCTCCACGAAGGGTCAAGTGCACAGTCTA
s2_R_1764_TAGGATGTCT	CAAGCAGAAGACGGCATACGAGATTAGGATGTCTAGGGTCAAGTGCACAGTCTA
s2_R_1765_GATAAGGAAC	CAAGCAGAAGACGGCATACGAGATGATAAGGAACAGGGTCAAGTGCACAGTCTA
s2_R_1766_ATTGTCGCTT	CAAGCAGAAGACGGCATACGAGATATTGTCGCTTAGGGTCAAGTGCACAGTCTA
s2_R_1767_GAGCAGGATT	CAAGCAGAAGACGGCATACGAGATGAGCAGGATTAGGGTCAAGTGCACAGTCTA
s2_R_1768_CTCCACTAAG	CAAGCAGAAGACGGCATACGAGATCTCCACTAAGAGGGTCAAGTGCACAGTCTA
s2_R_1769_CTTCCGTCCT	CAAGCAGAAGACGGCATACGAGATCTTCCGTCCTAGGGTCAAGTGCACAGTCTA
s2_R_1770_CCAACAGTAA	CAAGCAGAAGACGGCATACGAGATCCAACAGTAAAGGGTCAAGTGCACAGTCTA
s2_R_1771_TCACGTCCAC	CAAGCAGAAGACGGCATACGAGATTCACGTCCACAGGGTCAAGTGCACAGTCTA
s2_R_1772_CTAGTTAACC	CAAGCAGAAGACGGCATACGAGATCTAGTTAACCAGGGTCAAGTGCACAGTCTA
s2_R_1773_CCAGTTCACA	CAAGCAGAAGACGGCATACGAGATCCAGTTCACAAGGGTCAAGTGCACAGTCTA
s2_R_1774_CTATTCGTCA	CAAGCAGAAGACGGCATACGAGATCTATTCGTCAAGGGTCAAGTGCACAGTCTA
s2_R_1775_CACCAACAGA	CAAGCAGAAGACGGCATACGAGATCACCAACAGAAGGGTCAAGTGCACAGTCTA
s2_R_1776_CAACTACAAC	CAAGCAGAAGACGGCATACGAGATCAACTACAACAGGGTCAAGTGCACAGTCTA
s2_R_1777_ATGATGAGGC	CAAGCAGAAGACGGCATACGAGATATGATGAGGCAGGGTCAAGTGCACAGTCTA
s2_R_1778_AGCCAGGACA	CAAGCAGAAGACGGCATACGAGATAGCCAGGACAAGGGTCAAGTGCACAGTCTA
s2_R_1779_ATCCTTCTAG	CAAGCAGAAGACGGCATACGAGATATCCTTCTAGAGGGTCAAGTGCACAGTCTA
s2_R_1780_CAAGCAAGTA	CAAGCAGAAGACGGCATACGAGATCAAGCAAGTAAGGGTCAAGTGCACAGTCTA
s2_R_1781_GTTACACCAA	CAAGCAGAAGACGGCATACGAGATGTTACACCAAAGGGTCAAGTGCACAGTCTA
s2_R_1782_GACCATCCAT	CAAGCAGAAGACGGCATACGAGATGACCATCCATAGGGTCAAGTGCACAGTCTA
s2_R_1783_CATATCTGAG	CAAGCAGAAGACGGCATACGAGATCATATCTGAGAGGGTCAAGTGCACAGTCTA
s2_R_1784_GAACCAGAAG	CAAGCAGAAGACGGCATACGAGATGAACCAGAAGAGGGTCAAGTGCACAGTCTA
s2_R_1785_GAATTCCTCC	CAAGCAGAAGACGGCATACGAGATGAATTCCTCCAGGGTCAAGTGCACAGTCTA
s2_R_1786_CGACATCAGG	CAAGCAGAAGACGGCATACGAGATCGACATCAGGAGGGTCAAGTGCACAGTCTA
s2_R_1787_ATCCTAAGGA	CAAGCAGAAGACGGCATACGAGATATCCTAAGGAAGGGTCAAGTGCACAGTCTA
s2_R_1788_ATGACTCCTC	CAAGCAGAAGACGGCATACGAGATATGACTCCTCAGGGTCAAGTGCACAGTCTA
s2_R_1789_CCACCATCAA	CAAGCAGAAGACGGCATACGAGATCCACCATCAAAGGGTCAAGTGCACAGTCTA
s2_R_1790_CCAACCTATT	CAAGCAGAAGACGGCATACGAGATCCAACCTATTAGGGTCAAGTGCACAGTCTA
s2_R_1791_CCATTACCAA	CAAGCAGAAGACGGCATACGAGATCCATTACCAAAGGGTCAAGTGCACAGTCTA
s2_R_1792_CTCTGAGTTC	CAAGCAGAAGACGGCATACGAGATCTCTGAGTTCAGGGTCAAGTGCACAGTCTA
s2_R_1793_GACAAGAGGT	CAAGCAGAAGACGGCATACGAGATGACAAGAGGTAGGGTCAAGTGCACAGTCTA
s2_R_1794_TGAACCTATG	CAAGCAGAAGACGGCATACGAGATTGAACCTATGAGGGTCAAGTGCACAGTCTA
s2_R_1795_ATGTACCACT	CAAGCAGAAGACGGCATACGAGATATGTACCACTAGGGTCAAGTGCACAGTCTA
s2_R_1796_TAAGGAGCTC	CAAGCAGAAGACGGCATACGAGATTAAGGAGCTCAGGGTCAAGTGCACAGTCTA
s2_R_1797_GTATTGCCTT	CAAGCAGAAGACGGCATACGAGATGTATTGCCTTAGGGTCAAGTGCACAGTCTA
s2_R_1798_CGTACACTAA	CAAGCAGAAGACGGCATACGAGATCGTACACTAAAGGGTCAAGTGCACAGTCTA
s2_R_1799_TCTAGGTCAC	CAAGCAGAAGACGGCATACGAGATTCTAGGTCACAGGGTCAAGTGCACAGTCTA
s2_R_1800_TGCCTACTTA	CAAGCAGAAGACGGCATACGAGATTGCCTACTTAAGGGTCAAGTGCACAGTCTA
s2_R_1801_ATCAATCCAG	CAAGCAGAAGACGGCATACGAGATATCAATCCAGAGGGTCAAGTGCACAGTCTA
s2_R_1802_TGCGAATGTT	CAAGCAGAAGACGGCATACGAGATTGCGAATGTTAGGGTCAAGTGCACAGTCTA
s2_R_1803_ATAGTCCAGA	CAAGCAGAAGACGGCATACGAGATATAGTCCAGAAGGGTCAAGTGCACAGTCTA
s2_R_1804_TAGTCACGCC	CAAGCAGAAGACGGCATACGAGATTAGTCACGCCAGGGTCAAGTGCACAGTCTA
s2_R_1805_CACATGCGAA	CAAGCAGAAGACGGCATACGAGATCACATGCGAAAGGGTCAAGTGCACAGTCTA
s2_R_1806_CCAAGAGGTC	CAAGCAGAAGACGGCATACGAGATCCAAGAGGTCAGGGTCAAGTGCACAGTCTA
s2_R_1807_TTCACGCAAT	CAAGCAGAAGACGGCATACGAGATTTCACGCAATAGGGTCAAGTGCACAGTCTA
s2_R_1808_TGCATTGGCC	CAAGCAGAAGACGGCATACGAGATTGCATTGGCCAGGGTCAAGTGCACAGTCTA
s2_R_1809_CTCACTCTTG	CAAGCAGAAGACGGCATACGAGATCTCACTCTTGAGGGTCAAGTGCACAGTCTA
s2_R_1810_GACTCTCACA	CAAGCAGAAGACGGCATACGAGATGACTCTCACAAGGGTCAAGTGCACAGTCTA
s2_R_1811_CAGGCTACAA	CAAGCAGAAGACGGCATACGAGATCAGGCTACAAAGGGTCAAGTGCACAGTCTA
s2_R_1812_CACATTCACT	CAAGCAGAAGACGGCATACGAGATCACATTCACTAGGGTCAAGTGCACAGTCTA
s2_R_1813_CCTAGTCTCA	CAAGCAGAAGACGGCATACGAGATCCTAGTCTCAAGGGTCAAGTGCACAGTCTA
s2_R_1814_CACCACCGAA	CAAGCAGAAGACGGCATACGAGATCACCACCGAAAGGGTCAAGTGCACAGTCTA
s2_R_1815_GAACCTGGAT	CAAGCAGAAGACGGCATACGAGATGAACCTGGATAGGGTCAAGTGCACAGTCTA
s2_R_1816_ATCGTGGCAT	CAAGCAGAAGACGGCATACGAGATATCGTGGCATAGGGTCAAGTGCACAGTCTA
s2_R_1817_TTGCGCCAGA	CAAGCAGAAGACGGCATACGAGATTTGCGCCAGAAGGGTCAAGTGCACAGTCTA
s2_R_1818_CAAGTCATCC	CAAGCAGAAGACGGCATACGAGATCAAGTCATCCAGGGTCAAGTGCACAGTCTA
s2_R_1819_CTCCTTGCCT	CAAGCAGAAGACGGCATACGAGATCTCCTTGCCTAGGGTCAAGTGCACAGTCTA
s2_R_1820_GTTATACAGG	CAAGCAGAAGACGGCATACGAGATGTTATACAGGAGGGTCAAGTGCACAGTCTA
s2_R_1821_CGTTCCTTAT	CAAGCAGAAGACGGCATACGAGATCGTTCCTTATAGGGTCAAGTGCACAGTCTA
s2_R_1822_CTGTCCATCT	CAAGCAGAAGACGGCATACGAGATCTGTCCATCTAGGGTCAAGTGCACAGTCTA
s2_R_1823_TGTTCAACAC	CAAGCAGAAGACGGCATACGAGATTGTTCAACACAGGGTCAAGTGCACAGTCTA
s2_R_1824_ATTCGCCAGG	CAAGCAGAAGACGGCATACGAGATATTCGCCAGGAGGGTCAAGTGCACAGTCTA
s2_R_1825_CCAAGTCAAC	CAAGCAGAAGACGGCATACGAGATCCAAGTCAACAGGGTCAAGTGCACAGTCTA
s2_R_1826_CAGAGATGGA	CAAGCAGAAGACGGCATACGAGATCAGAGATGGAAGGGTCAAGTGCACAGTCTA
s2_R_1827_ATTGGACAGA	CAAGCAGAAGACGGCATACGAGATATTGGACAGAAGGGTCAAGTGCACAGTCTA
s2_R_1828_GACTTACGCC	CAAGCAGAAGACGGCATACGAGATGACTTACGCCAGGGTCAAGTGCACAGTCTA
s2_R_1829_GATGCTTCTC	CAAGCAGAAGACGGCATACGAGATGATGCTTCTCAGGGTCAAGTGCACAGTCTA
s2_R_1830_TGGTACTGAA	CAAGCAGAAGACGGCATACGAGATTGGTACTGAAAGGGTCAAGTGCACAGTCTA
s2_R_1831_TAGGCCTCAC	CAAGCAGAAGACGGCATACGAGATTAGGCCTCACAGGGTCAAGTGCACAGTCTA
s2_R_1832_CCAGAAGTTG	CAAGCAGAAGACGGCATACGAGATCCAGAAGTTGAGGGTCAAGTGCACAGTCTA
s2_R_1833_CGAGTATATG	CAAGCAGAAGACGGCATACGAGATCGAGTATATGAGGGTCAAGTGCACAGTCTA
s2_R_1834_CCTACTGCGA	CAAGCAGAAGACGGCATACGAGATCCTACTGCGAAGGGTCAAGTGCACAGTCTA
s2_R_1835_CGCGGAATTA	CAAGCAGAAGACGGCATACGAGATCGCGGAATTAAGGGTCAAGTGCACAGTCTA
s2_R_1836_CGAACCAAGG	CAAGCAGAAGACGGCATACGAGATCGAACCAAGGAGGGTCAAGTGCACAGTCTA
s2_R_1837_CCAATCGAAT	CAAGCAGAAGACGGCATACGAGATCCAATCGAATAGGGTCAAGTGCACAGTCTA
s2_R_1838_CAGTACTTCC	CAAGCAGAAGACGGCATACGAGATCAGTACTTCCAGGGTCAAGTGCACAGTCTA
s2_R_1839_CACTACAAGA	CAAGCAGAAGACGGCATACGAGATCACTACAAGAAGGGTCAAGTGCACAGTCTA
s2_R_1840_CGCACAAGGA	CAAGCAGAAGACGGCATACGAGATCGCACAAGGAAGGGTCAAGTGCACAGTCTA
s2_R_1841_TGAGTCCTAG	CAAGCAGAAGACGGCATACGAGATTGAGTCCTAGAGGGTCAAGTGCACAGTCTA
s2_R_1842_CTATGCCTTA	CAAGCAGAAGACGGCATACGAGATCTATGCCTTAAGGGTCAAGTGCACAGTCTA
s2_R_1843_CGTCATGTGA	CAAGCAGAAGACGGCATACGAGATCGTCATGTGAAGGGTCAAGTGCACAGTCTA
s2_R_1844_GAACCTCCTA	CAAGCAGAAGACGGCATACGAGATGAACCTCCTAAGGGTCAAGTGCACAGTCTA
s2_R_1845_GACTCTATTG	CAAGCAGAAGACGGCATACGAGATGACTCTATTGAGGGTCAAGTGCACAGTCTA
s2_R_1846_TAAGACGAGA	CAAGCAGAAGACGGCATACGAGATTAAGACGAGAAGGGTCAAGTGCACAGTCTA
s2_R_1847_TCAGAGAAGG	CAAGCAGAAGACGGCATACGAGATTCAGAGAAGGAGGGTCAAGTGCACAGTCTA
s2_R_1848_GAACACGTAA	CAAGCAGAAGACGGCATACGAGATGAACACGTAAAGGGTCAAGTGCACAGTCTA
s2_R_1849_CGATTGTCAC	CAAGCAGAAGACGGCATACGAGATCGATTGTCACAGGGTCAAGTGCACAGTCTA
s2_R_1850_GAGGAATCAA	CAAGCAGAAGACGGCATACGAGATGAGGAATCAAAGGGTCAAGTGCACAGTCTA
s2_R_1851_CGACTTGCTC	CAAGCAGAAGACGGCATACGAGATCGACTTGCTCAGGGTCAAGTGCACAGTCTA
s2_R_1852_CACAGTTAAG	CAAGCAGAAGACGGCATACGAGATCACAGTTAAGAGGGTCAAGTGCACAGTCTA
s2_R_1853_TCGTAACCAC	CAAGCAGAAGACGGCATACGAGATTCGTAACCACAGGGTCAAGTGCACAGTCTA
s2_R_1854_CGATGCCAAC	CAAGCAGAAGACGGCATACGAGATCGATGCCAACAGGGTCAAGTGCACAGTCTA
s2_R_1855_CTCTACATTG	CAAGCAGAAGACGGCATACGAGATCTCTACATTGAGGGTCAAGTGCACAGTCTA
s2_R_1856_CTGAGCCTAC	CAAGCAGAAGACGGCATACGAGATCTGAGCCTACAGGGTCAAGTGCACAGTCTA
s2_R_1857_CACCACCTCT	CAAGCAGAAGACGGCATACGAGATCACCACCTCTAGGGTCAAGTGCACAGTCTA
s2_R_1858_TAGGCCAATT	CAAGCAGAAGACGGCATACGAGATTAGGCCAATTAGGGTCAAGTGCACAGTCTA
s2_R_1859_GTAACTTCAC	CAAGCAGAAGACGGCATACGAGATGTAACTTCACAGGGTCAAGTGCACAGTCTA
s2_R_1860_GTTCAAGTCT	CAAGCAGAAGACGGCATACGAGATGTTCAAGTCTAGGGTCAAGTGCACAGTCTA
s2_R_1861_CGTGAACAAT	CAAGCAGAAGACGGCATACGAGATCGTGAACAATAGGGTCAAGTGCACAGTCTA
s2_R_1862_CCGTCCATGA	CAAGCAGAAGACGGCATACGAGATCCGTCCATGAAGGGTCAAGTGCACAGTCTA
s2_R_1863_CGATACGATT	CAAGCAGAAGACGGCATACGAGATCGATACGATTAGGGTCAAGTGCACAGTCTA
s2_R_1864_TACTCAGATG	CAAGCAGAAGACGGCATACGAGATTACTCAGATGAGGGTCAAGTGCACAGTCTA
s2_R_1865_TAATCGATCC	CAAGCAGAAGACGGCATACGAGATTAATCGATCCAGGGTCAAGTGCACAGTCTA
s2_R_1866_TAAGAAGCCT	CAAGCAGAAGACGGCATACGAGATTAAGAAGCCTAGGGTCAAGTGCACAGTCTA
s2_R_1867_TTCTGCAATC	CAAGCAGAAGACGGCATACGAGATTTCTGCAATCAGGGTCAAGTGCACAGTCTA
s2_R_1868_GATAATCCTG	CAAGCAGAAGACGGCATACGAGATGATAATCCTGAGGGTCAAGTGCACAGTCTA
s2_R_1869_CGTTAACCTC	CAAGCAGAAGACGGCATACGAGATCGTTAACCTCAGGGTCAAGTGCACAGTCTA
s2_R_1870_CGCACTCAAG	CAAGCAGAAGACGGCATACGAGATCGCACTCAAGAGGGTCAAGTGCACAGTCTA
s2_R_1871_CATGCTCTTC	CAAGCAGAAGACGGCATACGAGATCATGCTCTTCAGGGTCAAGTGCACAGTCTA
s2_R_1872_GAATGATGAC	CAAGCAGAAGACGGCATACGAGATGAATGATGACAGGGTCAAGTGCACAGTCTA
s2_R_1873_CCTAAGTATC	CAAGCAGAAGACGGCATACGAGATCCTAAGTATCAGGGTCAAGTGCACAGTCTA
s2_R_1874_GACACCTTAA	CAAGCAGAAGACGGCATACGAGATGACACCTTAAAGGGTCAAGTGCACAGTCTA
s2_R_1875_CCTTCCGTCA	CAAGCAGAAGACGGCATACGAGATCCTTCCGTCAAGGGTCAAGTGCACAGTCTA
s2_R_1876_CCAAGGACAA	CAAGCAGAAGACGGCATACGAGATCCAAGGACAAAGGGTCAAGTGCACAGTCTA
s2_R_1877_CGAGTTAGGA	CAAGCAGAAGACGGCATACGAGATCGAGTTAGGAAGGGTCAAGTGCACAGTCTA
s2_R_1878_GTACTACTCC	CAAGCAGAAGACGGCATACGAGATGTACTACTCCAGGGTCAAGTGCACAGTCTA
s2_R_1879_GATCCACTCA	CAAGCAGAAGACGGCATACGAGATGATCCACTCAAGGGTCAAGTGCACAGTCTA
s2_R_1880_TAATGCTCAC	CAAGCAGAAGACGGCATACGAGATTAATGCTCACAGGGTCAAGTGCACAGTCTA
s2_R_1881_CTTCCTCGAA	CAAGCAGAAGACGGCATACGAGATCTTCCTCGAAAGGGTCAAGTGCACAGTCTA
s2_R_1882_CGAGTCATAA	CAAGCAGAAGACGGCATACGAGATCGAGTCATAAAGGGTCAAGTGCACAGTCTA
s2_R_1883_GTTCAGTCAC	CAAGCAGAAGACGGCATACGAGATGTTCAGTCACAGGGTCAAGTGCACAGTCTA
s2_R_1884_GAGAACTTGA	CAAGCAGAAGACGGCATACGAGATGAGAACTTGAAGGGTCAAGTGCACAGTCTA
s2_R_1885_TACGTACAGG	CAAGCAGAAGACGGCATACGAGATTACGTACAGGAGGGTCAAGTGCACAGTCTA
s2_R_1886_GAAGGCATAA	CAAGCAGAAGACGGCATACGAGATGAAGGCATAAAGGGTCAAGTGCACAGTCTA
s2_R_1887_CCACATCCAT	CAAGCAGAAGACGGCATACGAGATCCACATCCATAGGGTCAAGTGCACAGTCTA
s2_R_1888_CCGTAACCTG	CAAGCAGAAGACGGCATACGAGATCCGTAACCTGAGGGTCAAGTGCACAGTCTA
s2_R_1889_CCGACAGATT	CAAGCAGAAGACGGCATACGAGATCCGACAGATTAGGGTCAAGTGCACAGTCTA
s2_R_1890_TAGCACATTG	CAAGCAGAAGACGGCATACGAGATTAGCACATTGAGGGTCAAGTGCACAGTCTA
s2_R_1891_GCTAGAATAG	CAAGCAGAAGACGGCATACGAGATGCTAGAATAGAGGGTCAAGTGCACAGTCTA
s2_R_1892_GAATATCGTG	CAAGCAGAAGACGGCATACGAGATGAATATCGTGAGGGTCAAGTGCACAGTCTA
s2_R_1893_CGAGACCACT	CAAGCAGAAGACGGCATACGAGATCGAGACCACTAGGGTCAAGTGCACAGTCTA
s2_R_1894_GAGGTTGCTC	CAAGCAGAAGACGGCATACGAGATGAGGTTGCTCAGGGTCAAGTGCACAGTCTA
s2_R_1895_GATACACATC	CAAGCAGAAGACGGCATACGAGATGATACACATCAGGGTCAAGTGCACAGTCTA
s2_R_1896_GTCCTCAAGA	CAAGCAGAAGACGGCATACGAGATGTCCTCAAGAAGGGTCAAGTGCACAGTCTA
s2_R_1897_CCACGACCTT	CAAGCAGAAGACGGCATACGAGATCCACGACCTTAGGGTCAAGTGCACAGTCTA
s2_R_1898_GATACTCCAC	CAAGCAGAAGACGGCATACGAGATGATACTCCACAGGGTCAAGTGCACAGTCTA
s2_R_1899_TACACCGAAT	CAAGCAGAAGACGGCATACGAGATTACACCGAATAGGGTCAAGTGCACAGTCTA
s2_R_1900_CCTCATATCA	CAAGCAGAAGACGGCATACGAGATCCTCATATCAAGGGTCAAGTGCACAGTCTA
s2_R_1901_GATAGGTTCA	CAAGCAGAAGACGGCATACGAGATGATAGGTTCAAGGGTCAAGTGCACAGTCTA
s2_R_1902_GTCCACCTTA	CAAGCAGAAGACGGCATACGAGATGTCCACCTTAAGGGTCAAGTGCACAGTCTA
s2_R_1903_GTTGATGACT	CAAGCAGAAGACGGCATACGAGATGTTGATGACTAGGGTCAAGTGCACAGTCTA
s2_R_1904_GTAAGACCTC	CAAGCAGAAGACGGCATACGAGATGTAAGACCTCAGGGTCAAGTGCACAGTCTA
s2_R_1905_TCACACACAT	CAAGCAGAAGACGGCATACGAGATTCACACACATAGGGTCAAGTGCACAGTCTA
s2_R_1906_TACAACAGGA	CAAGCAGAAGACGGCATACGAGATTACAACAGGAAGGGTCAAGTGCACAGTCTA
s2_R_1907_TGCTATACCT	CAAGCAGAAGACGGCATACGAGATTGCTATACCTAGGGTCAAGTGCACAGTCTA
s2_R_1908_GCAGAGCCAT	CAAGCAGAAGACGGCATACGAGATGCAGAGCCATAGGGTCAAGTGCACAGTCTA
s2_R_1909_CGACAAGAAC	CAAGCAGAAGACGGCATACGAGATCGACAAGAACAGGGTCAAGTGCACAGTCTA
s2_R_1910_TACTGTCAAC	CAAGCAGAAGACGGCATACGAGATTACTGTCAACAGGGTCAAGTGCACAGTCTA
s2_R_1911_CGACAATCTT	CAAGCAGAAGACGGCATACGAGATCGACAATCTTAGGGTCAAGTGCACAGTCTA
s2_R_1912_CGAAGCTCTT	CAAGCAGAAGACGGCATACGAGATCGAAGCTCTTAGGGTCAAGTGCACAGTCTA
s2_R_1913_CGACTCTTCA	CAAGCAGAAGACGGCATACGAGATCGACTCTTCAAGGGTCAAGTGCACAGTCTA
s2_R_1914_CGATACGCAC	CAAGCAGAAGACGGCATACGAGATCGATACGCACAGGGTCAAGTGCACAGTCTA
s2_R_1915_CTACTGCATT	CAAGCAGAAGACGGCATACGAGATCTACTGCATTAGGGTCAAGTGCACAGTCTA
s2_R_1916_GACTCCAAGG	CAAGCAGAAGACGGCATACGAGATGACTCCAAGGAGGGTCAAGTGCACAGTCTA
s2_R_1917_CTCAATCATC	CAAGCAGAAGACGGCATACGAGATCTCAATCATCAGGGTCAAGTGCACAGTCTA
s2_R_1918_CTTGCTAACT	CAAGCAGAAGACGGCATACGAGATCTTGCTAACTAGGGTCAAGTGCACAGTCTA
s2_R_1919_TGCAATTCAC	CAAGCAGAAGACGGCATACGAGATTGCAATTCACAGGGTCAAGTGCACAGTCTA
s2_R_1920_CGACACCTAT	CAAGCAGAAGACGGCATACGAGATCGACACCTATAGGGTCAAGTGCACAGTCTA
s2_R_1921_CGTCACGAAT	CAAGCAGAAGACGGCATACGAGATCGTCACGAATAGGGTCAAGTGCACAGTCTA
s2_R_1922_GTCCATTGAA	CAAGCAGAAGACGGCATACGAGATGTCCATTGAAAGGGTCAAGTGCACAGTCTA
s2_R_1923_GAGACGTATT	CAAGCAGAAGACGGCATACGAGATGAGACGTATTAGGGTCAAGTGCACAGTCTA
s2_R_1924_CTTACCAGAC	CAAGCAGAAGACGGCATACGAGATCTTACCAGACAGGGTCAAGTGCACAGTCTA
s2_R_1925_TCTTGCATAG	CAAGCAGAAGACGGCATACGAGATTCTTGCATAGAGGGTCAAGTGCACAGTCTA
s2_R_1926_GCTTCACGAC	CAAGCAGAAGACGGCATACGAGATGCTTCACGACAGGGTCAAGTGCACAGTCTA
s2_R_1927_TGTCTAATCC	CAAGCAGAAGACGGCATACGAGATTGTCTAATCCAGGGTCAAGTGCACAGTCTA
s2_R_1928_TCCTCGTTAG	CAAGCAGAAGACGGCATACGAGATTCCTCGTTAGAGGGTCAAGTGCACAGTCTA
s2_R_1929_GAGATGCTAA	CAAGCAGAAGACGGCATACGAGATGAGATGCTAAAGGGTCAAGTGCACAGTCTA
s2_R_1930_GAGTCATTGA	CAAGCAGAAGACGGCATACGAGATGAGTCATTGAAGGGTCAAGTGCACAGTCTA
s2_R_1931_TCAGGATTCC	CAAGCAGAAGACGGCATACGAGATTCAGGATTCCAGGGTCAAGTGCACAGTCTA
s2_R_1932_TGGATCCTAT	CAAGCAGAAGACGGCATACGAGATTGGATCCTATAGGGTCAAGTGCACAGTCTA
s2_R_1933_GAGCAGACTA	CAAGCAGAAGACGGCATACGAGATGAGCAGACTAAGGGTCAAGTGCACAGTCTA
s2_R_1934_CGTTACCGAT	CAAGCAGAAGACGGCATACGAGATCGTTACCGATAGGGTCAAGTGCACAGTCTA
s2_R_1935_CTCAAGCGAG	CAAGCAGAAGACGGCATACGAGATCTCAAGCGAGAGGGTCAAGTGCACAGTCTA
s2_R_1936_TACAATCGAC	CAAGCAGAAGACGGCATACGAGATTACAATCGACAGGGTCAAGTGCACAGTCTA
s2_R_1937_TAGTAGGAAG	CAAGCAGAAGACGGCATACGAGATTAGTAGGAAGAGGGTCAAGTGCACAGTCTA
s2_R_1938_TAGACCTGAA	CAAGCAGAAGACGGCATACGAGATTAGACCTGAAAGGGTCAAGTGCACAGTCTA
s2_R_1939_CTTGAGAGTT	CAAGCAGAAGACGGCATACGAGATCTTGAGAGTTAGGGTCAAGTGCACAGTCTA
s2_R_1940_GAACCGTCAT	CAAGCAGAAGACGGCATACGAGATGAACCGTCATAGGGTCAAGTGCACAGTCTA
s2_R_1941_GCGACTGAAC	CAAGCAGAAGACGGCATACGAGATGCGACTGAACAGGGTCAAGTGCACAGTCTA
s2_R_1942_CTTACTACTC	CAAGCAGAAGACGGCATACGAGATCTTACTACTCAGGGTCAAGTGCACAGTCTA
s2_R_1943_TCAACCATGA	CAAGCAGAAGACGGCATACGAGATTCAACCATGAAGGGTCAAGTGCACAGTCTA
s2_R_1944_TTCTTGGTGC	CAAGCAGAAGACGGCATACGAGATTTCTTGGTGCAGGGTCAAGTGCACAGTCTA
s2_R_1945_GACTACTTAC	CAAGCAGAAGACGGCATACGAGATGACTACTTACAGGGTCAAGTGCACAGTCTA
s2_R_1946_GACTATGAGG	CAAGCAGAAGACGGCATACGAGATGACTATGAGGAGGGTCAAGTGCACAGTCTA
s2_R_1947_TTGTGACTCA	CAAGCAGAAGACGGCATACGAGATTTGTGACTCAAGGGTCAAGTGCACAGTCTA
s2_R_1948_TAAGTTCCAC	CAAGCAGAAGACGGCATACGAGATTAAGTTCCACAGGGTCAAGTGCACAGTCTA
s2_R_1949_TCTATAGCTG	CAAGCAGAAGACGGCATACGAGATTCTATAGCTGAGGGTCAAGTGCACAGTCTA
s2_R_1950_TACCTGACTA	CAAGCAGAAGACGGCATACGAGATTACCTGACTAAGGGTCAAGTGCACAGTCTA
s2_R_1951_GAGTACCGAA	CAAGCAGAAGACGGCATACGAGATGAGTACCGAAAGGGTCAAGTGCACAGTCTA
s2_R_1952_TAGCGAACTG	CAAGCAGAAGACGGCATACGAGATTAGCGAACTGAGGGTCAAGTGCACAGTCTA
s2_R_1953_TACGACATAG	CAAGCAGAAGACGGCATACGAGATTACGACATAGAGGGTCAAGTGCACAGTCTA
s2_R_1954_TCACGAGCCA	CAAGCAGAAGACGGCATACGAGATTCACGAGCCAAGGGTCAAGTGCACAGTCTA
s2_R_1955_TACGTCTGAT	CAAGCAGAAGACGGCATACGAGATTACGTCTGATAGGGTCAAGTGCACAGTCTA
s2_R_1956_TCCTTGCGAC	CAAGCAGAAGACGGCATACGAGATTCCTTGCGACAGGGTCAAGTGCACAGTCTA
s2_R_1957_TTCATGAGAC	CAAGCAGAAGACGGCATACGAGATTTCATGAGACAGGGTCAAGTGCACAGTCTA
s2_R_1958_TCCGAAGCTG	CAAGCAGAAGACGGCATACGAGATTCCGAAGCTGAGGGTCAAGTGCACAGTCTA
s2_R_1959_GATCCATAAC	CAAGCAGAAGACGGCATACGAGATGATCCATAACAGGGTCAAGTGCACAGTCTA
s2_R_1960_TAGAGAGGTT	CAAGCAGAAGACGGCATACGAGATTAGAGAGGTTAGGGTCAAGTGCACAGTCTA
s2_R_1961_GTCATCATCC	CAAGCAGAAGACGGCATACGAGATGTCATCATCCAGGGTCAAGTGCACAGTCTA
s2_R_1962_TAGACAGAGT	CAAGCAGAAGACGGCATACGAGATTAGACAGAGTAGGGTCAAGTGCACAGTCTA
s2_R_1963_GCCTGGATTC	CAAGCAGAAGACGGCATACGAGATGCCTGGATTCAGGGTCAAGTGCACAGTCTA
s2_R_1964_GCAGCCTTAC	CAAGCAGAAGACGGCATACGAGATGCAGCCTTACAGGGTCAAGTGCACAGTCTA
s2_R_1965_GCTATTAGGA	CAAGCAGAAGACGGCATACGAGATGCTATTAGGAAGGGTCAAGTGCACAGTCTA
s2_R_1966_TACACCGTCA	CAAGCAGAAGACGGCATACGAGATTACACCGTCAAGGGTCAAGTGCACAGTCTA
s2_R_1967_GTTATGCCAG	CAAGCAGAAGACGGCATACGAGATGTTATGCCAGAGGGTCAAGTGCACAGTCTA
s2_R_1968_TACGCTACGA	CAAGCAGAAGACGGCATACGAGATTACGCTACGAAGGGTCAAGTGCACAGTCTA
s2_R_1969_TAGAAGAGAC	CAAGCAGAAGACGGCATACGAGATTAGAAGAGACAGGGTCAAGTGCACAGTCTA
s2_R_1970_TAACACCGAC	CAAGCAGAAGACGGCATACGAGATTAACACCGACAGGGTCAAGTGCACAGTCTA
s2_R_1971_TACGAGGAGG	CAAGCAGAAGACGGCATACGAGATTACGAGGAGGAGGGTCAAGTGCACAGTCTA
s2_R_1972_TCCTACCAAC	CAAGCAGAAGACGGCATACGAGATTCCTACCAACAGGGTCAAGTGCACAGTCTA
s2_R_1973_TTCTGATCCT	CAAGCAGAAGACGGCATACGAGATTTCTGATCCTAGGGTCAAGTGCACAGTCTA
s2_R_1974_TCGATGATTG	CAAGCAGAAGACGGCATACGAGATTCGATGATTGAGGGTCAAGTGCACAGTCTA
s2_R_1975_TCCAGTAGAC	CAAGCAGAAGACGGCATACGAGATTCCAGTAGACAGGGTCAAGTGCACAGTCTA
s2_R_1976_CAACGCTAGG	CAAGCAGAAGACGGCATACGAGATCAACGCTAGGAGGGTCAAGTGCACAGTCTA
s2_R_1977_GAACGCTTAC	CAAGCAGAAGACGGCATACGAGATGAACGCTTACAGGGTCAAGTGCACAGTCTA
s2_R_1978_TTCCAGCAAC	CAAGCAGAAGACGGCATACGAGATTTCCAGCAACAGGGTCAAGTGCACAGTCTA
s2_R_1979_CACGAGTCTC	CAAGCAGAAGACGGCATACGAGATCACGAGTCTCAGGGTCAAGTGCACAGTCTA
s2_R_1980_GCGGCAATAC	CAAGCAGAAGACGGCATACGAGATGCGGCAATACAGGGTCAAGTGCACAGTCTA
s2_R_1981_TTGACTAGCT	CAAGCAGAAGACGGCATACGAGATTTGACTAGCTAGGGTCAAGTGCACAGTCTA
s2_R_1982_AGACAGTCAC	CAAGCAGAAGACGGCATACGAGATAGACAGTCACAGGGTCAAGTGCACAGTCTA
s2_R_1983_TCCTATCAGG	CAAGCAGAAGACGGCATACGAGATTCCTATCAGGAGGGTCAAGTGCACAGTCTA
s2_R_1984_CACGACTAAC	CAAGCAGAAGACGGCATACGAGATCACGACTAACAGGGTCAAGTGCACAGTCTA
s2_R_1985_CCATAGCCTC	CAAGCAGAAGACGGCATACGAGATCCATAGCCTCAGGGTCAAGTGCACAGTCTA
s2_R_1986_TGCGCGATAC	CAAGCAGAAGACGGCATACGAGATTGCGCGATACAGGGTCAAGTGCACAGTCTA
s2_R_1987_TAAGTAGGAC	CAAGCAGAAGACGGCATACGAGATTAAGTAGGACAGGGTCAAGTGCACAGTCTA
s2_R_1988_GGAAGCGAAC	CAAGCAGAAGACGGCATACGAGATGGAAGCGAACAGGGTCAAGTGCACAGTCTA
s2_R_1989_GATGGAACTC	CAAGCAGAAGACGGCATACGAGATGATGGAACTCAGGGTCAAGTGCACAGTCTA
s2_R_1990_TGATGAAGGA	CAAGCAGAAGACGGCATACGAGATTGATGAAGGAAGGGTCAAGTGCACAGTCTA
s2_R_1991_TAGGCGATAT	CAAGCAGAAGACGGCATACGAGATTAGGCGATATAGGGTCAAGTGCACAGTCTA
s2_R_1992_TCCAACATTC	CAAGCAGAAGACGGCATACGAGATTCCAACATTCAGGGTCAAGTGCACAGTCTA
s2_R_1993_TCACAGAGGT	CAAGCAGAAGACGGCATACGAGATTCACAGAGGTAGGGTCAAGTGCACAGTCTA
s2_R_1994_TTCAGTAAGG	CAAGCAGAAGACGGCATACGAGATTTCAGTAAGGAGGGTCAAGTGCACAGTCTA
s2_R_1995_TTGGCCGACT	CAAGCAGAAGACGGCATACGAGATTTGGCCGACTAGGGTCAAGTGCACAGTCTA
s2_R_1996_TGTACCATGG	CAAGCAGAAGACGGCATACGAGATTGTACCATGGAGGGTCAAGTGCACAGTCTA
s2_R_1997_ACGGTAGCGT	CAAGCAGAAGACGGCATACGAGATACGGTAGCGTAGGGTCAAGTGCACAGTCTA
s2_R_1998_AGGCTAACTC	CAAGCAGAAGACGGCATACGAGATAGGCTAACTCAGGGTCAAGTGCACAGTCTA
s2_R_1999_TACATCCACA	CAAGCAGAAGACGGCATACGAGATTACATCCACAAGGGTCAAGTGCACAGTCTA
s2_R_2000_CTTGCTGTAG	CAAGCAGAAGACGGCATACGAGATCTTGCTGTAGAGGGTCAAGTGCACAGTCTA
s2_R_2001_AGAATAGGCC	CAAGCAGAAGACGGCATACGAGATAGAATAGGCCAGGGTCAAGTGCACAGTCTA
s2_R_2002_CGGTGCAGAA	CAAGCAGAAGACGGCATACGAGATCGGTGCAGAAAGGGTCAAGTGCACAGTCTA
s2_R_2003_TCTTCTCCGA	CAAGCAGAAGACGGCATACGAGATTCTTCTCCGAAGGGTCAAGTGCACAGTCTA
s2_R_2004_ATTCTCCGGA	CAAGCAGAAGACGGCATACGAGATATTCTCCGGAAGGGTCAAGTGCACAGTCTA
s2_R_2005_CAGAACGTTC	CAAGCAGAAGACGGCATACGAGATCAGAACGTTCAGGGTCAAGTGCACAGTCTA
s2_R_2006_CTAACTCGCC	CAAGCAGAAGACGGCATACGAGATCTAACTCGCCAGGGTCAAGTGCACAGTCTA
s2_R_2007_ATGGACGTTC	CAAGCAGAAGACGGCATACGAGATATGGACGTTCAGGGTCAAGTGCACAGTCTA
s2_R_2008_ATTCAGCGCC	CAAGCAGAAGACGGCATACGAGATATTCAGCGCCAGGGTCAAGTGCACAGTCTA
s2_R_2009_AGAACAACTC	CAAGCAGAAGACGGCATACGAGATAGAACAACTCAGGGTCAAGTGCACAGTCTA
s2_R_2010_TATAAGCACC	CAAGCAGAAGACGGCATACGAGATTATAAGCACCAGGGTCAAGTGCACAGTCTA
s2_R_2011_ACATGAACTC	CAAGCAGAAGACGGCATACGAGATACATGAACTCAGGGTCAAGTGCACAGTCTA
s2_R_2012_CTACCAGCTC	CAAGCAGAAGACGGCATACGAGATCTACCAGCTCAGGGTCAAGTGCACAGTCTA
s2_R_2013_CACGGCGAAT	CAAGCAGAAGACGGCATACGAGATCACGGCGAATAGGGTCAAGTGCACAGTCTA
s2_R_2014_AGTAGCAGAC	CAAGCAGAAGACGGCATACGAGATAGTAGCAGACAGGGTCAAGTGCACAGTCTA
s2_R_2015_GGCCACTAAC	CAAGCAGAAGACGGCATACGAGATGGCCACTAACAGGGTCAAGTGCACAGTCTA
s2_R_2016_TCCATACTCA	CAAGCAGAAGACGGCATACGAGATTCCATACTCAAGGGTCAAGTGCACAGTCTA
s2_R_2017_ATCAGCACTC	CAAGCAGAAGACGGCATACGAGATATCAGCACTCAGGGTCAAGTGCACAGTCTA
s2_R_2018_CCAATATCTC	CAAGCAGAAGACGGCATACGAGATCCAATATCTCAGGGTCAAGTGCACAGTCTA
s2_R_2019_GAGCAACACC	CAAGCAGAAGACGGCATACGAGATGAGCAACACCAGGGTCAAGTGCACAGTCTA
s2_R_2020_CTTCCAATTG	CAAGCAGAAGACGGCATACGAGATCTTCCAATTGAGGGTCAAGTGCACAGTCTA
s2_R_2021_ATTACAGGAC	CAAGCAGAAGACGGCATACGAGATATTACAGGACAGGGTCAAGTGCACAGTCTA
s2_R_2022_GTAACGCGAA	CAAGCAGAAGACGGCATACGAGATGTAACGCGAAAGGGTCAAGTGCACAGTCTA
s2_R_2023_ATACTCGCCG	CAAGCAGAAGACGGCATACGAGATATACTCGCCGAGGGTCAAGTGCACAGTCTA
s2_R_2024_GAATCGCACC	CAAGCAGAAGACGGCATACGAGATGAATCGCACCAGGGTCAAGTGCACAGTCTA
