rpp30_F_1_ACGTTGAAGA	AATGATACGGCGACCACCGAGATCTACACACGTTGAAGAGAGCGGCTGTCTCCACAAGT
rpp30_F_2_TGTAATCGAG	AATGATACGGCGACCACCGAGATCTACACTGTAATCGAGGAGCGGCTGTCTCCACAAGT
rpp30_F_3_GTTGAGATGG	AATGATACGGCGACCACCGAGATCTACACGTTGAGATGGGAGCGGCTGTCTCCACAAGT
rpp30_F_4_AAGACCAACG	AATGATACGGCGACCACCGAGATCTACACAAGACCAACGGAGCGGCTGTCTCCACAAGT
rpp30_F_5_CGAACTTGCG	AATGATACGGCGACCACCGAGATCTACACCGAACTTGCGGAGCGGCTGTCTCCACAAGT
rpp30_F_6_CGATACAACG	AATGATACGGCGACCACCGAGATCTACACCGATACAACGGAGCGGCTGTCTCCACAAGT
rpp30_F_7_TAAGGTAACG	AATGATACGGCGACCACCGAGATCTACACTAAGGTAACGGAGCGGCTGTCTCCACAAGT
rpp30_F_8_TACACTCACG	AATGATACGGCGACCACCGAGATCTACACTACACTCACGGAGCGGCTGTCTCCACAAGT
rpp30_F_9_CTGGTAGTCA	AATGATACGGCGACCACCGAGATCTACACCTGGTAGTCAGAGCGGCTGTCTCCACAAGT
rpp30_F_10_AATTCCGTCG	AATGATACGGCGACCACCGAGATCTACACAATTCCGTCGGAGCGGCTGTCTCCACAAGT
rpp30_F_11_AGCGATCTAA	AATGATACGGCGACCACCGAGATCTACACAGCGATCTAAGAGCGGCTGTCTCCACAAGT
rpp30_F_12_GAGGCTATCT	AATGATACGGCGACCACCGAGATCTACACGAGGCTATCTGAGCGGCTGTCTCCACAAGT
rpp30_F_13_CCGATCAGTA	AATGATACGGCGACCACCGAGATCTACACCCGATCAGTAGAGCGGCTGTCTCCACAAGT
rpp30_F_14_CTCAAGTACG	AATGATACGGCGACCACCGAGATCTACACCTCAAGTACGGAGCGGCTGTCTCCACAAGT
rpp30_F_15_AGCGTTGTTG	AATGATACGGCGACCACCGAGATCTACACAGCGTTGTTGGAGCGGCTGTCTCCACAAGT
rpp30_F_16_ATTCTGTCCG	AATGATACGGCGACCACCGAGATCTACACATTCTGTCCGGAGCGGCTGTCTCCACAAGT
rpp30_F_17_TCTGGTCTAA	AATGATACGGCGACCACCGAGATCTACACTCTGGTCTAAGAGCGGCTGTCTCCACAAGT
rpp30_F_18_AGATTCTCTG	AATGATACGGCGACCACCGAGATCTACACAGATTCTCTGGAGCGGCTGTCTCCACAAGT
rpp30_F_19_GAATGTTACG	AATGATACGGCGACCACCGAGATCTACACGAATGTTACGGAGCGGCTGTCTCCACAAGT
rpp30_F_20_TAGTAGTCTG	AATGATACGGCGACCACCGAGATCTACACTAGTAGTCTGGAGCGGCTGTCTCCACAAGT
rpp30_F_21_ATCTGGAACG	AATGATACGGCGACCACCGAGATCTACACATCTGGAACGGAGCGGCTGTCTCCACAAGT
rpp30_F_22_ACTCATCTGG	AATGATACGGCGACCACCGAGATCTACACACTCATCTGGGAGCGGCTGTCTCCACAAGT
rpp30_F_23_TATCTTACGG	AATGATACGGCGACCACCGAGATCTACACTATCTTACGGGAGCGGCTGTCTCCACAAGT
rpp30_F_24_ATGTTGTTGG	AATGATACGGCGACCACCGAGATCTACACATGTTGTTGGGAGCGGCTGTCTCCACAAGT
rpp30_F_25_GATTGTCGTA	AATGATACGGCGACCACCGAGATCTACACGATTGTCGTAGAGCGGCTGTCTCCACAAGT
rpp30_F_26_GAGGTATGGA	AATGATACGGCGACCACCGAGATCTACACGAGGTATGGAGAGCGGCTGTCTCCACAAGT
rpp30_F_27_GTGGAATAGG	AATGATACGGCGACCACCGAGATCTACACGTGGAATAGGGAGCGGCTGTCTCCACAAGT
rpp30_F_28_TTCTAAGTCG	AATGATACGGCGACCACCGAGATCTACACTTCTAAGTCGGAGCGGCTGTCTCCACAAGT
rpp30_F_29_TTATCTTGCG	AATGATACGGCGACCACCGAGATCTACACTTATCTTGCGGAGCGGCTGTCTCCACAAGT
rpp30_F_30_AGACTGCGTG	AATGATACGGCGACCACCGAGATCTACACAGACTGCGTGGAGCGGCTGTCTCCACAAGT
rpp30_F_31_GTAGTGTGAA	AATGATACGGCGACCACCGAGATCTACACGTAGTGTGAAGAGCGGCTGTCTCCACAAGT
rpp30_F_32_TATTGTCACG	AATGATACGGCGACCACCGAGATCTACACTATTGTCACGGAGCGGCTGTCTCCACAAGT
rpp30_F_33_AATACGAGCG	AATGATACGGCGACCACCGAGATCTACACAATACGAGCGGAGCGGCTGTCTCCACAAGT
rpp30_F_34_GTCCTTAGCG	AATGATACGGCGACCACCGAGATCTACACGTCCTTAGCGGAGCGGCTGTCTCCACAAGT
rpp30_F_35_CTAGTATTCG	AATGATACGGCGACCACCGAGATCTACACCTAGTATTCGGAGCGGCTGTCTCCACAAGT
rpp30_F_36_ATGACAGTCG	AATGATACGGCGACCACCGAGATCTACACATGACAGTCGGAGCGGCTGTCTCCACAAGT
rpp30_F_37_CCTTGCTTCG	AATGATACGGCGACCACCGAGATCTACACCCTTGCTTCGGAGCGGCTGTCTCCACAAGT
rpp30_F_38_CAAGTGTCCG	AATGATACGGCGACCACCGAGATCTACACCAAGTGTCCGGAGCGGCTGTCTCCACAAGT
rpp30_F_39_CTACTTGTCG	AATGATACGGCGACCACCGAGATCTACACCTACTTGTCGGAGCGGCTGTCTCCACAAGT
rpp30_F_40_TGATAGGTCT	AATGATACGGCGACCACCGAGATCTACACTGATAGGTCTGAGCGGCTGTCTCCACAAGT
rpp30_F_41_CTGTACACCG	AATGATACGGCGACCACCGAGATCTACACCTGTACACCGGAGCGGCTGTCTCCACAAGT
rpp30_F_42_AGACACCGGA	AATGATACGGCGACCACCGAGATCTACACAGACACCGGAGAGCGGCTGTCTCCACAAGT
rpp30_F_43_ACCTTGGACG	AATGATACGGCGACCACCGAGATCTACACACCTTGGACGGAGCGGCTGTCTCCACAAGT
rpp30_F_44_CGTGTAATTG	AATGATACGGCGACCACCGAGATCTACACCGTGTAATTGGAGCGGCTGTCTCCACAAGT
rpp30_F_45_TTCATGCGGA	AATGATACGGCGACCACCGAGATCTACACTTCATGCGGAGAGCGGCTGTCTCCACAAGT
rpp30_F_46_AAGCTATCCG	AATGATACGGCGACCACCGAGATCTACACAAGCTATCCGGAGCGGCTGTCTCCACAAGT
rpp30_F_47_ACAGGTGTTA	AATGATACGGCGACCACCGAGATCTACACACAGGTGTTAGAGCGGCTGTCTCCACAAGT
rpp30_F_48_AACGTCAACG	AATGATACGGCGACCACCGAGATCTACACAACGTCAACGGAGCGGCTGTCTCCACAAGT
rpp30_F_49_AGGTAGGTAA	AATGATACGGCGACCACCGAGATCTACACAGGTAGGTAAGAGCGGCTGTCTCCACAAGT
rpp30_F_50_GACAACAACG	AATGATACGGCGACCACCGAGATCTACACGACAACAACGGAGCGGCTGTCTCCACAAGT
rpp30_F_51_GACTGCTTCG	AATGATACGGCGACCACCGAGATCTACACGACTGCTTCGGAGCGGCTGTCTCCACAAGT
rpp30_F_52_CCGTGGATCA	AATGATACGGCGACCACCGAGATCTACACCCGTGGATCAGAGCGGCTGTCTCCACAAGT
rpp30_F_53_TGAGTCAACG	AATGATACGGCGACCACCGAGATCTACACTGAGTCAACGGAGCGGCTGTCTCCACAAGT
rpp30_F_54_TTGGACAACG	AATGATACGGCGACCACCGAGATCTACACTTGGACAACGGAGCGGCTGTCTCCACAAGT
rpp30_F_55_CTGTGTTCAA	AATGATACGGCGACCACCGAGATCTACACCTGTGTTCAAGAGCGGCTGTCTCCACAAGT
rpp30_F_56_GTATCCTGTA	AATGATACGGCGACCACCGAGATCTACACGTATCCTGTAGAGCGGCTGTCTCCACAAGT
rpp30_F_57_CGCAATTGTA	AATGATACGGCGACCACCGAGATCTACACCGCAATTGTAGAGCGGCTGTCTCCACAAGT
rpp30_F_58_AACAGTGACG	AATGATACGGCGACCACCGAGATCTACACAACAGTGACGGAGCGGCTGTCTCCACAAGT
rpp30_F_59_GATGTATCCG	AATGATACGGCGACCACCGAGATCTACACGATGTATCCGGAGCGGCTGTCTCCACAAGT
rpp30_F_60_CATTGGCTTG	AATGATACGGCGACCACCGAGATCTACACCATTGGCTTGGAGCGGCTGTCTCCACAAGT
rpp30_F_61_GAGTATAGGT	AATGATACGGCGACCACCGAGATCTACACGAGTATAGGTGAGCGGCTGTCTCCACAAGT
rpp30_F_62_GACATAATCG	AATGATACGGCGACCACCGAGATCTACACGACATAATCGGAGCGGCTGTCTCCACAAGT
rpp30_F_63_ACTGTTCTTG	AATGATACGGCGACCACCGAGATCTACACACTGTTCTTGGAGCGGCTGTCTCCACAAGT
rpp30_F_64_CTGACTATCG	AATGATACGGCGACCACCGAGATCTACACCTGACTATCGGAGCGGCTGTCTCCACAAGT
rpp30_F_65_GCTTGTCATG	AATGATACGGCGACCACCGAGATCTACACGCTTGTCATGGAGCGGCTGTCTCCACAAGT
rpp30_F_66_AAGTTCTACG	AATGATACGGCGACCACCGAGATCTACACAAGTTCTACGGAGCGGCTGTCTCCACAAGT
rpp30_F_67_TAGTATACGG	AATGATACGGCGACCACCGAGATCTACACTAGTATACGGGAGCGGCTGTCTCCACAAGT
rpp30_F_68_TTGTGATCGG	AATGATACGGCGACCACCGAGATCTACACTTGTGATCGGGAGCGGCTGTCTCCACAAGT
rpp30_F_69_GAGCAATGCG	AATGATACGGCGACCACCGAGATCTACACGAGCAATGCGGAGCGGCTGTCTCCACAAGT
rpp30_F_70_CGTTCATAGA	AATGATACGGCGACCACCGAGATCTACACCGTTCATAGAGAGCGGCTGTCTCCACAAGT
rpp30_F_71_ACACAATTCG	AATGATACGGCGACCACCGAGATCTACACACACAATTCGGAGCGGCTGTCTCCACAAGT
rpp30_F_72_ACATTCACGG	AATGATACGGCGACCACCGAGATCTACACACATTCACGGGAGCGGCTGTCTCCACAAGT
rpp30_F_73_AGCATGGTAG	AATGATACGGCGACCACCGAGATCTACACAGCATGGTAGGAGCGGCTGTCTCCACAAGT
rpp30_F_74_CTTGGAGTGA	AATGATACGGCGACCACCGAGATCTACACCTTGGAGTGAGAGCGGCTGTCTCCACAAGT
rpp30_F_75_TGTTCGGCAA	AATGATACGGCGACCACCGAGATCTACACTGTTCGGCAAGAGCGGCTGTCTCCACAAGT
rpp30_F_76_GTCAGAATTG	AATGATACGGCGACCACCGAGATCTACACGTCAGAATTGGAGCGGCTGTCTCCACAAGT
rpp30_F_77_AAGACCTTGG	AATGATACGGCGACCACCGAGATCTACACAAGACCTTGGGAGCGGCTGTCTCCACAAGT
rpp30_F_78_AACGGATCTA	AATGATACGGCGACCACCGAGATCTACACAACGGATCTAGAGCGGCTGTCTCCACAAGT
rpp30_F_79_CTAATGAACG	AATGATACGGCGACCACCGAGATCTACACCTAATGAACGGAGCGGCTGTCTCCACAAGT
rpp30_F_80_CGTAAGCGTA	AATGATACGGCGACCACCGAGATCTACACCGTAAGCGTAGAGCGGCTGTCTCCACAAGT
rpp30_F_81_ATGCGATTCG	AATGATACGGCGACCACCGAGATCTACACATGCGATTCGGAGCGGCTGTCTCCACAAGT
rpp30_F_82_TCTTGTTCCG	AATGATACGGCGACCACCGAGATCTACACTCTTGTTCCGGAGCGGCTGTCTCCACAAGT
rpp30_F_83_ATGTCATACG	AATGATACGGCGACCACCGAGATCTACACATGTCATACGGAGCGGCTGTCTCCACAAGT
rpp30_F_84_CGTGTGTAAG	AATGATACGGCGACCACCGAGATCTACACCGTGTGTAAGGAGCGGCTGTCTCCACAAGT
rpp30_F_85_ATAGAAGACG	AATGATACGGCGACCACCGAGATCTACACATAGAAGACGGAGCGGCTGTCTCCACAAGT
rpp30_F_86_CACAGGATCG	AATGATACGGCGACCACCGAGATCTACACCACAGGATCGGAGCGGCTGTCTCCACAAGT
rpp30_F_87_TGAATGCGTC	AATGATACGGCGACCACCGAGATCTACACTGAATGCGTCGAGCGGCTGTCTCCACAAGT
rpp30_F_88_AAGTTGAGCG	AATGATACGGCGACCACCGAGATCTACACAAGTTGAGCGGAGCGGCTGTCTCCACAAGT
rpp30_F_89_TGCGTTCACG	AATGATACGGCGACCACCGAGATCTACACTGCGTTCACGGAGCGGCTGTCTCCACAAGT
rpp30_F_90_CTCAATTGGT	AATGATACGGCGACCACCGAGATCTACACCTCAATTGGTGAGCGGCTGTCTCCACAAGT
rpp30_F_91_CATATGATGG	AATGATACGGCGACCACCGAGATCTACACCATATGATGGGAGCGGCTGTCTCCACAAGT
rpp30_F_92_ATCGAGAAGA	AATGATACGGCGACCACCGAGATCTACACATCGAGAAGAGAGCGGCTGTCTCCACAAGT
rpp30_F_93_GATGAACACG	AATGATACGGCGACCACCGAGATCTACACGATGAACACGGAGCGGCTGTCTCCACAAGT
rpp30_F_94_ACATGTCAGA	AATGATACGGCGACCACCGAGATCTACACACATGTCAGAGAGCGGCTGTCTCCACAAGT
rpp30_F_95_AATGGTCTGA	AATGATACGGCGACCACCGAGATCTACACAATGGTCTGAGAGCGGCTGTCTCCACAAGT
rpp30_F_96_AGACTTACGG	AATGATACGGCGACCACCGAGATCTACACAGACTTACGGGAGCGGCTGTCTCCACAAGT
rpp30_F_97_GTCATGTGCG	AATGATACGGCGACCACCGAGATCTACACGTCATGTGCGGAGCGGCTGTCTCCACAAGT
rpp30_F_98_TTGTGTGCGT	AATGATACGGCGACCACCGAGATCTACACTTGTGTGCGTGAGCGGCTGTCTCCACAAGT
rpp30_F_99_GTAGTCTAGT	AATGATACGGCGACCACCGAGATCTACACGTAGTCTAGTGAGCGGCTGTCTCCACAAGT
rpp30_F_100_TGGTTGAGTA	AATGATACGGCGACCACCGAGATCTACACTGGTTGAGTAGAGCGGCTGTCTCCACAAGT
rpp30_F_101_AAGCTTAGGA	AATGATACGGCGACCACCGAGATCTACACAAGCTTAGGAGAGCGGCTGTCTCCACAAGT
rpp30_F_102_CATTAGGTCT	AATGATACGGCGACCACCGAGATCTACACCATTAGGTCTGAGCGGCTGTCTCCACAAGT
rpp30_F_103_GAAGTGTGTT	AATGATACGGCGACCACCGAGATCTACACGAAGTGTGTTGAGCGGCTGTCTCCACAAGT
rpp30_F_104_CTGCATTCGG	AATGATACGGCGACCACCGAGATCTACACCTGCATTCGGGAGCGGCTGTCTCCACAAGT
rpp30_F_105_ACCTGATTCG	AATGATACGGCGACCACCGAGATCTACACACCTGATTCGGAGCGGCTGTCTCCACAAGT
rpp30_F_106_CCGTGTTGTA	AATGATACGGCGACCACCGAGATCTACACCCGTGTTGTAGAGCGGCTGTCTCCACAAGT
rpp30_F_107_AACATGCGCG	AATGATACGGCGACCACCGAGATCTACACAACATGCGCGGAGCGGCTGTCTCCACAAGT
rpp30_F_108_ACTGATAACG	AATGATACGGCGACCACCGAGATCTACACACTGATAACGGAGCGGCTGTCTCCACAAGT
rpp30_F_109_TACGGATCAG	AATGATACGGCGACCACCGAGATCTACACTACGGATCAGGAGCGGCTGTCTCCACAAGT
rpp30_F_110_AATCAGAACG	AATGATACGGCGACCACCGAGATCTACACAATCAGAACGGAGCGGCTGTCTCCACAAGT
rpp30_F_111_GATACTATCG	AATGATACGGCGACCACCGAGATCTACACGATACTATCGGAGCGGCTGTCTCCACAAGT
rpp30_F_112_ATGAACGGAA	AATGATACGGCGACCACCGAGATCTACACATGAACGGAAGAGCGGCTGTCTCCACAAGT
rpp30_F_113_ACCGCATAGA	AATGATACGGCGACCACCGAGATCTACACACCGCATAGAGAGCGGCTGTCTCCACAAGT
rpp30_F_114_GTAAGGAGTA	AATGATACGGCGACCACCGAGATCTACACGTAAGGAGTAGAGCGGCTGTCTCCACAAGT
rpp30_F_115_CAAGAACTAG	AATGATACGGCGACCACCGAGATCTACACCAAGAACTAGGAGCGGCTGTCTCCACAAGT
rpp30_F_116_ATATGACGGA	AATGATACGGCGACCACCGAGATCTACACATATGACGGAGAGCGGCTGTCTCCACAAGT
rpp30_F_117_TGTTAGTACG	AATGATACGGCGACCACCGAGATCTACACTGTTAGTACGGAGCGGCTGTCTCCACAAGT
rpp30_F_118_GCGCAATTAA	AATGATACGGCGACCACCGAGATCTACACGCGCAATTAAGAGCGGCTGTCTCCACAAGT
rpp30_F_119_GTCATTCACG	AATGATACGGCGACCACCGAGATCTACACGTCATTCACGGAGCGGCTGTCTCCACAAGT
rpp30_F_120_GAGCACTCTT	AATGATACGGCGACCACCGAGATCTACACGAGCACTCTTGAGCGGCTGTCTCCACAAGT
rpp30_F_121_AACATTCGGA	AATGATACGGCGACCACCGAGATCTACACAACATTCGGAGAGCGGCTGTCTCCACAAGT
rpp30_F_122_GTATAGCTCT	AATGATACGGCGACCACCGAGATCTACACGTATAGCTCTGAGCGGCTGTCTCCACAAGT
rpp30_F_123_GAACCTGTCG	AATGATACGGCGACCACCGAGATCTACACGAACCTGTCGGAGCGGCTGTCTCCACAAGT
rpp30_F_124_CAACTGGTAA	AATGATACGGCGACCACCGAGATCTACACCAACTGGTAAGAGCGGCTGTCTCCACAAGT
rpp30_F_125_GGAATGATCT	AATGATACGGCGACCACCGAGATCTACACGGAATGATCTGAGCGGCTGTCTCCACAAGT
rpp30_F_126_ACGAGTTGCG	AATGATACGGCGACCACCGAGATCTACACACGAGTTGCGGAGCGGCTGTCTCCACAAGT
rpp30_F_127_CTGTTAAGCG	AATGATACGGCGACCACCGAGATCTACACCTGTTAAGCGGAGCGGCTGTCTCCACAAGT
rpp30_F_128_ACATGGTCTT	AATGATACGGCGACCACCGAGATCTACACACATGGTCTTGAGCGGCTGTCTCCACAAGT
rpp30_F_129_AGTGCCAACG	AATGATACGGCGACCACCGAGATCTACACAGTGCCAACGGAGCGGCTGTCTCCACAAGT
rpp30_F_130_CCGAGTGCAA	AATGATACGGCGACCACCGAGATCTACACCCGAGTGCAAGAGCGGCTGTCTCCACAAGT
rpp30_F_131_AATGGAACGG	AATGATACGGCGACCACCGAGATCTACACAATGGAACGGGAGCGGCTGTCTCCACAAGT
rpp30_F_132_TAGATCGCAA	AATGATACGGCGACCACCGAGATCTACACTAGATCGCAAGAGCGGCTGTCTCCACAAGT
rpp30_F_133_AACATAACGG	AATGATACGGCGACCACCGAGATCTACACAACATAACGGGAGCGGCTGTCTCCACAAGT
rpp30_F_134_GCTAATACCG	AATGATACGGCGACCACCGAGATCTACACGCTAATACCGGAGCGGCTGTCTCCACAAGT
rpp30_F_135_ATGTTCTGAG	AATGATACGGCGACCACCGAGATCTACACATGTTCTGAGGAGCGGCTGTCTCCACAAGT
rpp30_F_136_ACCATATCGA	AATGATACGGCGACCACCGAGATCTACACACCATATCGAGAGCGGCTGTCTCCACAAGT
rpp30_F_137_GAACTACACG	AATGATACGGCGACCACCGAGATCTACACGAACTACACGGAGCGGCTGTCTCCACAAGT
rpp30_F_138_AGTTAGATCG	AATGATACGGCGACCACCGAGATCTACACAGTTAGATCGGAGCGGCTGTCTCCACAAGT
rpp30_F_139_CCAACTAACG	AATGATACGGCGACCACCGAGATCTACACCCAACTAACGGAGCGGCTGTCTCCACAAGT
rpp30_F_140_AGTGTTCTCT	AATGATACGGCGACCACCGAGATCTACACAGTGTTCTCTGAGCGGCTGTCTCCACAAGT
rpp30_F_141_TCTAGTCGGA	AATGATACGGCGACCACCGAGATCTACACTCTAGTCGGAGAGCGGCTGTCTCCACAAGT
rpp30_F_142_ATCCTGATCT	AATGATACGGCGACCACCGAGATCTACACATCCTGATCTGAGCGGCTGTCTCCACAAGT
rpp30_F_143_CAGACTGAGA	AATGATACGGCGACCACCGAGATCTACACCAGACTGAGAGAGCGGCTGTCTCCACAAGT
rpp30_F_144_CCAGGAGTGT	AATGATACGGCGACCACCGAGATCTACACCCAGGAGTGTGAGCGGCTGTCTCCACAAGT
rpp30_F_145_ACTGGTTGTA	AATGATACGGCGACCACCGAGATCTACACACTGGTTGTAGAGCGGCTGTCTCCACAAGT
rpp30_F_146_GGATCATTGG	AATGATACGGCGACCACCGAGATCTACACGGATCATTGGGAGCGGCTGTCTCCACAAGT
rpp30_F_147_ACTGTGGCCT	AATGATACGGCGACCACCGAGATCTACACACTGTGGCCTGAGCGGCTGTCTCCACAAGT
rpp30_F_148_TTGGATTGGT	AATGATACGGCGACCACCGAGATCTACACTTGGATTGGTGAGCGGCTGTCTCCACAAGT
rpp30_F_149_GTGATCTGGA	AATGATACGGCGACCACCGAGATCTACACGTGATCTGGAGAGCGGCTGTCTCCACAAGT
rpp30_F_150_AGGAACATCG	AATGATACGGCGACCACCGAGATCTACACAGGAACATCGGAGCGGCTGTCTCCACAAGT
rpp30_F_151_GCTTCATGTA	AATGATACGGCGACCACCGAGATCTACACGCTTCATGTAGAGCGGCTGTCTCCACAAGT
rpp30_F_152_GCATAAGGTT	AATGATACGGCGACCACCGAGATCTACACGCATAAGGTTGAGCGGCTGTCTCCACAAGT
rpp30_F_153_ATCACTTGCG	AATGATACGGCGACCACCGAGATCTACACATCACTTGCGGAGCGGCTGTCTCCACAAGT
rpp30_F_154_CTCCTATACG	AATGATACGGCGACCACCGAGATCTACACCTCCTATACGGAGCGGCTGTCTCCACAAGT
rpp30_F_155_CTGGATCAGA	AATGATACGGCGACCACCGAGATCTACACCTGGATCAGAGAGCGGCTGTCTCCACAAGT
rpp30_F_156_CGGATCTTGC	AATGATACGGCGACCACCGAGATCTACACCGGATCTTGCGAGCGGCTGTCTCCACAAGT
rpp30_F_157_AACTGTCCGG	AATGATACGGCGACCACCGAGATCTACACAACTGTCCGGGAGCGGCTGTCTCCACAAGT
rpp30_F_158_ACTTAAGTCG	AATGATACGGCGACCACCGAGATCTACACACTTAAGTCGGAGCGGCTGTCTCCACAAGT
rpp30_F_159_ATGTTGCGGA	AATGATACGGCGACCACCGAGATCTACACATGTTGCGGAGAGCGGCTGTCTCCACAAGT
rpp30_F_160_ATGAGACTTG	AATGATACGGCGACCACCGAGATCTACACATGAGACTTGGAGCGGCTGTCTCCACAAGT
rpp30_F_161_TACCTGCGTG	AATGATACGGCGACCACCGAGATCTACACTACCTGCGTGGAGCGGCTGTCTCCACAAGT
rpp30_F_162_GGCTGTCATA	AATGATACGGCGACCACCGAGATCTACACGGCTGTCATAGAGCGGCTGTCTCCACAAGT
rpp30_F_163_CAGTGTATCT	AATGATACGGCGACCACCGAGATCTACACCAGTGTATCTGAGCGGCTGTCTCCACAAGT
rpp30_F_164_GTGCTATGTA	AATGATACGGCGACCACCGAGATCTACACGTGCTATGTAGAGCGGCTGTCTCCACAAGT
rpp30_F_165_GTATAGAGAG	AATGATACGGCGACCACCGAGATCTACACGTATAGAGAGGAGCGGCTGTCTCCACAAGT
rpp30_F_166_CACGGTATCA	AATGATACGGCGACCACCGAGATCTACACCACGGTATCAGAGCGGCTGTCTCCACAAGT
rpp30_F_167_CGGATAATGG	AATGATACGGCGACCACCGAGATCTACACCGGATAATGGGAGCGGCTGTCTCCACAAGT
rpp30_F_168_CAATACGGAA	AATGATACGGCGACCACCGAGATCTACACCAATACGGAAGAGCGGCTGTCTCCACAAGT
rpp30_F_169_TGCATGTAGG	AATGATACGGCGACCACCGAGATCTACACTGCATGTAGGGAGCGGCTGTCTCCACAAGT
rpp30_F_170_CGGACTAGAA	AATGATACGGCGACCACCGAGATCTACACCGGACTAGAAGAGCGGCTGTCTCCACAAGT
rpp30_F_171_AACCTTCACG	AATGATACGGCGACCACCGAGATCTACACAACCTTCACGGAGCGGCTGTCTCCACAAGT
rpp30_F_172_AGAGCGATCG	AATGATACGGCGACCACCGAGATCTACACAGAGCGATCGGAGCGGCTGTCTCCACAAGT
rpp30_F_173_GATAAGTGCG	AATGATACGGCGACCACCGAGATCTACACGATAAGTGCGGAGCGGCTGTCTCCACAAGT
rpp30_F_174_TCAAGCAACG	AATGATACGGCGACCACCGAGATCTACACTCAAGCAACGGAGCGGCTGTCTCCACAAGT
rpp30_F_175_ACTCTGTTGA	AATGATACGGCGACCACCGAGATCTACACACTCTGTTGAGAGCGGCTGTCTCCACAAGT
rpp30_F_176_CGGTACCACA	AATGATACGGCGACCACCGAGATCTACACCGGTACCACAGAGCGGCTGTCTCCACAAGT
rpp30_F_177_TGATGTCTGT	AATGATACGGCGACCACCGAGATCTACACTGATGTCTGTGAGCGGCTGTCTCCACAAGT
rpp30_F_178_GGATCATGCT	AATGATACGGCGACCACCGAGATCTACACGGATCATGCTGAGCGGCTGTCTCCACAAGT
rpp30_F_179_GTAGAGTAAG	AATGATACGGCGACCACCGAGATCTACACGTAGAGTAAGGAGCGGCTGTCTCCACAAGT
rpp30_F_180_AACGGCTTGG	AATGATACGGCGACCACCGAGATCTACACAACGGCTTGGGAGCGGCTGTCTCCACAAGT
rpp30_F_181_TAACTAGCGG	AATGATACGGCGACCACCGAGATCTACACTAACTAGCGGGAGCGGCTGTCTCCACAAGT
rpp30_F_182_ACGACACACG	AATGATACGGCGACCACCGAGATCTACACACGACACACGGAGCGGCTGTCTCCACAAGT
rpp30_F_183_ATATCACCGT	AATGATACGGCGACCACCGAGATCTACACATATCACCGTGAGCGGCTGTCTCCACAAGT
rpp30_F_184_ACGATCTAGC	AATGATACGGCGACCACCGAGATCTACACACGATCTAGCGAGCGGCTGTCTCCACAAGT
rpp30_F_185_CTGTGGCGAA	AATGATACGGCGACCACCGAGATCTACACCTGTGGCGAAGAGCGGCTGTCTCCACAAGT
rpp30_F_186_ATAGCTCTCT	AATGATACGGCGACCACCGAGATCTACACATAGCTCTCTGAGCGGCTGTCTCCACAAGT
rpp30_F_187_GAGTTGTGCC	AATGATACGGCGACCACCGAGATCTACACGAGTTGTGCCGAGCGGCTGTCTCCACAAGT
rpp30_F_188_GCGAAGACTT	AATGATACGGCGACCACCGAGATCTACACGCGAAGACTTGAGCGGCTGTCTCCACAAGT
rpp30_F_189_GAAGATGCGT	AATGATACGGCGACCACCGAGATCTACACGAAGATGCGTGAGCGGCTGTCTCCACAAGT
rpp30_F_190_CATGTTGTCG	AATGATACGGCGACCACCGAGATCTACACCATGTTGTCGGAGCGGCTGTCTCCACAAGT
rpp30_F_191_GCTTCGTTGA	AATGATACGGCGACCACCGAGATCTACACGCTTCGTTGAGAGCGGCTGTCTCCACAAGT
rpp30_F_192_CGAGGAGATT	AATGATACGGCGACCACCGAGATCTACACCGAGGAGATTGAGCGGCTGTCTCCACAAGT
rpp30_F_193_TGGTCTATCG	AATGATACGGCGACCACCGAGATCTACACTGGTCTATCGGAGCGGCTGTCTCCACAAGT
rpp30_F_194_TGCTGTCCGA	AATGATACGGCGACCACCGAGATCTACACTGCTGTCCGAGAGCGGCTGTCTCCACAAGT
rpp30_F_195_CCGTGTTACG	AATGATACGGCGACCACCGAGATCTACACCCGTGTTACGGAGCGGCTGTCTCCACAAGT
rpp30_F_196_TGCAAGATTG	AATGATACGGCGACCACCGAGATCTACACTGCAAGATTGGAGCGGCTGTCTCCACAAGT
rpp30_F_197_AGATCGGCCA	AATGATACGGCGACCACCGAGATCTACACAGATCGGCCAGAGCGGCTGTCTCCACAAGT
rpp30_F_198_GTAATGGCCA	AATGATACGGCGACCACCGAGATCTACACGTAATGGCCAGAGCGGCTGTCTCCACAAGT
rpp30_F_199_GTGGTTCATT	AATGATACGGCGACCACCGAGATCTACACGTGGTTCATTGAGCGGCTGTCTCCACAAGT
rpp30_F_200_TCTCATCACG	AATGATACGGCGACCACCGAGATCTACACTCTCATCACGGAGCGGCTGTCTCCACAAGT
rpp30_F_201_GAGACCTCTG	AATGATACGGCGACCACCGAGATCTACACGAGACCTCTGGAGCGGCTGTCTCCACAAGT
rpp30_F_202_ACACAGCGTA	AATGATACGGCGACCACCGAGATCTACACACACAGCGTAGAGCGGCTGTCTCCACAAGT
rpp30_F_203_GTGGCCTTAG	AATGATACGGCGACCACCGAGATCTACACGTGGCCTTAGGAGCGGCTGTCTCCACAAGT
rpp30_F_204_AGACGGATAG	AATGATACGGCGACCACCGAGATCTACACAGACGGATAGGAGCGGCTGTCTCCACAAGT
rpp30_F_205_GTGAGATTCA	AATGATACGGCGACCACCGAGATCTACACGTGAGATTCAGAGCGGCTGTCTCCACAAGT
rpp30_F_206_CTGGAACCAA	AATGATACGGCGACCACCGAGATCTACACCTGGAACCAAGAGCGGCTGTCTCCACAAGT
rpp30_F_207_AGGTACGTTG	AATGATACGGCGACCACCGAGATCTACACAGGTACGTTGGAGCGGCTGTCTCCACAAGT
rpp30_F_208_ACCAACGTCG	AATGATACGGCGACCACCGAGATCTACACACCAACGTCGGAGCGGCTGTCTCCACAAGT
rpp30_F_209_AGGCCACATC	AATGATACGGCGACCACCGAGATCTACACAGGCCACATCGAGCGGCTGTCTCCACAAGT
rpp30_F_210_ACATCATCCG	AATGATACGGCGACCACCGAGATCTACACACATCATCCGGAGCGGCTGTCTCCACAAGT
rpp30_F_211_TACCGTAGGA	AATGATACGGCGACCACCGAGATCTACACTACCGTAGGAGAGCGGCTGTCTCCACAAGT
rpp30_F_212_ACCAGGCTTA	AATGATACGGCGACCACCGAGATCTACACACCAGGCTTAGAGCGGCTGTCTCCACAAGT
rpp30_F_213_GGCATATAAG	AATGATACGGCGACCACCGAGATCTACACGGCATATAAGGAGCGGCTGTCTCCACAAGT
rpp30_F_214_GGCTACGAAG	AATGATACGGCGACCACCGAGATCTACACGGCTACGAAGGAGCGGCTGTCTCCACAAGT
rpp30_F_215_ACATTGTTCG	AATGATACGGCGACCACCGAGATCTACACACATTGTTCGGAGCGGCTGTCTCCACAAGT
rpp30_F_216_CTACTAACGG	AATGATACGGCGACCACCGAGATCTACACCTACTAACGGGAGCGGCTGTCTCCACAAGT
rpp30_F_217_TACATGGCGG	AATGATACGGCGACCACCGAGATCTACACTACATGGCGGGAGCGGCTGTCTCCACAAGT
rpp30_F_218_CAACACTTCG	AATGATACGGCGACCACCGAGATCTACACCAACACTTCGGAGCGGCTGTCTCCACAAGT
rpp30_F_219_ACTCACTACG	AATGATACGGCGACCACCGAGATCTACACACTCACTACGGAGCGGCTGTCTCCACAAGT
rpp30_F_220_GTGAGCACTG	AATGATACGGCGACCACCGAGATCTACACGTGAGCACTGGAGCGGCTGTCTCCACAAGT
rpp30_F_221_CAGATCACAG	AATGATACGGCGACCACCGAGATCTACACCAGATCACAGGAGCGGCTGTCTCCACAAGT
rpp30_F_222_AGACATTGGT	AATGATACGGCGACCACCGAGATCTACACAGACATTGGTGAGCGGCTGTCTCCACAAGT
rpp30_F_223_TTCCAGATCG	AATGATACGGCGACCACCGAGATCTACACTTCCAGATCGGAGCGGCTGTCTCCACAAGT
rpp30_F_224_GCGATCTCCA	AATGATACGGCGACCACCGAGATCTACACGCGATCTCCAGAGCGGCTGTCTCCACAAGT
rpp30_F_225_GGAACTCTGG	AATGATACGGCGACCACCGAGATCTACACGGAACTCTGGGAGCGGCTGTCTCCACAAGT
rpp30_F_226_GTACTGCGTA	AATGATACGGCGACCACCGAGATCTACACGTACTGCGTAGAGCGGCTGTCTCCACAAGT
rpp30_F_227_TCAAGCGGTA	AATGATACGGCGACCACCGAGATCTACACTCAAGCGGTAGAGCGGCTGTCTCCACAAGT
rpp30_F_228_TCTGATCCGG	AATGATACGGCGACCACCGAGATCTACACTCTGATCCGGGAGCGGCTGTCTCCACAAGT
rpp30_F_229_CAGTGAACGG	AATGATACGGCGACCACCGAGATCTACACCAGTGAACGGGAGCGGCTGTCTCCACAAGT
rpp30_F_230_TGCTAAGCGG	AATGATACGGCGACCACCGAGATCTACACTGCTAAGCGGGAGCGGCTGTCTCCACAAGT
rpp30_F_231_GTGCCTACCT	AATGATACGGCGACCACCGAGATCTACACGTGCCTACCTGAGCGGCTGTCTCCACAAGT
rpp30_F_232_CATGTCGTGA	AATGATACGGCGACCACCGAGATCTACACCATGTCGTGAGAGCGGCTGTCTCCACAAGT
rpp30_F_233_GGCACAACTA	AATGATACGGCGACCACCGAGATCTACACGGCACAACTAGAGCGGCTGTCTCCACAAGT
rpp30_F_234_TGGCCATATA	AATGATACGGCGACCACCGAGATCTACACTGGCCATATAGAGCGGCTGTCTCCACAAGT
rpp30_F_235_GAAGTGGCCT	AATGATACGGCGACCACCGAGATCTACACGAAGTGGCCTGAGCGGCTGTCTCCACAAGT
rpp30_F_236_AGCAGTAGAG	AATGATACGGCGACCACCGAGATCTACACAGCAGTAGAGGAGCGGCTGTCTCCACAAGT
rpp30_F_237_AACGGTCAAT	AATGATACGGCGACCACCGAGATCTACACAACGGTCAATGAGCGGCTGTCTCCACAAGT
rpp30_F_238_CACGCATACG	AATGATACGGCGACCACCGAGATCTACACCACGCATACGGAGCGGCTGTCTCCACAAGT
rpp30_F_239_GGCTAATCCT	AATGATACGGCGACCACCGAGATCTACACGGCTAATCCTGAGCGGCTGTCTCCACAAGT
rpp30_F_240_GACTTCGACG	AATGATACGGCGACCACCGAGATCTACACGACTTCGACGGAGCGGCTGTCTCCACAAGT
rpp30_F_241_CAGTAGAGTT	AATGATACGGCGACCACCGAGATCTACACCAGTAGAGTTGAGCGGCTGTCTCCACAAGT
rpp30_F_242_GAGAGTAGAA	AATGATACGGCGACCACCGAGATCTACACGAGAGTAGAAGAGCGGCTGTCTCCACAAGT
rpp30_F_243_GGACGAATTG	AATGATACGGCGACCACCGAGATCTACACGGACGAATTGGAGCGGCTGTCTCCACAAGT
rpp30_F_244_GGAGTAACTG	AATGATACGGCGACCACCGAGATCTACACGGAGTAACTGGAGCGGCTGTCTCCACAAGT
rpp30_F_245_GGATACCTTG	AATGATACGGCGACCACCGAGATCTACACGGATACCTTGGAGCGGCTGTCTCCACAAGT
rpp30_F_246_GGCTAGACTG	AATGATACGGCGACCACCGAGATCTACACGGCTAGACTGGAGCGGCTGTCTCCACAAGT
rpp30_F_247_GAGCAATAGA	AATGATACGGCGACCACCGAGATCTACACGAGCAATAGAGAGCGGCTGTCTCCACAAGT
rpp30_F_248_AGGAATTCGG	AATGATACGGCGACCACCGAGATCTACACAGGAATTCGGGAGCGGCTGTCTCCACAAGT
rpp30_F_249_AGACCGGAGT	AATGATACGGCGACCACCGAGATCTACACAGACCGGAGTGAGCGGCTGTCTCCACAAGT
rpp30_F_250_CTTGTCTACG	AATGATACGGCGACCACCGAGATCTACACCTTGTCTACGGAGCGGCTGTCTCCACAAGT
rpp30_F_251_TGAGCTTCCG	AATGATACGGCGACCACCGAGATCTACACTGAGCTTCCGGAGCGGCTGTCTCCACAAGT
rpp30_F_252_GGATAGAGCT	AATGATACGGCGACCACCGAGATCTACACGGATAGAGCTGAGCGGCTGTCTCCACAAGT
rpp30_F_253_TCATCTACCG	AATGATACGGCGACCACCGAGATCTACACTCATCTACCGGAGCGGCTGTCTCCACAAGT
rpp30_F_254_TGCGAATCGA	AATGATACGGCGACCACCGAGATCTACACTGCGAATCGAGAGCGGCTGTCTCCACAAGT
rpp30_F_255_GTACAAGGTA	AATGATACGGCGACCACCGAGATCTACACGTACAAGGTAGAGCGGCTGTCTCCACAAGT
rpp30_F_256_CCAGTATGTA	AATGATACGGCGACCACCGAGATCTACACCCAGTATGTAGAGCGGCTGTCTCCACAAGT
rpp30_F_257_AGTCGTTACG	AATGATACGGCGACCACCGAGATCTACACAGTCGTTACGGAGCGGCTGTCTCCACAAGT
rpp30_F_258_AATGCAATCG	AATGATACGGCGACCACCGAGATCTACACAATGCAATCGGAGCGGCTGTCTCCACAAGT
rpp30_F_259_CTTAAGAGCG	AATGATACGGCGACCACCGAGATCTACACCTTAAGAGCGGAGCGGCTGTCTCCACAAGT
rpp30_F_260_ACGTTCATCG	AATGATACGGCGACCACCGAGATCTACACACGTTCATCGGAGCGGCTGTCTCCACAAGT
rpp30_F_261_CCATCGGATT	AATGATACGGCGACCACCGAGATCTACACCCATCGGATTGAGCGGCTGTCTCCACAAGT
rpp30_F_262_CGATAGATAG	AATGATACGGCGACCACCGAGATCTACACCGATAGATAGGAGCGGCTGTCTCCACAAGT
rpp30_F_263_ACATACCACG	AATGATACGGCGACCACCGAGATCTACACACATACCACGGAGCGGCTGTCTCCACAAGT
rpp30_F_264_GGTCTGAGAT	AATGATACGGCGACCACCGAGATCTACACGGTCTGAGATGAGCGGCTGTCTCCACAAGT
rpp30_F_265_GAACGAGAGA	AATGATACGGCGACCACCGAGATCTACACGAACGAGAGAGAGCGGCTGTCTCCACAAGT
rpp30_F_266_CATCGATCAA	AATGATACGGCGACCACCGAGATCTACACCATCGATCAAGAGCGGCTGTCTCCACAAGT
rpp30_F_267_TCATTGAGGA	AATGATACGGCGACCACCGAGATCTACACTCATTGAGGAGAGCGGCTGTCTCCACAAGT
rpp30_F_268_GCTTCGAGAA	AATGATACGGCGACCACCGAGATCTACACGCTTCGAGAAGAGCGGCTGTCTCCACAAGT
rpp30_F_269_ATTGAATCGG	AATGATACGGCGACCACCGAGATCTACACATTGAATCGGGAGCGGCTGTCTCCACAAGT
rpp30_F_270_CAATCATCGG	AATGATACGGCGACCACCGAGATCTACACCAATCATCGGGAGCGGCTGTCTCCACAAGT
rpp30_F_271_GACCTATCGG	AATGATACGGCGACCACCGAGATCTACACGACCTATCGGGAGCGGCTGTCTCCACAAGT
rpp30_F_272_GAATCGGCAA	AATGATACGGCGACCACCGAGATCTACACGAATCGGCAAGAGCGGCTGTCTCCACAAGT
rpp30_F_273_AGGTGAGGAT	AATGATACGGCGACCACCGAGATCTACACAGGTGAGGATGAGCGGCTGTCTCCACAAGT
rpp30_F_274_CTGGTCTCTA	AATGATACGGCGACCACCGAGATCTACACCTGGTCTCTAGAGCGGCTGTCTCCACAAGT
rpp30_F_275_CGGAGAAGGT	AATGATACGGCGACCACCGAGATCTACACCGGAGAAGGTGAGCGGCTGTCTCCACAAGT
rpp30_F_276_AAGGTGACGT	AATGATACGGCGACCACCGAGATCTACACAAGGTGACGTGAGCGGCTGTCTCCACAAGT
rpp30_F_277_GACGCACAGA	AATGATACGGCGACCACCGAGATCTACACGACGCACAGAGAGCGGCTGTCTCCACAAGT
rpp30_F_278_AAGGCCTCTA	AATGATACGGCGACCACCGAGATCTACACAAGGCCTCTAGAGCGGCTGTCTCCACAAGT
rpp30_F_279_TGCCACCGTA	AATGATACGGCGACCACCGAGATCTACACTGCCACCGTAGAGCGGCTGTCTCCACAAGT
rpp30_F_280_AACGGCAAGA	AATGATACGGCGACCACCGAGATCTACACAACGGCAAGAGAGCGGCTGTCTCCACAAGT
rpp30_F_281_ATGGACTCCG	AATGATACGGCGACCACCGAGATCTACACATGGACTCCGGAGCGGCTGTCTCCACAAGT
rpp30_F_282_AAGCTTGCGT	AATGATACGGCGACCACCGAGATCTACACAAGCTTGCGTGAGCGGCTGTCTCCACAAGT
rpp30_F_283_CACGTATCGT	AATGATACGGCGACCACCGAGATCTACACCACGTATCGTGAGCGGCTGTCTCCACAAGT
rpp30_F_284_ATCGGACAAG	AATGATACGGCGACCACCGAGATCTACACATCGGACAAGGAGCGGCTGTCTCCACAAGT
rpp30_F_285_GTGACGTACC	AATGATACGGCGACCACCGAGATCTACACGTGACGTACCGAGCGGCTGTCTCCACAAGT
rpp30_F_286_ACAGTATCGG	AATGATACGGCGACCACCGAGATCTACACACAGTATCGGGAGCGGCTGTCTCCACAAGT
rpp30_F_287_CATTGAAGCG	AATGATACGGCGACCACCGAGATCTACACCATTGAAGCGGAGCGGCTGTCTCCACAAGT
rpp30_F_288_GGCAACCTGT	AATGATACGGCGACCACCGAGATCTACACGGCAACCTGTGAGCGGCTGTCTCCACAAGT
rpp30_F_289_ACTTCGTGCG	AATGATACGGCGACCACCGAGATCTACACACTTCGTGCGGAGCGGCTGTCTCCACAAGT
rpp30_F_290_CAAGTCCGTG	AATGATACGGCGACCACCGAGATCTACACCAAGTCCGTGGAGCGGCTGTCTCCACAAGT
rpp30_F_291_TACGGTTACT	AATGATACGGCGACCACCGAGATCTACACTACGGTTACTGAGCGGCTGTCTCCACAAGT
rpp30_F_292_AGGAAGCGGA	AATGATACGGCGACCACCGAGATCTACACAGGAAGCGGAGAGCGGCTGTCTCCACAAGT
rpp30_F_293_TAACCGTTCG	AATGATACGGCGACCACCGAGATCTACACTAACCGTTCGGAGCGGCTGTCTCCACAAGT
rpp30_F_294_TTCTCTCGTA	AATGATACGGCGACCACCGAGATCTACACTTCTCTCGTAGAGCGGCTGTCTCCACAAGT
rpp30_F_295_GATGAAGCGG	AATGATACGGCGACCACCGAGATCTACACGATGAAGCGGGAGCGGCTGTCTCCACAAGT
rpp30_F_296_GTGTTAGAGT	AATGATACGGCGACCACCGAGATCTACACGTGTTAGAGTGAGCGGCTGTCTCCACAAGT
rpp30_F_297_ATCAAGCGTC	AATGATACGGCGACCACCGAGATCTACACATCAAGCGTCGAGCGGCTGTCTCCACAAGT
rpp30_F_298_TGTATCGACC	AATGATACGGCGACCACCGAGATCTACACTGTATCGACCGAGCGGCTGTCTCCACAAGT
rpp30_F_299_ATCACGACCG	AATGATACGGCGACCACCGAGATCTACACATCACGACCGGAGCGGCTGTCTCCACAAGT
rpp30_F_300_TGGCGTTCGT	AATGATACGGCGACCACCGAGATCTACACTGGCGTTCGTGAGCGGCTGTCTCCACAAGT
rpp30_F_301_CGTAACGTGG	AATGATACGGCGACCACCGAGATCTACACCGTAACGTGGGAGCGGCTGTCTCCACAAGT
rpp30_F_302_AATATGGCCA	AATGATACGGCGACCACCGAGATCTACACAATATGGCCAGAGCGGCTGTCTCCACAAGT
rpp30_F_303_CCTGCTTAAG	AATGATACGGCGACCACCGAGATCTACACCCTGCTTAAGGAGCGGCTGTCTCCACAAGT
rpp30_F_304_CCTCTGAACG	AATGATACGGCGACCACCGAGATCTACACCCTCTGAACGGAGCGGCTGTCTCCACAAGT
rpp30_F_305_GCCAGATATG	AATGATACGGCGACCACCGAGATCTACACGCCAGATATGGAGCGGCTGTCTCCACAAGT
rpp30_F_306_AGTTACCGTA	AATGATACGGCGACCACCGAGATCTACACAGTTACCGTAGAGCGGCTGTCTCCACAAGT
rpp30_F_307_GCATGAACGT	AATGATACGGCGACCACCGAGATCTACACGCATGAACGTGAGCGGCTGTCTCCACAAGT
rpp30_F_308_AGTGTCTATG	AATGATACGGCGACCACCGAGATCTACACAGTGTCTATGGAGCGGCTGTCTCCACAAGT
rpp30_F_309_TTAAGTCACG	AATGATACGGCGACCACCGAGATCTACACTTAAGTCACGGAGCGGCTGTCTCCACAAGT
rpp30_F_310_TTACCTATCG	AATGATACGGCGACCACCGAGATCTACACTTACCTATCGGAGCGGCTGTCTCCACAAGT
rpp30_F_311_AACTTAGGCG	AATGATACGGCGACCACCGAGATCTACACAACTTAGGCGGAGCGGCTGTCTCCACAAGT
rpp30_F_312_CGGTTCAAGG	AATGATACGGCGACCACCGAGATCTACACCGGTTCAAGGGAGCGGCTGTCTCCACAAGT
rpp30_F_313_CATTGAGTAG	AATGATACGGCGACCACCGAGATCTACACCATTGAGTAGGAGCGGCTGTCTCCACAAGT
rpp30_F_314_GTAGAGAGGA	AATGATACGGCGACCACCGAGATCTACACGTAGAGAGGAGAGCGGCTGTCTCCACAAGT
rpp30_F_315_TGGAGGATCG	AATGATACGGCGACCACCGAGATCTACACTGGAGGATCGGAGCGGCTGTCTCCACAAGT
rpp30_F_316_AACCACGACG	AATGATACGGCGACCACCGAGATCTACACAACCACGACGGAGCGGCTGTCTCCACAAGT
rpp30_F_317_AAGCGGATTG	AATGATACGGCGACCACCGAGATCTACACAAGCGGATTGGAGCGGCTGTCTCCACAAGT
rpp30_F_318_CACGGCTATG	AATGATACGGCGACCACCGAGATCTACACCACGGCTATGGAGCGGCTGTCTCCACAAGT
rpp30_F_319_ATGGCTGTGT	AATGATACGGCGACCACCGAGATCTACACATGGCTGTGTGAGCGGCTGTCTCCACAAGT
rpp30_F_320_AGGCGGAGAT	AATGATACGGCGACCACCGAGATCTACACAGGCGGAGATGAGCGGCTGTCTCCACAAGT
rpp30_F_321_ATACGGACAT	AATGATACGGCGACCACCGAGATCTACACATACGGACATGAGCGGCTGTCTCCACAAGT
rpp30_F_322_CTGCAACAGG	AATGATACGGCGACCACCGAGATCTACACCTGCAACAGGGAGCGGCTGTCTCCACAAGT
rpp30_F_323_GTACATGACG	AATGATACGGCGACCACCGAGATCTACACGTACATGACGGAGCGGCTGTCTCCACAAGT
rpp30_F_324_CAACCGGACT	AATGATACGGCGACCACCGAGATCTACACCAACCGGACTGAGCGGCTGTCTCCACAAGT
rpp30_F_325_GGTAATGATG	AATGATACGGCGACCACCGAGATCTACACGGTAATGATGGAGCGGCTGTCTCCACAAGT
rpp30_F_326_CTGATGCAAG	AATGATACGGCGACCACCGAGATCTACACCTGATGCAAGGAGCGGCTGTCTCCACAAGT
rpp30_F_327_CATGTCTCTG	AATGATACGGCGACCACCGAGATCTACACCATGTCTCTGGAGCGGCTGTCTCCACAAGT
rpp30_F_328_TAGAGAGTAG	AATGATACGGCGACCACCGAGATCTACACTAGAGAGTAGGAGCGGCTGTCTCCACAAGT
rpp30_F_329_ATCACCGTAA	AATGATACGGCGACCACCGAGATCTACACATCACCGTAAGAGCGGCTGTCTCCACAAGT
rpp30_F_330_GGTAATGCGT	AATGATACGGCGACCACCGAGATCTACACGGTAATGCGTGAGCGGCTGTCTCCACAAGT
rpp30_F_331_GGTACATCCA	AATGATACGGCGACCACCGAGATCTACACGGTACATCCAGAGCGGCTGTCTCCACAAGT
rpp30_F_332_ATGTCGAGAG	AATGATACGGCGACCACCGAGATCTACACATGTCGAGAGGAGCGGCTGTCTCCACAAGT
rpp30_F_333_TAATCCAACG	AATGATACGGCGACCACCGAGATCTACACTAATCCAACGGAGCGGCTGTCTCCACAAGT
rpp30_F_334_CTGATCATTG	AATGATACGGCGACCACCGAGATCTACACCTGATCATTGGAGCGGCTGTCTCCACAAGT
rpp30_F_335_CAAGCTTCCT	AATGATACGGCGACCACCGAGATCTACACCAAGCTTCCTGAGCGGCTGTCTCCACAAGT
rpp30_F_336_GACTCAACCG	AATGATACGGCGACCACCGAGATCTACACGACTCAACCGGAGCGGCTGTCTCCACAAGT
rpp30_F_337_TGTGGTTCTG	AATGATACGGCGACCACCGAGATCTACACTGTGGTTCTGGAGCGGCTGTCTCCACAAGT
rpp30_F_338_ATTACCGTGG	AATGATACGGCGACCACCGAGATCTACACATTACCGTGGGAGCGGCTGTCTCCACAAGT
rpp30_F_339_GGCAATACGG	AATGATACGGCGACCACCGAGATCTACACGGCAATACGGGAGCGGCTGTCTCCACAAGT
rpp30_F_340_AATCCGATGG	AATGATACGGCGACCACCGAGATCTACACAATCCGATGGGAGCGGCTGTCTCCACAAGT
rpp30_F_341_GCCTTCATCA	AATGATACGGCGACCACCGAGATCTACACGCCTTCATCAGAGCGGCTGTCTCCACAAGT
rpp30_F_342_CCTGCATCGA	AATGATACGGCGACCACCGAGATCTACACCCTGCATCGAGAGCGGCTGTCTCCACAAGT
rpp30_F_343_AGGTAGGACG	AATGATACGGCGACCACCGAGATCTACACAGGTAGGACGGAGCGGCTGTCTCCACAAGT
rpp30_F_344_GTGCTACTAT	AATGATACGGCGACCACCGAGATCTACACGTGCTACTATGAGCGGCTGTCTCCACAAGT
rpp30_F_345_CAGGTGCTCT	AATGATACGGCGACCACCGAGATCTACACCAGGTGCTCTGAGCGGCTGTCTCCACAAGT
rpp30_F_346_GCGTTGCGAA	AATGATACGGCGACCACCGAGATCTACACGCGTTGCGAAGAGCGGCTGTCTCCACAAGT
rpp30_F_347_CACTCCGTTG	AATGATACGGCGACCACCGAGATCTACACCACTCCGTTGGAGCGGCTGTCTCCACAAGT
rpp30_F_348_CTGGAGTATG	AATGATACGGCGACCACCGAGATCTACACCTGGAGTATGGAGCGGCTGTCTCCACAAGT
rpp30_F_349_AAGCAGTGTT	AATGATACGGCGACCACCGAGATCTACACAAGCAGTGTTGAGCGGCTGTCTCCACAAGT
rpp30_F_350_ACGGTACATG	AATGATACGGCGACCACCGAGATCTACACACGGTACATGGAGCGGCTGTCTCCACAAGT
rpp30_F_351_ACGGTCCTAT	AATGATACGGCGACCACCGAGATCTACACACGGTCCTATGAGCGGCTGTCTCCACAAGT
rpp30_F_352_TCTTCTAGAG	AATGATACGGCGACCACCGAGATCTACACTCTTCTAGAGGAGCGGCTGTCTCCACAAGT
rpp30_F_353_TAAGAATCGG	AATGATACGGCGACCACCGAGATCTACACTAAGAATCGGGAGCGGCTGTCTCCACAAGT
rpp30_F_354_CTACGAGGTT	AATGATACGGCGACCACCGAGATCTACACCTACGAGGTTGAGCGGCTGTCTCCACAAGT
rpp30_F_355_AATCGTGAGA	AATGATACGGCGACCACCGAGATCTACACAATCGTGAGAGAGCGGCTGTCTCCACAAGT
rpp30_F_356_ATCTATACCG	AATGATACGGCGACCACCGAGATCTACACATCTATACCGGAGCGGCTGTCTCCACAAGT
rpp30_F_357_ACACGGTTAA	AATGATACGGCGACCACCGAGATCTACACACACGGTTAAGAGCGGCTGTCTCCACAAGT
rpp30_F_358_AGAGCTCAGA	AATGATACGGCGACCACCGAGATCTACACAGAGCTCAGAGAGCGGCTGTCTCCACAAGT
rpp30_F_359_TAGAATAGCG	AATGATACGGCGACCACCGAGATCTACACTAGAATAGCGGAGCGGCTGTCTCCACAAGT
rpp30_F_360_TGGCCTGTTG	AATGATACGGCGACCACCGAGATCTACACTGGCCTGTTGGAGCGGCTGTCTCCACAAGT
rpp30_F_361_AGGAAGGCCT	AATGATACGGCGACCACCGAGATCTACACAGGAAGGCCTGAGCGGCTGTCTCCACAAGT
rpp30_F_362_ACACTGTGGT	AATGATACGGCGACCACCGAGATCTACACACACTGTGGTGAGCGGCTGTCTCCACAAGT
rpp30_F_363_ACAGATTCCG	AATGATACGGCGACCACCGAGATCTACACACAGATTCCGGAGCGGCTGTCTCCACAAGT
rpp30_F_364_GGCAACAGTA	AATGATACGGCGACCACCGAGATCTACACGGCAACAGTAGAGCGGCTGTCTCCACAAGT
rpp30_F_365_TTAGCAGTGT	AATGATACGGCGACCACCGAGATCTACACTTAGCAGTGTGAGCGGCTGTCTCCACAAGT
rpp30_F_366_GGACGTAGGA	AATGATACGGCGACCACCGAGATCTACACGGACGTAGGAGAGCGGCTGTCTCCACAAGT
rpp30_F_367_CTATGTACCG	AATGATACGGCGACCACCGAGATCTACACCTATGTACCGGAGCGGCTGTCTCCACAAGT
rpp30_F_368_CAGATCTACC	AATGATACGGCGACCACCGAGATCTACACCAGATCTACCGAGCGGCTGTCTCCACAAGT
rpp30_F_369_TACGAGGTAA	AATGATACGGCGACCACCGAGATCTACACTACGAGGTAAGAGCGGCTGTCTCCACAAGT
rpp30_F_370_GAGGTAACGG	AATGATACGGCGACCACCGAGATCTACACGAGGTAACGGGAGCGGCTGTCTCCACAAGT
rpp30_F_371_GCTTATACGT	AATGATACGGCGACCACCGAGATCTACACGCTTATACGTGAGCGGCTGTCTCCACAAGT
rpp30_F_372_CACATGGTCA	AATGATACGGCGACCACCGAGATCTACACCACATGGTCAGAGCGGCTGTCTCCACAAGT
rpp30_F_373_ACAGACATCG	AATGATACGGCGACCACCGAGATCTACACACAGACATCGGAGCGGCTGTCTCCACAAGT
rpp30_F_374_CGATCTACGG	AATGATACGGCGACCACCGAGATCTACACCGATCTACGGGAGCGGCTGTCTCCACAAGT
rpp30_F_375_GTATCCGCCA	AATGATACGGCGACCACCGAGATCTACACGTATCCGCCAGAGCGGCTGTCTCCACAAGT
rpp30_F_376_AGAAGGTCTG	AATGATACGGCGACCACCGAGATCTACACAGAAGGTCTGGAGCGGCTGTCTCCACAAGT
rpp30_F_377_GTCTTAACGG	AATGATACGGCGACCACCGAGATCTACACGTCTTAACGGGAGCGGCTGTCTCCACAAGT
rpp30_F_378_CCGGTAGATA	AATGATACGGCGACCACCGAGATCTACACCCGGTAGATAGAGCGGCTGTCTCCACAAGT
rpp30_F_379_AACTTGCTGG	AATGATACGGCGACCACCGAGATCTACACAACTTGCTGGGAGCGGCTGTCTCCACAAGT
rpp30_F_380_AAGGTTACCG	AATGATACGGCGACCACCGAGATCTACACAAGGTTACCGGAGCGGCTGTCTCCACAAGT
rpp30_F_381_CGTGACTATA	AATGATACGGCGACCACCGAGATCTACACCGTGACTATAGAGCGGCTGTCTCCACAAGT
rpp30_F_382_ATGCTTATCG	AATGATACGGCGACCACCGAGATCTACACATGCTTATCGGAGCGGCTGTCTCCACAAGT
rpp30_F_383_TAATGATGCG	AATGATACGGCGACCACCGAGATCTACACTAATGATGCGGAGCGGCTGTCTCCACAAGT
rpp30_F_384_CACTTGTGTT	AATGATACGGCGACCACCGAGATCTACACCACTTGTGTTGAGCGGCTGTCTCCACAAGT
rpp30_F_385_CTGTAGATGG	AATGATACGGCGACCACCGAGATCTACACCTGTAGATGGGAGCGGCTGTCTCCACAAGT
rpp30_F_386_GTATCACTGC	AATGATACGGCGACCACCGAGATCTACACGTATCACTGCGAGCGGCTGTCTCCACAAGT
rpp30_F_387_TTCCTGTAGT	AATGATACGGCGACCACCGAGATCTACACTTCCTGTAGTGAGCGGCTGTCTCCACAAGT
rpp30_F_388_GGTACACAAG	AATGATACGGCGACCACCGAGATCTACACGGTACACAAGGAGCGGCTGTCTCCACAAGT
rpp30_F_389_TTCAACCGTG	AATGATACGGCGACCACCGAGATCTACACTTCAACCGTGGAGCGGCTGTCTCCACAAGT
rpp30_F_390_ACCACTGTGA	AATGATACGGCGACCACCGAGATCTACACACCACTGTGAGAGCGGCTGTCTCCACAAGT
rpp30_F_391_CTCTGGCATG	AATGATACGGCGACCACCGAGATCTACACCTCTGGCATGGAGCGGCTGTCTCCACAAGT
rpp30_F_392_GTGATCTTAC	AATGATACGGCGACCACCGAGATCTACACGTGATCTTACGAGCGGCTGTCTCCACAAGT
rpp30_F_393_AGGATCCGAA	AATGATACGGCGACCACCGAGATCTACACAGGATCCGAAGAGCGGCTGTCTCCACAAGT
rpp30_F_394_GGCCTACACA	AATGATACGGCGACCACCGAGATCTACACGGCCTACACAGAGCGGCTGTCTCCACAAGT
rpp30_F_395_TGCGGACATT	AATGATACGGCGACCACCGAGATCTACACTGCGGACATTGAGCGGCTGTCTCCACAAGT
rpp30_F_396_ACTACTTCCG	AATGATACGGCGACCACCGAGATCTACACACTACTTCCGGAGCGGCTGTCTCCACAAGT
rpp30_F_397_ACGAAGAACG	AATGATACGGCGACCACCGAGATCTACACACGAAGAACGGAGCGGCTGTCTCCACAAGT
rpp30_F_398_ATCGACTGTT	AATGATACGGCGACCACCGAGATCTACACATCGACTGTTGAGCGGCTGTCTCCACAAGT
rpp30_F_399_CCATATATCG	AATGATACGGCGACCACCGAGATCTACACCCATATATCGGAGCGGCTGTCTCCACAAGT
rpp30_F_400_ACCGGATGAA	AATGATACGGCGACCACCGAGATCTACACACCGGATGAAGAGCGGCTGTCTCCACAAGT
rpp30_F_401_CGTTGTCGAG	AATGATACGGCGACCACCGAGATCTACACCGTTGTCGAGGAGCGGCTGTCTCCACAAGT
rpp30_F_402_GCGCCTGTTA	AATGATACGGCGACCACCGAGATCTACACGCGCCTGTTAGAGCGGCTGTCTCCACAAGT
rpp30_F_403_ACTATTAGCG	AATGATACGGCGACCACCGAGATCTACACACTATTAGCGGAGCGGCTGTCTCCACAAGT
rpp30_F_404_GACTGTAGCG	AATGATACGGCGACCACCGAGATCTACACGACTGTAGCGGAGCGGCTGTCTCCACAAGT
rpp30_F_405_GATATGAACG	AATGATACGGCGACCACCGAGATCTACACGATATGAACGGAGCGGCTGTCTCCACAAGT
rpp30_F_406_GCAATCATAC	AATGATACGGCGACCACCGAGATCTACACGCAATCATACGAGCGGCTGTCTCCACAAGT
rpp30_F_407_ACTATCTCTG	AATGATACGGCGACCACCGAGATCTACACACTATCTCTGGAGCGGCTGTCTCCACAAGT
rpp30_F_408_GTTCTGGATG	AATGATACGGCGACCACCGAGATCTACACGTTCTGGATGGAGCGGCTGTCTCCACAAGT
rpp30_F_409_TCCGGCAATG	AATGATACGGCGACCACCGAGATCTACACTCCGGCAATGGAGCGGCTGTCTCCACAAGT
rpp30_F_410_TGAGCGTGTT	AATGATACGGCGACCACCGAGATCTACACTGAGCGTGTTGAGCGGCTGTCTCCACAAGT
rpp30_F_411_GGTAGTATTG	AATGATACGGCGACCACCGAGATCTACACGGTAGTATTGGAGCGGCTGTCTCCACAAGT
rpp30_F_412_CGAGAACGTG	AATGATACGGCGACCACCGAGATCTACACCGAGAACGTGGAGCGGCTGTCTCCACAAGT
rpp30_F_413_ATGGTGTCGA	AATGATACGGCGACCACCGAGATCTACACATGGTGTCGAGAGCGGCTGTCTCCACAAGT
rpp30_F_414_CTGGTCAACT	AATGATACGGCGACCACCGAGATCTACACCTGGTCAACTGAGCGGCTGTCTCCACAAGT
rpp30_F_415_CAGAACCACG	AATGATACGGCGACCACCGAGATCTACACCAGAACCACGGAGCGGCTGTCTCCACAAGT
rpp30_F_416_CCATGGTGAA	AATGATACGGCGACCACCGAGATCTACACCCATGGTGAAGAGCGGCTGTCTCCACAAGT
rpp30_F_417_TGAGGATAGA	AATGATACGGCGACCACCGAGATCTACACTGAGGATAGAGAGCGGCTGTCTCCACAAGT
rpp30_F_418_GCAGTGATGA	AATGATACGGCGACCACCGAGATCTACACGCAGTGATGAGAGCGGCTGTCTCCACAAGT
rpp30_F_419_TGTCACTCCG	AATGATACGGCGACCACCGAGATCTACACTGTCACTCCGGAGCGGCTGTCTCCACAAGT
rpp30_F_420_CGTGAGATAA	AATGATACGGCGACCACCGAGATCTACACCGTGAGATAAGAGCGGCTGTCTCCACAAGT
rpp30_F_421_AGTGAGAGAG	AATGATACGGCGACCACCGAGATCTACACAGTGAGAGAGGAGCGGCTGTCTCCACAAGT
rpp30_F_422_AACGGACGGA	AATGATACGGCGACCACCGAGATCTACACAACGGACGGAGAGCGGCTGTCTCCACAAGT
rpp30_F_423_TCACCGATGG	AATGATACGGCGACCACCGAGATCTACACTCACCGATGGGAGCGGCTGTCTCCACAAGT
rpp30_F_424_GCATATTCGG	AATGATACGGCGACCACCGAGATCTACACGCATATTCGGGAGCGGCTGTCTCCACAAGT
rpp30_F_425_TTGGCGTTGG	AATGATACGGCGACCACCGAGATCTACACTTGGCGTTGGGAGCGGCTGTCTCCACAAGT
rpp30_F_426_ACGGCTATAA	AATGATACGGCGACCACCGAGATCTACACACGGCTATAAGAGCGGCTGTCTCCACAAGT
rpp30_F_427_GTTGGAGTAG	AATGATACGGCGACCACCGAGATCTACACGTTGGAGTAGGAGCGGCTGTCTCCACAAGT
rpp30_F_428_GCGGCATGAA	AATGATACGGCGACCACCGAGATCTACACGCGGCATGAAGAGCGGCTGTCTCCACAAGT
rpp30_F_429_CAATGAGATG	AATGATACGGCGACCACCGAGATCTACACCAATGAGATGGAGCGGCTGTCTCCACAAGT
rpp30_F_430_AGATCAGAGG	AATGATACGGCGACCACCGAGATCTACACAGATCAGAGGGAGCGGCTGTCTCCACAAGT
rpp30_F_431_CAACTCGTGC	AATGATACGGCGACCACCGAGATCTACACCAACTCGTGCGAGCGGCTGTCTCCACAAGT
rpp30_F_432_GTATTCCGGA	AATGATACGGCGACCACCGAGATCTACACGTATTCCGGAGAGCGGCTGTCTCCACAAGT
rpp30_F_433_TCTCAGCGTG	AATGATACGGCGACCACCGAGATCTACACTCTCAGCGTGGAGCGGCTGTCTCCACAAGT
rpp30_F_434_CCTAGCGTGA	AATGATACGGCGACCACCGAGATCTACACCCTAGCGTGAGAGCGGCTGTCTCCACAAGT
rpp30_F_435_GCGCCATCTT	AATGATACGGCGACCACCGAGATCTACACGCGCCATCTTGAGCGGCTGTCTCCACAAGT
rpp30_F_436_GTTACGATCT	AATGATACGGCGACCACCGAGATCTACACGTTACGATCTGAGCGGCTGTCTCCACAAGT
rpp30_F_437_ATGGTAGTGG	AATGATACGGCGACCACCGAGATCTACACATGGTAGTGGGAGCGGCTGTCTCCACAAGT
rpp30_F_438_TTCTCATGGT	AATGATACGGCGACCACCGAGATCTACACTTCTCATGGTGAGCGGCTGTCTCCACAAGT
rpp30_F_439_GTTCTCATCG	AATGATACGGCGACCACCGAGATCTACACGTTCTCATCGGAGCGGCTGTCTCCACAAGT
rpp30_F_440_GGATCGAGTA	AATGATACGGCGACCACCGAGATCTACACGGATCGAGTAGAGCGGCTGTCTCCACAAGT
rpp30_F_441_GCCTAATGCG	AATGATACGGCGACCACCGAGATCTACACGCCTAATGCGGAGCGGCTGTCTCCACAAGT
rpp30_F_442_GCGTTATCAG	AATGATACGGCGACCACCGAGATCTACACGCGTTATCAGGAGCGGCTGTCTCCACAAGT
rpp30_F_443_TCGATCCAGT	AATGATACGGCGACCACCGAGATCTACACTCGATCCAGTGAGCGGCTGTCTCCACAAGT
rpp30_F_444_GTTAGAGGTA	AATGATACGGCGACCACCGAGATCTACACGTTAGAGGTAGAGCGGCTGTCTCCACAAGT
rpp30_F_445_AAGCGTACGG	AATGATACGGCGACCACCGAGATCTACACAAGCGTACGGGAGCGGCTGTCTCCACAAGT
rpp30_F_446_GGTTCTGTCA	AATGATACGGCGACCACCGAGATCTACACGGTTCTGTCAGAGCGGCTGTCTCCACAAGT
rpp30_F_447_TCTATGCGCG	AATGATACGGCGACCACCGAGATCTACACTCTATGCGCGGAGCGGCTGTCTCCACAAGT
rpp30_F_448_TCTCACGAGT	AATGATACGGCGACCACCGAGATCTACACTCTCACGAGTGAGCGGCTGTCTCCACAAGT
rpp30_F_449_GAAGATCAGA	AATGATACGGCGACCACCGAGATCTACACGAAGATCAGAGAGCGGCTGTCTCCACAAGT
rpp30_F_450_GAGGTCAATG	AATGATACGGCGACCACCGAGATCTACACGAGGTCAATGGAGCGGCTGTCTCCACAAGT
rpp30_F_451_GCGCAACCTA	AATGATACGGCGACCACCGAGATCTACACGCGCAACCTAGAGCGGCTGTCTCCACAAGT
rpp30_F_452_CTAGGTTCAT	AATGATACGGCGACCACCGAGATCTACACCTAGGTTCATGAGCGGCTGTCTCCACAAGT
rpp30_F_453_GGTAAGTGAA	AATGATACGGCGACCACCGAGATCTACACGGTAAGTGAAGAGCGGCTGTCTCCACAAGT
rpp30_F_454_AAGATGTGAG	AATGATACGGCGACCACCGAGATCTACACAAGATGTGAGGAGCGGCTGTCTCCACAAGT
rpp30_F_455_CCGTGGTAGA	AATGATACGGCGACCACCGAGATCTACACCCGTGGTAGAGAGCGGCTGTCTCCACAAGT
rpp30_F_456_GGCATAGTTG	AATGATACGGCGACCACCGAGATCTACACGGCATAGTTGGAGCGGCTGTCTCCACAAGT
rpp30_F_457_ACTAGGTCTA	AATGATACGGCGACCACCGAGATCTACACACTAGGTCTAGAGCGGCTGTCTCCACAAGT
rpp30_F_458_AGATGATCGG	AATGATACGGCGACCACCGAGATCTACACAGATGATCGGGAGCGGCTGTCTCCACAAGT
rpp30_F_459_GTACGAGGAC	AATGATACGGCGACCACCGAGATCTACACGTACGAGGACGAGCGGCTGTCTCCACAAGT
rpp30_F_460_TCGACGGAAG	AATGATACGGCGACCACCGAGATCTACACTCGACGGAAGGAGCGGCTGTCTCCACAAGT
rpp30_F_461_CAAGTCGAGT	AATGATACGGCGACCACCGAGATCTACACCAAGTCGAGTGAGCGGCTGTCTCCACAAGT
rpp30_F_462_CACTTAGCGG	AATGATACGGCGACCACCGAGATCTACACCACTTAGCGGGAGCGGCTGTCTCCACAAGT
rpp30_F_463_TGGCGACACT	AATGATACGGCGACCACCGAGATCTACACTGGCGACACTGAGCGGCTGTCTCCACAAGT
rpp30_F_464_ACGGATTGGA	AATGATACGGCGACCACCGAGATCTACACACGGATTGGAGAGCGGCTGTCTCCACAAGT
rpp30_F_465_AATCTCCGAG	AATGATACGGCGACCACCGAGATCTACACAATCTCCGAGGAGCGGCTGTCTCCACAAGT
rpp30_F_466_CTCATGCTAT	AATGATACGGCGACCACCGAGATCTACACCTCATGCTATGAGCGGCTGTCTCCACAAGT
rpp30_F_467_ACGGAACTAG	AATGATACGGCGACCACCGAGATCTACACACGGAACTAGGAGCGGCTGTCTCCACAAGT
rpp30_F_468_ACGGATAGAT	AATGATACGGCGACCACCGAGATCTACACACGGATAGATGAGCGGCTGTCTCCACAAGT
rpp30_F_469_CCGGAATCAT	AATGATACGGCGACCACCGAGATCTACACCCGGAATCATGAGCGGCTGTCTCCACAAGT
rpp30_F_470_CCGGACCAAT	AATGATACGGCGACCACCGAGATCTACACCCGGACCAATGAGCGGCTGTCTCCACAAGT
rpp30_F_471_CCGGATTCTA	AATGATACGGCGACCACCGAGATCTACACCCGGATTCTAGAGCGGCTGTCTCCACAAGT
rpp30_F_472_GCGGAACAGT	AATGATACGGCGACCACCGAGATCTACACGCGGAACAGTGAGCGGCTGTCTCCACAAGT
rpp30_F_473_ATGGACCATA	AATGATACGGCGACCACCGAGATCTACACATGGACCATAGAGCGGCTGTCTCCACAAGT
rpp30_F_474_GACGGAGTGA	AATGATACGGCGACCACCGAGATCTACACGACGGAGTGAGAGCGGCTGTCTCCACAAGT
rpp30_F_475_GGAACACTCT	AATGATACGGCGACCACCGAGATCTACACGGAACACTCTGAGCGGCTGTCTCCACAAGT
rpp30_F_476_GGAAGCCTTA	AATGATACGGCGACCACCGAGATCTACACGGAAGCCTTAGAGCGGCTGTCTCCACAAGT
rpp30_F_477_GGAAGCTACT	AATGATACGGCGACCACCGAGATCTACACGGAAGCTACTGAGCGGCTGTCTCCACAAGT
rpp30_F_478_GGAATGCAAG	AATGATACGGCGACCACCGAGATCTACACGGAATGCAAGGAGCGGCTGTCTCCACAAGT
rpp30_F_479_GGACACCATT	AATGATACGGCGACCACCGAGATCTACACGGACACCATTGAGCGGCTGTCTCCACAAGT
rpp30_F_480_GGACCATACA	AATGATACGGCGACCACCGAGATCTACACGGACCATACAGAGCGGCTGTCTCCACAAGT
rpp30_F_481_GGACCTTGAA	AATGATACGGCGACCACCGAGATCTACACGGACCTTGAAGAGCGGCTGTCTCCACAAGT
rpp30_F_482_GGAGAGTTAT	AATGATACGGCGACCACCGAGATCTACACGGAGAGTTATGAGCGGCTGTCTCCACAAGT
rpp30_F_483_GGAGCTATTA	AATGATACGGCGACCACCGAGATCTACACGGAGCTATTAGAGCGGCTGTCTCCACAAGT
rpp30_F_484_GGAGTTCTCA	AATGATACGGCGACCACCGAGATCTACACGGAGTTCTCAGAGCGGCTGTCTCCACAAGT
rpp30_F_485_GGATACCAGA	AATGATACGGCGACCACCGAGATCTACACGGATACCAGAGAGCGGCTGTCTCCACAAGT
rpp30_F_486_GGATCAGCGA	AATGATACGGCGACCACCGAGATCTACACGGATCAGCGAGAGCGGCTGTCTCCACAAGT
rpp30_F_487_ATGGATGCCT	AATGATACGGCGACCACCGAGATCTACACATGGATGCCTGAGCGGCTGTCTCCACAAGT
rpp30_F_488_CGGAACTTAA	AATGATACGGCGACCACCGAGATCTACACCGGAACTTAAGAGCGGCTGTCTCCACAAGT
rpp30_F_489_CGGAAGTGAG	AATGATACGGCGACCACCGAGATCTACACCGGAAGTGAGGAGCGGCTGTCTCCACAAGT
rpp30_F_490_CGGATACTCA	AATGATACGGCGACCACCGAGATCTACACCGGATACTCAGAGCGGCTGTCTCCACAAGT
rpp30_F_491_TTCGGTACAT	AATGATACGGCGACCACCGAGATCTACACTTCGGTACATGAGCGGCTGTCTCCACAAGT
rpp30_F_492_GGTTGTTACT	AATGATACGGCGACCACCGAGATCTACACGGTTGTTACTGAGCGGCTGTCTCCACAAGT
rpp30_F_493_CTGCCTATAA	AATGATACGGCGACCACCGAGATCTACACCTGCCTATAAGAGCGGCTGTCTCCACAAGT
rpp30_F_494_AGGAATGTGA	AATGATACGGCGACCACCGAGATCTACACAGGAATGTGAGAGCGGCTGTCTCCACAAGT
rpp30_F_495_AGGTGTCCAG	AATGATACGGCGACCACCGAGATCTACACAGGTGTCCAGGAGCGGCTGTCTCCACAAGT
rpp30_F_496_ACGGAGTATT	AATGATACGGCGACCACCGAGATCTACACACGGAGTATTGAGCGGCTGTCTCCACAAGT
rpp30_F_497_TTGTGTGTTG	AATGATACGGCGACCACCGAGATCTACACTTGTGTGTTGGAGCGGCTGTCTCCACAAGT
rpp30_F_498_GCGAGTCACT	AATGATACGGCGACCACCGAGATCTACACGCGAGTCACTGAGCGGCTGTCTCCACAAGT
rpp30_F_499_ATTAGTACGG	AATGATACGGCGACCACCGAGATCTACACATTAGTACGGGAGCGGCTGTCTCCACAAGT
rpp30_F_500_CGGTTCCTAA	AATGATACGGCGACCACCGAGATCTACACCGGTTCCTAAGAGCGGCTGTCTCCACAAGT
rpp30_F_501_CTGTGTCTTC	AATGATACGGCGACCACCGAGATCTACACCTGTGTCTTCGAGCGGCTGTCTCCACAAGT
rpp30_F_502_AATAGCTACG	AATGATACGGCGACCACCGAGATCTACACAATAGCTACGGAGCGGCTGTCTCCACAAGT
rpp30_F_503_CGACATACCG	AATGATACGGCGACCACCGAGATCTACACCGACATACCGGAGCGGCTGTCTCCACAAGT
rpp30_F_504_GGCATGATTA	AATGATACGGCGACCACCGAGATCTACACGGCATGATTAGAGCGGCTGTCTCCACAAGT
rpp30_F_505_GTGTCATGAG	AATGATACGGCGACCACCGAGATCTACACGTGTCATGAGGAGCGGCTGTCTCCACAAGT
rpp30_F_506_GGACTGACGT	AATGATACGGCGACCACCGAGATCTACACGGACTGACGTGAGCGGCTGTCTCCACAAGT
rpp30_F_507_CCATCAGCTG	AATGATACGGCGACCACCGAGATCTACACCCATCAGCTGGAGCGGCTGTCTCCACAAGT
rpp30_F_508_TATGGCCACA	AATGATACGGCGACCACCGAGATCTACACTATGGCCACAGAGCGGCTGTCTCCACAAGT
rpp30_F_509_GTATCGCTTG	AATGATACGGCGACCACCGAGATCTACACGTATCGCTTGGAGCGGCTGTCTCCACAAGT
rpp30_F_510_AATGTTCGTC	AATGATACGGCGACCACCGAGATCTACACAATGTTCGTCGAGCGGCTGTCTCCACAAGT
rpp30_F_511_CGATTAACGT	AATGATACGGCGACCACCGAGATCTACACCGATTAACGTGAGCGGCTGTCTCCACAAGT
rpp30_F_512_ACATGGAGTA	AATGATACGGCGACCACCGAGATCTACACACATGGAGTAGAGCGGCTGTCTCCACAAGT
rpp30_F_513_GGAACAACGG	AATGATACGGCGACCACCGAGATCTACACGGAACAACGGGAGCGGCTGTCTCCACAAGT
rpp30_F_514_TCTCAGAGAA	AATGATACGGCGACCACCGAGATCTACACTCTCAGAGAAGAGCGGCTGTCTCCACAAGT
rpp30_F_515_TGAAGAGCTT	AATGATACGGCGACCACCGAGATCTACACTGAAGAGCTTGAGCGGCTGTCTCCACAAGT
rpp30_F_516_GGCTCCATTA	AATGATACGGCGACCACCGAGATCTACACGGCTCCATTAGAGCGGCTGTCTCCACAAGT
rpp30_F_517_AGAATTGACG	AATGATACGGCGACCACCGAGATCTACACAGAATTGACGGAGCGGCTGTCTCCACAAGT
rpp30_F_518_CTACGACTTG	AATGATACGGCGACCACCGAGATCTACACCTACGACTTGGAGCGGCTGTCTCCACAAGT
rpp30_F_519_GGAACAGATT	AATGATACGGCGACCACCGAGATCTACACGGAACAGATTGAGCGGCTGTCTCCACAAGT
rpp30_F_520_GGTATTCACT	AATGATACGGCGACCACCGAGATCTACACGGTATTCACTGAGCGGCTGTCTCCACAAGT
rpp30_F_521_GTCAATGGTT	AATGATACGGCGACCACCGAGATCTACACGTCAATGGTTGAGCGGCTGTCTCCACAAGT
rpp30_F_522_CGGAGCGATT	AATGATACGGCGACCACCGAGATCTACACCGGAGCGATTGAGCGGCTGTCTCCACAAGT
rpp30_F_523_GACGCGACAT	AATGATACGGCGACCACCGAGATCTACACGACGCGACATGAGCGGCTGTCTCCACAAGT
rpp30_F_524_CTATCCTTCG	AATGATACGGCGACCACCGAGATCTACACCTATCCTTCGGAGCGGCTGTCTCCACAAGT
rpp30_F_525_GTCGTTCTAC	AATGATACGGCGACCACCGAGATCTACACGTCGTTCTACGAGCGGCTGTCTCCACAAGT
rpp30_F_526_TATGAGATCG	AATGATACGGCGACCACCGAGATCTACACTATGAGATCGGAGCGGCTGTCTCCACAAGT
rpp30_F_527_GGAGCTCAAG	AATGATACGGCGACCACCGAGATCTACACGGAGCTCAAGGAGCGGCTGTCTCCACAAGT
rpp30_F_528_GGAGTGCCTA	AATGATACGGCGACCACCGAGATCTACACGGAGTGCCTAGAGCGGCTGTCTCCACAAGT
rpp30_F_529_CTTGGAACCG	AATGATACGGCGACCACCGAGATCTACACCTTGGAACCGGAGCGGCTGTCTCCACAAGT
rpp30_F_530_AGTGTCGACT	AATGATACGGCGACCACCGAGATCTACACAGTGTCGACTGAGCGGCTGTCTCCACAAGT
rpp30_F_531_GAAGTTGATG	AATGATACGGCGACCACCGAGATCTACACGAAGTTGATGGAGCGGCTGTCTCCACAAGT
rpp30_F_532_TGAACAATCG	AATGATACGGCGACCACCGAGATCTACACTGAACAATCGGAGCGGCTGTCTCCACAAGT
rpp30_F_533_CGATGAGGTA	AATGATACGGCGACCACCGAGATCTACACCGATGAGGTAGAGCGGCTGTCTCCACAAGT
rpp30_F_534_AGTGGCGAAG	AATGATACGGCGACCACCGAGATCTACACAGTGGCGAAGGAGCGGCTGTCTCCACAAGT
rpp30_F_535_GATCAACGTA	AATGATACGGCGACCACCGAGATCTACACGATCAACGTAGAGCGGCTGTCTCCACAAGT
rpp30_F_536_GGTTAGGAAT	AATGATACGGCGACCACCGAGATCTACACGGTTAGGAATGAGCGGCTGTCTCCACAAGT
rpp30_F_537_GAAGCTTGTA	AATGATACGGCGACCACCGAGATCTACACGAAGCTTGTAGAGCGGCTGTCTCCACAAGT
rpp30_F_538_CACGGTCTGT	AATGATACGGCGACCACCGAGATCTACACCACGGTCTGTGAGCGGCTGTCTCCACAAGT
rpp30_F_539_CGTCAGTGGT	AATGATACGGCGACCACCGAGATCTACACCGTCAGTGGTGAGCGGCTGTCTCCACAAGT
rpp30_F_540_GATAACCGGA	AATGATACGGCGACCACCGAGATCTACACGATAACCGGAGAGCGGCTGTCTCCACAAGT
rpp30_F_541_GCGATAACCG	AATGATACGGCGACCACCGAGATCTACACGCGATAACCGGAGCGGCTGTCTCCACAAGT
rpp30_F_542_AGCGTCCAAG	AATGATACGGCGACCACCGAGATCTACACAGCGTCCAAGGAGCGGCTGTCTCCACAAGT
rpp30_F_543_GCCATCTACG	AATGATACGGCGACCACCGAGATCTACACGCCATCTACGGAGCGGCTGTCTCCACAAGT
rpp30_F_544_GTCAGTTGGA	AATGATACGGCGACCACCGAGATCTACACGTCAGTTGGAGAGCGGCTGTCTCCACAAGT
rpp30_F_545_GTATGATCAG	AATGATACGGCGACCACCGAGATCTACACGTATGATCAGGAGCGGCTGTCTCCACAAGT
rpp30_F_546_CCAACTGGTT	AATGATACGGCGACCACCGAGATCTACACCCAACTGGTTGAGCGGCTGTCTCCACAAGT
rpp30_F_547_GTTGTTCAGA	AATGATACGGCGACCACCGAGATCTACACGTTGTTCAGAGAGCGGCTGTCTCCACAAGT
rpp30_F_548_CCACTATTGG	AATGATACGGCGACCACCGAGATCTACACCCACTATTGGGAGCGGCTGTCTCCACAAGT
rpp30_F_549_GATTATGTCG	AATGATACGGCGACCACCGAGATCTACACGATTATGTCGGAGCGGCTGTCTCCACAAGT
rpp30_F_550_CGTAACAGTT	AATGATACGGCGACCACCGAGATCTACACCGTAACAGTTGAGCGGCTGTCTCCACAAGT
rpp30_F_551_ATCGGCTACT	AATGATACGGCGACCACCGAGATCTACACATCGGCTACTGAGCGGCTGTCTCCACAAGT
rpp30_F_552_ATCTCTAGGT	AATGATACGGCGACCACCGAGATCTACACATCTCTAGGTGAGCGGCTGTCTCCACAAGT
rpp30_F_553_ACTCGAGGTA	AATGATACGGCGACCACCGAGATCTACACACTCGAGGTAGAGCGGCTGTCTCCACAAGT
rpp30_F_554_GGACACTGAT	AATGATACGGCGACCACCGAGATCTACACGGACACTGATGAGCGGCTGTCTCCACAAGT
rpp30_F_555_CTGGTCCGAA	AATGATACGGCGACCACCGAGATCTACACCTGGTCCGAAGAGCGGCTGTCTCCACAAGT
rpp30_F_556_CCTGCGCATT	AATGATACGGCGACCACCGAGATCTACACCCTGCGCATTGAGCGGCTGTCTCCACAAGT
rpp30_F_557_AAGCTGTCTA	AATGATACGGCGACCACCGAGATCTACACAAGCTGTCTAGAGCGGCTGTCTCCACAAGT
rpp30_F_558_GTCATACGTC	AATGATACGGCGACCACCGAGATCTACACGTCATACGTCGAGCGGCTGTCTCCACAAGT
rpp30_F_559_CAACCTCAGT	AATGATACGGCGACCACCGAGATCTACACCAACCTCAGTGAGCGGCTGTCTCCACAAGT
rpp30_F_560_ACGTTCGGAA	AATGATACGGCGACCACCGAGATCTACACACGTTCGGAAGAGCGGCTGTCTCCACAAGT
rpp30_F_561_GATGTAGCTT	AATGATACGGCGACCACCGAGATCTACACGATGTAGCTTGAGCGGCTGTCTCCACAAGT
rpp30_F_562_GACCGTTAGG	AATGATACGGCGACCACCGAGATCTACACGACCGTTAGGGAGCGGCTGTCTCCACAAGT
rpp30_F_563_TACCGGCTAC	AATGATACGGCGACCACCGAGATCTACACTACCGGCTACGAGCGGCTGTCTCCACAAGT
rpp30_F_564_AGCTAATGGA	AATGATACGGCGACCACCGAGATCTACACAGCTAATGGAGAGCGGCTGTCTCCACAAGT
rpp30_F_565_GCGGTAATCA	AATGATACGGCGACCACCGAGATCTACACGCGGTAATCAGAGCGGCTGTCTCCACAAGT
rpp30_F_566_AGGAGAGGTA	AATGATACGGCGACCACCGAGATCTACACAGGAGAGGTAGAGCGGCTGTCTCCACAAGT
rpp30_F_567_ACCGATACGG	AATGATACGGCGACCACCGAGATCTACACACCGATACGGGAGCGGCTGTCTCCACAAGT
rpp30_F_568_ACATGGCCAA	AATGATACGGCGACCACCGAGATCTACACACATGGCCAAGAGCGGCTGTCTCCACAAGT
rpp30_F_569_GGTATTGTGA	AATGATACGGCGACCACCGAGATCTACACGGTATTGTGAGAGCGGCTGTCTCCACAAGT
rpp30_F_570_GTATGTGTCA	AATGATACGGCGACCACCGAGATCTACACGTATGTGTCAGAGCGGCTGTCTCCACAAGT
rpp30_F_571_CCGAGTCGAT	AATGATACGGCGACCACCGAGATCTACACCCGAGTCGATGAGCGGCTGTCTCCACAAGT
rpp30_F_572_GGAAGAATGA	AATGATACGGCGACCACCGAGATCTACACGGAAGAATGAGAGCGGCTGTCTCCACAAGT
rpp30_F_573_AAGACTTGTC	AATGATACGGCGACCACCGAGATCTACACAAGACTTGTCGAGCGGCTGTCTCCACAAGT
rpp30_F_574_AACGAAGTCG	AATGATACGGCGACCACCGAGATCTACACAACGAAGTCGGAGCGGCTGTCTCCACAAGT
rpp30_F_575_TGAACGTTGG	AATGATACGGCGACCACCGAGATCTACACTGAACGTTGGGAGCGGCTGTCTCCACAAGT
rpp30_F_576_TGGACGATAA	AATGATACGGCGACCACCGAGATCTACACTGGACGATAAGAGCGGCTGTCTCCACAAGT
rpp30_F_577_GGCTTCCTAT	AATGATACGGCGACCACCGAGATCTACACGGCTTCCTATGAGCGGCTGTCTCCACAAGT
rpp30_F_578_GACGGAAGAA	AATGATACGGCGACCACCGAGATCTACACGACGGAAGAAGAGCGGCTGTCTCCACAAGT
rpp30_F_579_TCGAATAGGA	AATGATACGGCGACCACCGAGATCTACACTCGAATAGGAGAGCGGCTGTCTCCACAAGT
rpp30_F_580_TGACGGTATA	AATGATACGGCGACCACCGAGATCTACACTGACGGTATAGAGCGGCTGTCTCCACAAGT
rpp30_F_581_GAGGCGGTAA	AATGATACGGCGACCACCGAGATCTACACGAGGCGGTAAGAGCGGCTGTCTCCACAAGT
rpp30_F_582_CGTGAGAACG	AATGATACGGCGACCACCGAGATCTACACCGTGAGAACGGAGCGGCTGTCTCCACAAGT
rpp30_F_583_CAATGGAAGC	AATGATACGGCGACCACCGAGATCTACACCAATGGAAGCGAGCGGCTGTCTCCACAAGT
rpp30_F_584_CGAGGTAGAG	AATGATACGGCGACCACCGAGATCTACACCGAGGTAGAGGAGCGGCTGTCTCCACAAGT
rpp30_F_585_CGTCGTACAT	AATGATACGGCGACCACCGAGATCTACACCGTCGTACATGAGCGGCTGTCTCCACAAGT
rpp30_F_586_AGGATCGATG	AATGATACGGCGACCACCGAGATCTACACAGGATCGATGGAGCGGCTGTCTCCACAAGT
rpp30_F_587_ATGCATCGGA	AATGATACGGCGACCACCGAGATCTACACATGCATCGGAGAGCGGCTGTCTCCACAAGT
rpp30_F_588_CGTTGGATAT	AATGATACGGCGACCACCGAGATCTACACCGTTGGATATGAGCGGCTGTCTCCACAAGT
rpp30_F_589_AGTTGTACCG	AATGATACGGCGACCACCGAGATCTACACAGTTGTACCGGAGCGGCTGTCTCCACAAGT
rpp30_F_590_CTAGGCGAGA	AATGATACGGCGACCACCGAGATCTACACCTAGGCGAGAGAGCGGCTGTCTCCACAAGT
rpp30_F_591_ACTTCGGCAT	AATGATACGGCGACCACCGAGATCTACACACTTCGGCATGAGCGGCTGTCTCCACAAGT
rpp30_F_592_GGACACACAA	AATGATACGGCGACCACCGAGATCTACACGGACACACAAGAGCGGCTGTCTCCACAAGT
rpp30_F_593_TGTGGAATGA	AATGATACGGCGACCACCGAGATCTACACTGTGGAATGAGAGCGGCTGTCTCCACAAGT
rpp30_F_594_GTACACTGGA	AATGATACGGCGACCACCGAGATCTACACGTACACTGGAGAGCGGCTGTCTCCACAAGT
rpp30_F_595_CAGACATCCT	AATGATACGGCGACCACCGAGATCTACACCAGACATCCTGAGCGGCTGTCTCCACAAGT
rpp30_F_596_GGATGTGATT	AATGATACGGCGACCACCGAGATCTACACGGATGTGATTGAGCGGCTGTCTCCACAAGT
rpp30_F_597_AGACTATGCG	AATGATACGGCGACCACCGAGATCTACACAGACTATGCGGAGCGGCTGTCTCCACAAGT
rpp30_F_598_ATGGCCTGTC	AATGATACGGCGACCACCGAGATCTACACATGGCCTGTCGAGCGGCTGTCTCCACAAGT
rpp30_F_599_CACCTTATCG	AATGATACGGCGACCACCGAGATCTACACCACCTTATCGGAGCGGCTGTCTCCACAAGT
rpp30_F_600_CAGAGTAACG	AATGATACGGCGACCACCGAGATCTACACCAGAGTAACGGAGCGGCTGTCTCCACAAGT
rpp30_F_601_AGTAGCCTAT	AATGATACGGCGACCACCGAGATCTACACAGTAGCCTATGAGCGGCTGTCTCCACAAGT
rpp30_F_602_ATGTGCTAGG	AATGATACGGCGACCACCGAGATCTACACATGTGCTAGGGAGCGGCTGTCTCCACAAGT
rpp30_F_603_AGGATGATCC	AATGATACGGCGACCACCGAGATCTACACAGGATGATCCGAGCGGCTGTCTCCACAAGT
rpp30_F_604_CCGACTAGGT	AATGATACGGCGACCACCGAGATCTACACCCGACTAGGTGAGCGGCTGTCTCCACAAGT
rpp30_F_605_GCGTCACGTT	AATGATACGGCGACCACCGAGATCTACACGCGTCACGTTGAGCGGCTGTCTCCACAAGT
rpp30_F_606_AGCGCTTCTT	AATGATACGGCGACCACCGAGATCTACACAGCGCTTCTTGAGCGGCTGTCTCCACAAGT
rpp30_F_607_ACAGCGTGAA	AATGATACGGCGACCACCGAGATCTACACACAGCGTGAAGAGCGGCTGTCTCCACAAGT
rpp30_F_608_GACGTGATCA	AATGATACGGCGACCACCGAGATCTACACGACGTGATCAGAGCGGCTGTCTCCACAAGT
rpp30_F_609_CACGACTGTA	AATGATACGGCGACCACCGAGATCTACACCACGACTGTAGAGCGGCTGTCTCCACAAGT
rpp30_F_610_CCGTGATCTT	AATGATACGGCGACCACCGAGATCTACACCCGTGATCTTGAGCGGCTGTCTCCACAAGT
rpp30_F_611_AGCAACCTTA	AATGATACGGCGACCACCGAGATCTACACAGCAACCTTAGAGCGGCTGTCTCCACAAGT
rpp30_F_612_CAGTGGTTGT	AATGATACGGCGACCACCGAGATCTACACCAGTGGTTGTGAGCGGCTGTCTCCACAAGT
rpp30_F_613_GTGCGTATTC	AATGATACGGCGACCACCGAGATCTACACGTGCGTATTCGAGCGGCTGTCTCCACAAGT
rpp30_F_614_AAGAGAATCG	AATGATACGGCGACCACCGAGATCTACACAAGAGAATCGGAGCGGCTGTCTCCACAAGT
rpp30_F_615_AATAAGGTGG	AATGATACGGCGACCACCGAGATCTACACAATAAGGTGGGAGCGGCTGTCTCCACAAGT
rpp30_F_616_GGCAATCTTG	AATGATACGGCGACCACCGAGATCTACACGGCAATCTTGGAGCGGCTGTCTCCACAAGT
rpp30_F_617_TCCTCAGTCT	AATGATACGGCGACCACCGAGATCTACACTCCTCAGTCTGAGCGGCTGTCTCCACAAGT
rpp30_F_618_GACGTTGTAA	AATGATACGGCGACCACCGAGATCTACACGACGTTGTAAGAGCGGCTGTCTCCACAAGT
rpp30_F_619_TCCGCAACCA	AATGATACGGCGACCACCGAGATCTACACTCCGCAACCAGAGCGGCTGTCTCCACAAGT
rpp30_F_620_GGCAATAACT	AATGATACGGCGACCACCGAGATCTACACGGCAATAACTGAGCGGCTGTCTCCACAAGT
rpp30_F_621_TCTAAGGACG	AATGATACGGCGACCACCGAGATCTACACTCTAAGGACGGAGCGGCTGTCTCCACAAGT
rpp30_F_622_TCTCCAGTGT	AATGATACGGCGACCACCGAGATCTACACTCTCCAGTGTGAGCGGCTGTCTCCACAAGT
rpp30_F_623_TCTTAAGCGT	AATGATACGGCGACCACCGAGATCTACACTCTTAAGCGTGAGCGGCTGTCTCCACAAGT
rpp30_F_624_TCTGAGGCCA	AATGATACGGCGACCACCGAGATCTACACTCTGAGGCCAGAGCGGCTGTCTCCACAAGT
rpp30_F_625_GCGAAGAGAG	AATGATACGGCGACCACCGAGATCTACACGCGAAGAGAGGAGCGGCTGTCTCCACAAGT
rpp30_F_626_GGAATATCCG	AATGATACGGCGACCACCGAGATCTACACGGAATATCCGGAGCGGCTGTCTCCACAAGT
rpp30_F_627_GGACACTACG	AATGATACGGCGACCACCGAGATCTACACGGACACTACGGAGCGGCTGTCTCCACAAGT
rpp30_F_628_GCGGACTAAG	AATGATACGGCGACCACCGAGATCTACACGCGGACTAAGGAGCGGCTGTCTCCACAAGT
rpp30_F_629_ACGGCCACTT	AATGATACGGCGACCACCGAGATCTACACACGGCCACTTGAGCGGCTGTCTCCACAAGT
rpp30_F_630_GCGGTTAGTA	AATGATACGGCGACCACCGAGATCTACACGCGGTTAGTAGAGCGGCTGTCTCCACAAGT
rpp30_F_631_TAGAACTCGT	AATGATACGGCGACCACCGAGATCTACACTAGAACTCGTGAGCGGCTGTCTCCACAAGT
rpp30_F_632_AACATCGGTT	AATGATACGGCGACCACCGAGATCTACACAACATCGGTTGAGCGGCTGTCTCCACAAGT
rpp30_F_633_AACGGAGAGG	AATGATACGGCGACCACCGAGATCTACACAACGGAGAGGGAGCGGCTGTCTCCACAAGT
rpp30_F_634_AAGGAGATCA	AATGATACGGCGACCACCGAGATCTACACAAGGAGATCAGAGCGGCTGTCTCCACAAGT
rpp30_F_635_AATCCTACCG	AATGATACGGCGACCACCGAGATCTACACAATCCTACCGGAGCGGCTGTCTCCACAAGT
rpp30_F_636_AATCGCGTAA	AATGATACGGCGACCACCGAGATCTACACAATCGCGTAAGAGCGGCTGTCTCCACAAGT
rpp30_F_637_AATGCGGCTA	AATGATACGGCGACCACCGAGATCTACACAATGCGGCTAGAGCGGCTGTCTCCACAAGT
rpp30_F_638_AATGTCTGGC	AATGATACGGCGACCACCGAGATCTACACAATGTCTGGCGAGCGGCTGTCTCCACAAGT
rpp30_F_639_ACAGACCGTG	AATGATACGGCGACCACCGAGATCTACACACAGACCGTGGAGCGGCTGTCTCCACAAGT
rpp30_F_640_ACATCACGTC	AATGATACGGCGACCACCGAGATCTACACACATCACGTCGAGCGGCTGTCTCCACAAGT
rpp30_F_641_ACATGAGTGG	AATGATACGGCGACCACCGAGATCTACACACATGAGTGGGAGCGGCTGTCTCCACAAGT
rpp30_F_642_ACCAAGCTGG	AATGATACGGCGACCACCGAGATCTACACACCAAGCTGGGAGCGGCTGTCTCCACAAGT
rpp30_F_643_ACCTAACCGG	AATGATACGGCGACCACCGAGATCTACACACCTAACCGGGAGCGGCTGTCTCCACAAGT
rpp30_F_644_ACGAGGTTGA	AATGATACGGCGACCACCGAGATCTACACACGAGGTTGAGAGCGGCTGTCTCCACAAGT
rpp30_F_645_ACGATTCGAC	AATGATACGGCGACCACCGAGATCTACACACGATTCGACGAGCGGCTGTCTCCACAAGT
rpp30_F_646_ACGCGCATCA	AATGATACGGCGACCACCGAGATCTACACACGCGCATCAGAGCGGCTGTCTCCACAAGT
rpp30_F_647_ACGTCCTAGA	AATGATACGGCGACCACCGAGATCTACACACGTCCTAGAGAGCGGCTGTCTCCACAAGT
rpp30_F_648_ACTTAGCGTC	AATGATACGGCGACCACCGAGATCTACACACTTAGCGTCGAGCGGCTGTCTCCACAAGT
rpp30_F_649_AGCTATATCC	AATGATACGGCGACCACCGAGATCTACACAGCTATATCCGAGCGGCTGTCTCCACAAGT
rpp30_F_650_AGGCCATGAC	AATGATACGGCGACCACCGAGATCTACACAGGCCATGACGAGCGGCTGTCTCCACAAGT
rpp30_F_651_AGTACTACGA	AATGATACGGCGACCACCGAGATCTACACAGTACTACGAGAGCGGCTGTCTCCACAAGT
rpp30_F_652_ATAGAGTGGC	AATGATACGGCGACCACCGAGATCTACACATAGAGTGGCGAGCGGCTGTCTCCACAAGT
rpp30_F_653_ATATAGGCCT	AATGATACGGCGACCACCGAGATCTACACATATAGGCCTGAGCGGCTGTCTCCACAAGT
rpp30_F_654_ATCCAAGGCG	AATGATACGGCGACCACCGAGATCTACACATCCAAGGCGGAGCGGCTGTCTCCACAAGT
rpp30_F_655_ATCGCGTACG	AATGATACGGCGACCACCGAGATCTACACATCGCGTACGGAGCGGCTGTCTCCACAAGT
rpp30_F_656_ATGTATGTCC	AATGATACGGCGACCACCGAGATCTACACATGTATGTCCGAGCGGCTGTCTCCACAAGT
rpp30_F_657_ATTGGCCATC	AATGATACGGCGACCACCGAGATCTACACATTGGCCATCGAGCGGCTGTCTCCACAAGT
rpp30_F_658_CACGACATGC	AATGATACGGCGACCACCGAGATCTACACCACGACATGCGAGCGGCTGTCTCCACAAGT
rpp30_F_659_CACGCGGATT	AATGATACGGCGACCACCGAGATCTACACCACGCGGATTGAGCGGCTGTCTCCACAAGT
rpp30_F_660_CAGATACTTG	AATGATACGGCGACCACCGAGATCTACACCAGATACTTGGAGCGGCTGTCTCCACAAGT
rpp30_F_661_CAGTTCAGGT	AATGATACGGCGACCACCGAGATCTACACCAGTTCAGGTGAGCGGCTGTCTCCACAAGT
rpp30_F_662_CCGGTAACAA	AATGATACGGCGACCACCGAGATCTACACCCGGTAACAAGAGCGGCTGTCTCCACAAGT
rpp30_F_663_CGACGTCAAT	AATGATACGGCGACCACCGAGATCTACACCGACGTCAATGAGCGGCTGTCTCCACAAGT
rpp30_F_664_CGATTCCGTA	AATGATACGGCGACCACCGAGATCTACACCGATTCCGTAGAGCGGCTGTCTCCACAAGT
rpp30_F_665_CGCAGTCAGT	AATGATACGGCGACCACCGAGATCTACACCGCAGTCAGTGAGCGGCTGTCTCCACAAGT
rpp30_F_666_CGGACCATGT	AATGATACGGCGACCACCGAGATCTACACCGGACCATGTGAGCGGCTGTCTCCACAAGT
rpp30_F_667_CGGAGTGTGT	AATGATACGGCGACCACCGAGATCTACACCGGAGTGTGTGAGCGGCTGTCTCCACAAGT
rpp30_F_668_CGGTAGACAT	AATGATACGGCGACCACCGAGATCTACACCGGTAGACATGAGCGGCTGTCTCCACAAGT
rpp30_F_669_CGTATAGCGG	AATGATACGGCGACCACCGAGATCTACACCGTATAGCGGGAGCGGCTGTCTCCACAAGT
rpp30_F_670_CGTCAATGCG	AATGATACGGCGACCACCGAGATCTACACCGTCAATGCGGAGCGGCTGTCTCCACAAGT
rpp30_F_671_CGTGGTAATA	AATGATACGGCGACCACCGAGATCTACACCGTGGTAATAGAGCGGCTGTCTCCACAAGT
rpp30_F_672_CTGCAGAGAT	AATGATACGGCGACCACCGAGATCTACACCTGCAGAGATGAGCGGCTGTCTCCACAAGT
rpp30_F_673_CTGGAATGTA	AATGATACGGCGACCACCGAGATCTACACCTGGAATGTAGAGCGGCTGTCTCCACAAGT
rpp30_F_674_CTTACTGGCG	AATGATACGGCGACCACCGAGATCTACACCTTACTGGCGGAGCGGCTGTCTCCACAAGT
rpp30_F_675_GAACGTACGT	AATGATACGGCGACCACCGAGATCTACACGAACGTACGTGAGCGGCTGTCTCCACAAGT
rpp30_F_676_GACATTGTGG	AATGATACGGCGACCACCGAGATCTACACGACATTGTGGGAGCGGCTGTCTCCACAAGT
rpp30_F_677_GAGACGATCA	AATGATACGGCGACCACCGAGATCTACACGAGACGATCAGAGCGGCTGTCTCCACAAGT
rpp30_F_678_GCAAGACGGA	AATGATACGGCGACCACCGAGATCTACACGCAAGACGGAGAGCGGCTGTCTCCACAAGT
rpp30_F_679_GCAGAGTGGT	AATGATACGGCGACCACCGAGATCTACACGCAGAGTGGTGAGCGGCTGTCTCCACAAGT
rpp30_F_680_GCGGTTAACT	AATGATACGGCGACCACCGAGATCTACACGCGGTTAACTGAGCGGCTGTCTCCACAAGT
rpp30_F_681_GGAACTTCCT	AATGATACGGCGACCACCGAGATCTACACGGAACTTCCTGAGCGGCTGTCTCCACAAGT
rpp30_F_682_GGAATCGTAA	AATGATACGGCGACCACCGAGATCTACACGGAATCGTAAGAGCGGCTGTCTCCACAAGT
rpp30_F_683_GGCACTCCAT	AATGATACGGCGACCACCGAGATCTACACGGCACTCCATGAGCGGCTGTCTCCACAAGT
rpp30_F_684_GGCCATAGAT	AATGATACGGCGACCACCGAGATCTACACGGCCATAGATGAGCGGCTGTCTCCACAAGT
rpp30_F_685_GGTACTTCAG	AATGATACGGCGACCACCGAGATCTACACGGTACTTCAGGAGCGGCTGTCTCCACAAGT
rpp30_F_686_GTACCAAGTC	AATGATACGGCGACCACCGAGATCTACACGTACCAAGTCGAGCGGCTGTCTCCACAAGT
rpp30_F_687_GTAGGATGGT	AATGATACGGCGACCACCGAGATCTACACGTAGGATGGTGAGCGGCTGTCTCCACAAGT
rpp30_F_688_GTCACAAGCG	AATGATACGGCGACCACCGAGATCTACACGTCACAAGCGGAGCGGCTGTCTCCACAAGT
rpp30_F_689_GTCATCTCTT	AATGATACGGCGACCACCGAGATCTACACGTCATCTCTTGAGCGGCTGTCTCCACAAGT
rpp30_F_690_GTCTGTAGAA	AATGATACGGCGACCACCGAGATCTACACGTCTGTAGAAGAGCGGCTGTCTCCACAAGT
rpp30_F_691_GTTAGCTTCG	AATGATACGGCGACCACCGAGATCTACACGTTAGCTTCGGAGCGGCTGTCTCCACAAGT
rpp30_F_692_GTTGATGTTG	AATGATACGGCGACCACCGAGATCTACACGTTGATGTTGGAGCGGCTGTCTCCACAAGT
rpp30_F_693_TAGAGACACG	AATGATACGGCGACCACCGAGATCTACACTAGAGACACGGAGCGGCTGTCTCCACAAGT
rpp30_F_694_TAGGATTACG	AATGATACGGCGACCACCGAGATCTACACTAGGATTACGGAGCGGCTGTCTCCACAAGT
rpp30_F_695_TCCATTAACG	AATGATACGGCGACCACCGAGATCTACACTCCATTAACGGAGCGGCTGTCTCCACAAGT
rpp30_F_696_TCGCGATCCT	AATGATACGGCGACCACCGAGATCTACACTCGCGATCCTGAGCGGCTGTCTCCACAAGT
rpp30_F_697_TCTAGTGCAT	AATGATACGGCGACCACCGAGATCTACACTCTAGTGCATGAGCGGCTGTCTCCACAAGT
rpp30_F_698_TGAGTAGAGG	AATGATACGGCGACCACCGAGATCTACACTGAGTAGAGGGAGCGGCTGTCTCCACAAGT
rpp30_F_699_TGATTGAGCG	AATGATACGGCGACCACCGAGATCTACACTGATTGAGCGGAGCGGCTGTCTCCACAAGT
rpp30_F_700_TGCACTCGAA	AATGATACGGCGACCACCGAGATCTACACTGCACTCGAAGAGCGGCTGTCTCCACAAGT
rpp30_F_701_TGTGAGAGGT	AATGATACGGCGACCACCGAGATCTACACTGTGAGAGGTGAGCGGCTGTCTCCACAAGT
rpp30_F_702_TTCGGAACTG	AATGATACGGCGACCACCGAGATCTACACTTCGGAACTGGAGCGGCTGTCTCCACAAGT
rpp30_F_703_TTGAGCTGGT	AATGATACGGCGACCACCGAGATCTACACTTGAGCTGGTGAGCGGCTGTCTCCACAAGT
rpp30_F_704_GATAGGCCTA	AATGATACGGCGACCACCGAGATCTACACGATAGGCCTAGAGCGGCTGTCTCCACAAGT
rpp30_F_705_CTCACATAGT	AATGATACGGCGACCACCGAGATCTACACCTCACATAGTGAGCGGCTGTCTCCACAAGT
rpp30_F_706_AACACTCGAT	AATGATACGGCGACCACCGAGATCTACACAACACTCGATGAGCGGCTGTCTCCACAAGT
rpp30_F_707_TCTTCGGAGG	AATGATACGGCGACCACCGAGATCTACACTCTTCGGAGGGAGCGGCTGTCTCCACAAGT
rpp30_F_708_TCACTCCGTC	AATGATACGGCGACCACCGAGATCTACACTCACTCCGTCGAGCGGCTGTCTCCACAAGT
rpp30_F_709_GTCGATTAGA	AATGATACGGCGACCACCGAGATCTACACGTCGATTAGAGAGCGGCTGTCTCCACAAGT
rpp30_F_710_CCTTGACAAG	AATGATACGGCGACCACCGAGATCTACACCCTTGACAAGGAGCGGCTGTCTCCACAAGT
rpp30_F_711_CTTAGGTCAA	AATGATACGGCGACCACCGAGATCTACACCTTAGGTCAAGAGCGGCTGTCTCCACAAGT
rpp30_F_712_GTACCTTAGA	AATGATACGGCGACCACCGAGATCTACACGTACCTTAGAGAGCGGCTGTCTCCACAAGT
rpp30_F_713_GGCTCTAAGT	AATGATACGGCGACCACCGAGATCTACACGGCTCTAAGTGAGCGGCTGTCTCCACAAGT
rpp30_F_714_GAGTGTACTG	AATGATACGGCGACCACCGAGATCTACACGAGTGTACTGGAGCGGCTGTCTCCACAAGT
rpp30_F_715_ATGCTGACTT	AATGATACGGCGACCACCGAGATCTACACATGCTGACTTGAGCGGCTGTCTCCACAAGT
rpp30_F_716_GTACAGACTT	AATGATACGGCGACCACCGAGATCTACACGTACAGACTTGAGCGGCTGTCTCCACAAGT
rpp30_F_717_TCCGAGACTT	AATGATACGGCGACCACCGAGATCTACACTCCGAGACTTGAGCGGCTGTCTCCACAAGT
rpp30_F_718_CGTAGCATCG	AATGATACGGCGACCACCGAGATCTACACCGTAGCATCGGAGCGGCTGTCTCCACAAGT
rpp30_F_719_GACGCATCTG	AATGATACGGCGACCACCGAGATCTACACGACGCATCTGGAGCGGCTGTCTCCACAAGT
rpp30_F_720_ACGCATGGAA	AATGATACGGCGACCACCGAGATCTACACACGCATGGAAGAGCGGCTGTCTCCACAAGT
rpp30_F_721_AGCGCAGATA	AATGATACGGCGACCACCGAGATCTACACAGCGCAGATAGAGCGGCTGTCTCCACAAGT
rpp30_F_722_AGCTATGTGG	AATGATACGGCGACCACCGAGATCTACACAGCTATGTGGGAGCGGCTGTCTCCACAAGT
rpp30_F_723_CGTAGAACTT	AATGATACGGCGACCACCGAGATCTACACCGTAGAACTTGAGCGGCTGTCTCCACAAGT
rpp30_F_724_CTCTGCGACA	AATGATACGGCGACCACCGAGATCTACACCTCTGCGACAGAGCGGCTGTCTCCACAAGT
rpp30_F_725_AAGCCTTGAA	AATGATACGGCGACCACCGAGATCTACACAAGCCTTGAAGAGCGGCTGTCTCCACAAGT
rpp30_F_726_ACGCACTCAT	AATGATACGGCGACCACCGAGATCTACACACGCACTCATGAGCGGCTGTCTCCACAAGT
rpp30_F_727_GACACGGTAT	AATGATACGGCGACCACCGAGATCTACACGACACGGTATGAGCGGCTGTCTCCACAAGT
rpp30_F_728_GTAGCACACG	AATGATACGGCGACCACCGAGATCTACACGTAGCACACGGAGCGGCTGTCTCCACAAGT
rpp30_F_729_ACTGATCTCC	AATGATACGGCGACCACCGAGATCTACACACTGATCTCCGAGCGGCTGTCTCCACAAGT
rpp30_F_730_TTAGGATCCA	AATGATACGGCGACCACCGAGATCTACACTTAGGATCCAGAGCGGCTGTCTCCACAAGT
rpp30_F_731_ATTAGCGGTT	AATGATACGGCGACCACCGAGATCTACACATTAGCGGTTGAGCGGCTGTCTCCACAAGT
rpp30_F_732_ACAATCGGAG	AATGATACGGCGACCACCGAGATCTACACACAATCGGAGGAGCGGCTGTCTCCACAAGT
rpp30_F_733_GAGCTCCTCA	AATGATACGGCGACCACCGAGATCTACACGAGCTCCTCAGAGCGGCTGTCTCCACAAGT
rpp30_F_734_TCTAACCGTC	AATGATACGGCGACCACCGAGATCTACACTCTAACCGTCGAGCGGCTGTCTCCACAAGT
rpp30_F_735_GCAAGCTGTT	AATGATACGGCGACCACCGAGATCTACACGCAAGCTGTTGAGCGGCTGTCTCCACAAGT
rpp30_F_736_GGCCTGCATT	AATGATACGGCGACCACCGAGATCTACACGGCCTGCATTGAGCGGCTGTCTCCACAAGT
rpp30_F_737_GGAATTGTCC	AATGATACGGCGACCACCGAGATCTACACGGAATTGTCCGAGCGGCTGTCTCCACAAGT
rpp30_F_738_CAACTTGGAC	AATGATACGGCGACCACCGAGATCTACACCAACTTGGACGAGCGGCTGTCTCCACAAGT
rpp30_F_739_TCCAGGAGTA	AATGATACGGCGACCACCGAGATCTACACTCCAGGAGTAGAGCGGCTGTCTCCACAAGT
rpp30_F_740_GTAGACCATG	AATGATACGGCGACCACCGAGATCTACACGTAGACCATGGAGCGGCTGTCTCCACAAGT
rpp30_F_741_CGTTATGGTT	AATGATACGGCGACCACCGAGATCTACACCGTTATGGTTGAGCGGCTGTCTCCACAAGT
rpp30_F_742_AGCGAACGTA	AATGATACGGCGACCACCGAGATCTACACAGCGAACGTAGAGCGGCTGTCTCCACAAGT
rpp30_F_743_CGGAATCCGT	AATGATACGGCGACCACCGAGATCTACACCGGAATCCGTGAGCGGCTGTCTCCACAAGT
rpp30_F_744_ACCTAGATCA	AATGATACGGCGACCACCGAGATCTACACACCTAGATCAGAGCGGCTGTCTCCACAAGT
rpp30_F_745_TATACAACCG	AATGATACGGCGACCACCGAGATCTACACTATACAACCGGAGCGGCTGTCTCCACAAGT
rpp30_F_746_GTAGGTTCGG	AATGATACGGCGACCACCGAGATCTACACGTAGGTTCGGGAGCGGCTGTCTCCACAAGT
rpp30_F_747_TTAATGGAGG	AATGATACGGCGACCACCGAGATCTACACTTAATGGAGGGAGCGGCTGTCTCCACAAGT
rpp30_F_748_TCGCATTCGA	AATGATACGGCGACCACCGAGATCTACACTCGCATTCGAGAGCGGCTGTCTCCACAAGT
rpp30_F_749_CCAGCTGTAT	AATGATACGGCGACCACCGAGATCTACACCCAGCTGTATGAGCGGCTGTCTCCACAAGT
rpp30_F_750_GAACCTTGGC	AATGATACGGCGACCACCGAGATCTACACGAACCTTGGCGAGCGGCTGTCTCCACAAGT
rpp30_F_751_TTGATCAGCG	AATGATACGGCGACCACCGAGATCTACACTTGATCAGCGGAGCGGCTGTCTCCACAAGT
rpp30_F_752_CTGTCAAGGT	AATGATACGGCGACCACCGAGATCTACACCTGTCAAGGTGAGCGGCTGTCTCCACAAGT
rpp30_F_753_CTAGCTACTT	AATGATACGGCGACCACCGAGATCTACACCTAGCTACTTGAGCGGCTGTCTCCACAAGT
rpp30_F_754_GTGTTGTGTT	AATGATACGGCGACCACCGAGATCTACACGTGTTGTGTTGAGCGGCTGTCTCCACAAGT
rpp30_F_755_GGCAATTCCA	AATGATACGGCGACCACCGAGATCTACACGGCAATTCCAGAGCGGCTGTCTCCACAAGT
rpp30_F_756_CGCATTACCT	AATGATACGGCGACCACCGAGATCTACACCGCATTACCTGAGCGGCTGTCTCCACAAGT
rpp30_F_757_AAGTAGTTCG	AATGATACGGCGACCACCGAGATCTACACAAGTAGTTCGGAGCGGCTGTCTCCACAAGT
rpp30_F_758_CTTATGCATC	AATGATACGGCGACCACCGAGATCTACACCTTATGCATCGAGCGGCTGTCTCCACAAGT
rpp30_F_759_CGTTGGTAGG	AATGATACGGCGACCACCGAGATCTACACCGTTGGTAGGGAGCGGCTGTCTCCACAAGT
rpp30_F_760_GTCGACTCAA	AATGATACGGCGACCACCGAGATCTACACGTCGACTCAAGAGCGGCTGTCTCCACAAGT
rpp30_F_761_ACAGTCGAGG	AATGATACGGCGACCACCGAGATCTACACACAGTCGAGGGAGCGGCTGTCTCCACAAGT
rpp30_F_762_CGCAACTACT	AATGATACGGCGACCACCGAGATCTACACCGCAACTACTGAGCGGCTGTCTCCACAAGT
rpp30_F_763_GGTCATGGAA	AATGATACGGCGACCACCGAGATCTACACGGTCATGGAAGAGCGGCTGTCTCCACAAGT
rpp30_F_764_GTTGGTAACG	AATGATACGGCGACCACCGAGATCTACACGTTGGTAACGGAGCGGCTGTCTCCACAAGT
rpp30_F_765_ATCATGACGT	AATGATACGGCGACCACCGAGATCTACACATCATGACGTGAGCGGCTGTCTCCACAAGT
rpp30_F_766_GACGATGGAT	AATGATACGGCGACCACCGAGATCTACACGACGATGGATGAGCGGCTGTCTCCACAAGT
rpp30_F_767_GATGGTGCTA	AATGATACGGCGACCACCGAGATCTACACGATGGTGCTAGAGCGGCTGTCTCCACAAGT
rpp30_F_768_ACAGGAAGCG	AATGATACGGCGACCACCGAGATCTACACACAGGAAGCGGAGCGGCTGTCTCCACAAGT
rpp30_F_769_GTGGTAAGAA	AATGATACGGCGACCACCGAGATCTACACGTGGTAAGAAGAGCGGCTGTCTCCACAAGT
rpp30_F_770_TAGACGTGGT	AATGATACGGCGACCACCGAGATCTACACTAGACGTGGTGAGCGGCTGTCTCCACAAGT
rpp30_F_771_CGACTCCAGA	AATGATACGGCGACCACCGAGATCTACACCGACTCCAGAGAGCGGCTGTCTCCACAAGT
rpp30_F_772_GCATGGTTAT	AATGATACGGCGACCACCGAGATCTACACGCATGGTTATGAGCGGCTGTCTCCACAAGT
rpp30_F_773_TCGAGTTAAC	AATGATACGGCGACCACCGAGATCTACACTCGAGTTAACGAGCGGCTGTCTCCACAAGT
rpp30_F_774_GTCAATTGCC	AATGATACGGCGACCACCGAGATCTACACGTCAATTGCCGAGCGGCTGTCTCCACAAGT
rpp30_F_775_AAGCGCTAAT	AATGATACGGCGACCACCGAGATCTACACAAGCGCTAATGAGCGGCTGTCTCCACAAGT
rpp30_F_776_AAGCTACAGT	AATGATACGGCGACCACCGAGATCTACACAAGCTACAGTGAGCGGCTGTCTCCACAAGT
rpp30_F_777_CGTGAGGTTC	AATGATACGGCGACCACCGAGATCTACACCGTGAGGTTCGAGCGGCTGTCTCCACAAGT
rpp30_F_778_AGACAGAACT	AATGATACGGCGACCACCGAGATCTACACAGACAGAACTGAGCGGCTGTCTCCACAAGT
rpp30_F_779_AAGTGAGTGA	AATGATACGGCGACCACCGAGATCTACACAAGTGAGTGAGAGCGGCTGTCTCCACAAGT
rpp30_F_780_GGTCAACATG	AATGATACGGCGACCACCGAGATCTACACGGTCAACATGGAGCGGCTGTCTCCACAAGT
rpp30_F_781_GCTGCTGGAT	AATGATACGGCGACCACCGAGATCTACACGCTGCTGGATGAGCGGCTGTCTCCACAAGT
rpp30_F_782_GAACCACGCT	AATGATACGGCGACCACCGAGATCTACACGAACCACGCTGAGCGGCTGTCTCCACAAGT
rpp30_F_783_GGAGAGCGTT	AATGATACGGCGACCACCGAGATCTACACGGAGAGCGTTGAGCGGCTGTCTCCACAAGT
rpp30_F_784_ACCGCGAAGT	AATGATACGGCGACCACCGAGATCTACACACCGCGAAGTGAGCGGCTGTCTCCACAAGT
rpp30_F_785_GGCTTCTTGG	AATGATACGGCGACCACCGAGATCTACACGGCTTCTTGGGAGCGGCTGTCTCCACAAGT
rpp30_F_786_TGGAACGGAG	AATGATACGGCGACCACCGAGATCTACACTGGAACGGAGGAGCGGCTGTCTCCACAAGT
rpp30_F_787_CGTACGCAGA	AATGATACGGCGACCACCGAGATCTACACCGTACGCAGAGAGCGGCTGTCTCCACAAGT
rpp30_F_788_CCGAGAGTAC	AATGATACGGCGACCACCGAGATCTACACCCGAGAGTACGAGCGGCTGTCTCCACAAGT
rpp30_F_789_TAGTAAGCCA	AATGATACGGCGACCACCGAGATCTACACTAGTAAGCCAGAGCGGCTGTCTCCACAAGT
rpp30_F_790_TACGCTGCCT	AATGATACGGCGACCACCGAGATCTACACTACGCTGCCTGAGCGGCTGTCTCCACAAGT
rpp30_F_791_TGCCTTGCAT	AATGATACGGCGACCACCGAGATCTACACTGCCTTGCATGAGCGGCTGTCTCCACAAGT
rpp30_F_792_CGCATCGTCT	AATGATACGGCGACCACCGAGATCTACACCGCATCGTCTGAGCGGCTGTCTCCACAAGT
rpp30_F_793_TTGCAACTGT	AATGATACGGCGACCACCGAGATCTACACTTGCAACTGTGAGCGGCTGTCTCCACAAGT
rpp30_F_794_CTACCGGATG	AATGATACGGCGACCACCGAGATCTACACCTACCGGATGGAGCGGCTGTCTCCACAAGT
rpp30_F_795_CTAACATACG	AATGATACGGCGACCACCGAGATCTACACCTAACATACGGAGCGGCTGTCTCCACAAGT
rpp30_F_796_CTTACGCACG	AATGATACGGCGACCACCGAGATCTACACCTTACGCACGGAGCGGCTGTCTCCACAAGT
rpp30_F_797_TCCTTCCACG	AATGATACGGCGACCACCGAGATCTACACTCCTTCCACGGAGCGGCTGTCTCCACAAGT
rpp30_F_798_AAGCCTACTT	AATGATACGGCGACCACCGAGATCTACACAAGCCTACTTGAGCGGCTGTCTCCACAAGT
rpp30_F_799_ACCGGTTCAT	AATGATACGGCGACCACCGAGATCTACACACCGGTTCATGAGCGGCTGTCTCCACAAGT
rpp30_F_800_GAGCTCACAA	AATGATACGGCGACCACCGAGATCTACACGAGCTCACAAGAGCGGCTGTCTCCACAAGT
rpp30_F_801_CACTAGGATA	AATGATACGGCGACCACCGAGATCTACACCACTAGGATAGAGCGGCTGTCTCCACAAGT
rpp30_F_802_CGGTATGGAG	AATGATACGGCGACCACCGAGATCTACACCGGTATGGAGGAGCGGCTGTCTCCACAAGT
rpp30_F_803_GAAGACGTCT	AATGATACGGCGACCACCGAGATCTACACGAAGACGTCTGAGCGGCTGTCTCCACAAGT
rpp30_F_804_GACTACCGTC	AATGATACGGCGACCACCGAGATCTACACGACTACCGTCGAGCGGCTGTCTCCACAAGT
rpp30_F_805_GGTTGACTAA	AATGATACGGCGACCACCGAGATCTACACGGTTGACTAAGAGCGGCTGTCTCCACAAGT
rpp30_F_806_GAGTCTGAGC	AATGATACGGCGACCACCGAGATCTACACGAGTCTGAGCGAGCGGCTGTCTCCACAAGT
rpp30_F_807_TTCACCAACG	AATGATACGGCGACCACCGAGATCTACACTTCACCAACGGAGCGGCTGTCTCCACAAGT
rpp30_F_808_TTGACTTACG	AATGATACGGCGACCACCGAGATCTACACTTGACTTACGGAGCGGCTGTCTCCACAAGT
rpp30_F_809_TGGAGTACGG	AATGATACGGCGACCACCGAGATCTACACTGGAGTACGGGAGCGGCTGTCTCCACAAGT
rpp30_F_810_CATGGTCTAG	AATGATACGGCGACCACCGAGATCTACACCATGGTCTAGGAGCGGCTGTCTCCACAAGT
rpp30_F_811_CACCTACGTC	AATGATACGGCGACCACCGAGATCTACACCACCTACGTCGAGCGGCTGTCTCCACAAGT
rpp30_F_812_CAAGCGCGAT	AATGATACGGCGACCACCGAGATCTACACCAAGCGCGATGAGCGGCTGTCTCCACAAGT
rpp30_F_813_TGCGTACGTG	AATGATACGGCGACCACCGAGATCTACACTGCGTACGTGGAGCGGCTGTCTCCACAAGT
rpp30_F_814_ATCGTGATTC	AATGATACGGCGACCACCGAGATCTACACATCGTGATTCGAGCGGCTGTCTCCACAAGT
rpp30_F_815_GAGAATGGCT	AATGATACGGCGACCACCGAGATCTACACGAGAATGGCTGAGCGGCTGTCTCCACAAGT
rpp30_F_816_GGCCACACTT	AATGATACGGCGACCACCGAGATCTACACGGCCACACTTGAGCGGCTGTCTCCACAAGT
rpp30_F_817_GCGTCCATTG	AATGATACGGCGACCACCGAGATCTACACGCGTCCATTGGAGCGGCTGTCTCCACAAGT
rpp30_F_818_GTGAACATTC	AATGATACGGCGACCACCGAGATCTACACGTGAACATTCGAGCGGCTGTCTCCACAAGT
rpp30_F_819_ACCGAGCTTC	AATGATACGGCGACCACCGAGATCTACACACCGAGCTTCGAGCGGCTGTCTCCACAAGT
rpp30_F_820_ATGATTCGCG	AATGATACGGCGACCACCGAGATCTACACATGATTCGCGGAGCGGCTGTCTCCACAAGT
rpp30_F_821_AGCAGATCTT	AATGATACGGCGACCACCGAGATCTACACAGCAGATCTTGAGCGGCTGTCTCCACAAGT
rpp30_F_822_GAAGATATCC	AATGATACGGCGACCACCGAGATCTACACGAAGATATCCGAGCGGCTGTCTCCACAAGT
rpp30_F_823_GCCTAGTGTC	AATGATACGGCGACCACCGAGATCTACACGCCTAGTGTCGAGCGGCTGTCTCCACAAGT
rpp30_F_824_TCTTCCGGAC	AATGATACGGCGACCACCGAGATCTACACTCTTCCGGACGAGCGGCTGTCTCCACAAGT
rpp30_F_825_GAACAAGTGG	AATGATACGGCGACCACCGAGATCTACACGAACAAGTGGGAGCGGCTGTCTCCACAAGT
rpp30_F_826_GCTAGATCGA	AATGATACGGCGACCACCGAGATCTACACGCTAGATCGAGAGCGGCTGTCTCCACAAGT
rpp30_F_827_CGCATGATGT	AATGATACGGCGACCACCGAGATCTACACCGCATGATGTGAGCGGCTGTCTCCACAAGT
rpp30_F_828_GTTGCCAAGC	AATGATACGGCGACCACCGAGATCTACACGTTGCCAAGCGAGCGGCTGTCTCCACAAGT
rpp30_F_829_TCAGACGGAT	AATGATACGGCGACCACCGAGATCTACACTCAGACGGATGAGCGGCTGTCTCCACAAGT
rpp30_F_830_GTTGGCATTC	AATGATACGGCGACCACCGAGATCTACACGTTGGCATTCGAGCGGCTGTCTCCACAAGT
rpp30_F_831_ACCAACGCAT	AATGATACGGCGACCACCGAGATCTACACACCAACGCATGAGCGGCTGTCTCCACAAGT
rpp30_F_832_ATAGTGCGTC	AATGATACGGCGACCACCGAGATCTACACATAGTGCGTCGAGCGGCTGTCTCCACAAGT
rpp30_F_833_GCGATTGCTG	AATGATACGGCGACCACCGAGATCTACACGCGATTGCTGGAGCGGCTGTCTCCACAAGT
rpp30_F_834_TCGAGCCTGA	AATGATACGGCGACCACCGAGATCTACACTCGAGCCTGAGAGCGGCTGTCTCCACAAGT
rpp30_F_835_CGTATACTGT	AATGATACGGCGACCACCGAGATCTACACCGTATACTGTGAGCGGCTGTCTCCACAAGT
rpp30_F_836_TAGGCGTACA	AATGATACGGCGACCACCGAGATCTACACTAGGCGTACAGAGCGGCTGTCTCCACAAGT
rpp30_F_837_GATAACGCCA	AATGATACGGCGACCACCGAGATCTACACGATAACGCCAGAGCGGCTGTCTCCACAAGT
rpp30_F_838_GAGTTCTATC	AATGATACGGCGACCACCGAGATCTACACGAGTTCTATCGAGCGGCTGTCTCCACAAGT
rpp30_F_839_TTATGGAACC	AATGATACGGCGACCACCGAGATCTACACTTATGGAACCGAGCGGCTGTCTCCACAAGT
rpp30_F_840_GTCTACGGAT	AATGATACGGCGACCACCGAGATCTACACGTCTACGGATGAGCGGCTGTCTCCACAAGT
rpp30_F_841_GCGTAGGTTG	AATGATACGGCGACCACCGAGATCTACACGCGTAGGTTGGAGCGGCTGTCTCCACAAGT
rpp30_F_842_TAGGAAGGCG	AATGATACGGCGACCACCGAGATCTACACTAGGAAGGCGGAGCGGCTGTCTCCACAAGT
rpp30_F_843_GCGGAAGTAT	AATGATACGGCGACCACCGAGATCTACACGCGGAAGTATGAGCGGCTGTCTCCACAAGT
rpp30_F_844_GAATTAGCCG	AATGATACGGCGACCACCGAGATCTACACGAATTAGCCGGAGCGGCTGTCTCCACAAGT
rpp30_F_845_CACGGTAATT	AATGATACGGCGACCACCGAGATCTACACCACGGTAATTGAGCGGCTGTCTCCACAAGT
rpp30_F_846_CAATATCGAC	AATGATACGGCGACCACCGAGATCTACACCAATATCGACGAGCGGCTGTCTCCACAAGT
rpp30_F_847_ACCAATGGTA	AATGATACGGCGACCACCGAGATCTACACACCAATGGTAGAGCGGCTGTCTCCACAAGT
rpp30_F_848_AACGTTGTCT	AATGATACGGCGACCACCGAGATCTACACAACGTTGTCTGAGCGGCTGTCTCCACAAGT
rpp30_F_849_CCGGTGTGAT	AATGATACGGCGACCACCGAGATCTACACCCGGTGTGATGAGCGGCTGTCTCCACAAGT
rpp30_F_850_CGTCCTGAAG	AATGATACGGCGACCACCGAGATCTACACCGTCCTGAAGGAGCGGCTGTCTCCACAAGT
rpp30_F_851_CACTCTGCCA	AATGATACGGCGACCACCGAGATCTACACCACTCTGCCAGAGCGGCTGTCTCCACAAGT
rpp30_F_852_TATCGTCATC	AATGATACGGCGACCACCGAGATCTACACTATCGTCATCGAGCGGCTGTCTCCACAAGT
rpp30_F_853_GTACGTCCAT	AATGATACGGCGACCACCGAGATCTACACGTACGTCCATGAGCGGCTGTCTCCACAAGT
rpp30_F_854_AATTGCGGAT	AATGATACGGCGACCACCGAGATCTACACAATTGCGGATGAGCGGCTGTCTCCACAAGT
rpp30_F_855_GCGAACAATG	AATGATACGGCGACCACCGAGATCTACACGCGAACAATGGAGCGGCTGTCTCCACAAGT
rpp30_F_856_GAATGGACTT	AATGATACGGCGACCACCGAGATCTACACGAATGGACTTGAGCGGCTGTCTCCACAAGT
rpp30_F_857_AGGAAGTATC	AATGATACGGCGACCACCGAGATCTACACAGGAAGTATCGAGCGGCTGTCTCCACAAGT
rpp30_F_858_GCTAGCCTCT	AATGATACGGCGACCACCGAGATCTACACGCTAGCCTCTGAGCGGCTGTCTCCACAAGT
rpp30_F_859_CGCTGATGAC	AATGATACGGCGACCACCGAGATCTACACCGCTGATGACGAGCGGCTGTCTCCACAAGT
rpp30_F_860_GCGTAACTGA	AATGATACGGCGACCACCGAGATCTACACGCGTAACTGAGAGCGGCTGTCTCCACAAGT
rpp30_F_861_CAGGCCATCA	AATGATACGGCGACCACCGAGATCTACACCAGGCCATCAGAGCGGCTGTCTCCACAAGT
rpp30_F_862_TACACGGAGC	AATGATACGGCGACCACCGAGATCTACACTACACGGAGCGAGCGGCTGTCTCCACAAGT
rpp30_F_863_ACACACGTGG	AATGATACGGCGACCACCGAGATCTACACACACACGTGGGAGCGGCTGTCTCCACAAGT
rpp30_F_864_AGACTGGTTA	AATGATACGGCGACCACCGAGATCTACACAGACTGGTTAGAGCGGCTGTCTCCACAAGT
rpp30_F_865_CTCAGCTTCT	AATGATACGGCGACCACCGAGATCTACACCTCAGCTTCTGAGCGGCTGTCTCCACAAGT
rpp30_F_866_GGCTTAGGTA	AATGATACGGCGACCACCGAGATCTACACGGCTTAGGTAGAGCGGCTGTCTCCACAAGT
rpp30_F_867_AGACGTTAGA	AATGATACGGCGACCACCGAGATCTACACAGACGTTAGAGAGCGGCTGTCTCCACAAGT
rpp30_F_868_TGTAGCTATC	AATGATACGGCGACCACCGAGATCTACACTGTAGCTATCGAGCGGCTGTCTCCACAAGT
rpp30_F_869_AATTCGGAGC	AATGATACGGCGACCACCGAGATCTACACAATTCGGAGCGAGCGGCTGTCTCCACAAGT
rpp30_F_870_CGTACTCGAC	AATGATACGGCGACCACCGAGATCTACACCGTACTCGACGAGCGGCTGTCTCCACAAGT
rpp30_F_871_AGCTGTTCAA	AATGATACGGCGACCACCGAGATCTACACAGCTGTTCAAGAGCGGCTGTCTCCACAAGT
rpp30_F_872_ACAGACTCAC	AATGATACGGCGACCACCGAGATCTACACACAGACTCACGAGCGGCTGTCTCCACAAGT
rpp30_F_873_CGGAGGAGTA	AATGATACGGCGACCACCGAGATCTACACCGGAGGAGTAGAGCGGCTGTCTCCACAAGT
rpp30_F_874_GGTTAGCGAG	AATGATACGGCGACCACCGAGATCTACACGGTTAGCGAGGAGCGGCTGTCTCCACAAGT
rpp30_F_875_GGCCTTCAAC	AATGATACGGCGACCACCGAGATCTACACGGCCTTCAACGAGCGGCTGTCTCCACAAGT
rpp30_F_876_GGCTATCTAC	AATGATACGGCGACCACCGAGATCTACACGGCTATCTACGAGCGGCTGTCTCCACAAGT
rpp30_F_877_GGCTAGCTTA	AATGATACGGCGACCACCGAGATCTACACGGCTAGCTTAGAGCGGCTGTCTCCACAAGT
rpp30_F_878_GGTCATTAGT	AATGATACGGCGACCACCGAGATCTACACGGTCATTAGTGAGCGGCTGTCTCCACAAGT
rpp30_F_879_CACGCAACTT	AATGATACGGCGACCACCGAGATCTACACCACGCAACTTGAGCGGCTGTCTCCACAAGT
rpp30_F_880_AGCCTCAGTT	AATGATACGGCGACCACCGAGATCTACACAGCCTCAGTTGAGCGGCTGTCTCCACAAGT
rpp30_F_881_GGACCTCGTT	AATGATACGGCGACCACCGAGATCTACACGGACCTCGTTGAGCGGCTGTCTCCACAAGT
rpp30_F_882_AAGGACCGTC	AATGATACGGCGACCACCGAGATCTACACAAGGACCGTCGAGCGGCTGTCTCCACAAGT
rpp30_F_883_AGCCTCCTAA	AATGATACGGCGACCACCGAGATCTACACAGCCTCCTAAGAGCGGCTGTCTCCACAAGT
rpp30_F_884_GGCTAGAACA	AATGATACGGCGACCACCGAGATCTACACGGCTAGAACAGAGCGGCTGTCTCCACAAGT
rpp30_F_885_GACTAGTCTT	AATGATACGGCGACCACCGAGATCTACACGACTAGTCTTGAGCGGCTGTCTCCACAAGT
rpp30_F_886_TCCTGATAAG	AATGATACGGCGACCACCGAGATCTACACTCCTGATAAGGAGCGGCTGTCTCCACAAGT
rpp30_F_887_CCATAAGCCA	AATGATACGGCGACCACCGAGATCTACACCCATAAGCCAGAGCGGCTGTCTCCACAAGT
rpp30_F_888_TGGAACTACA	AATGATACGGCGACCACCGAGATCTACACTGGAACTACAGAGCGGCTGTCTCCACAAGT
rpp30_F_889_GGTTCCTACG	AATGATACGGCGACCACCGAGATCTACACGGTTCCTACGGAGCGGCTGTCTCCACAAGT
rpp30_F_890_GCATTGGTGT	AATGATACGGCGACCACCGAGATCTACACGCATTGGTGTGAGCGGCTGTCTCCACAAGT
rpp30_F_891_GTCGATACCT	AATGATACGGCGACCACCGAGATCTACACGTCGATACCTGAGCGGCTGTCTCCACAAGT
rpp30_F_892_GCGATACTTA	AATGATACGGCGACCACCGAGATCTACACGCGATACTTAGAGCGGCTGTCTCCACAAGT
rpp30_F_893_AGGCACGAGT	AATGATACGGCGACCACCGAGATCTACACAGGCACGAGTGAGCGGCTGTCTCCACAAGT
rpp30_F_894_ATACATCGCT	AATGATACGGCGACCACCGAGATCTACACATACATCGCTGAGCGGCTGTCTCCACAAGT
rpp30_F_895_TAAGATCGCT	AATGATACGGCGACCACCGAGATCTACACTAAGATCGCTGAGCGGCTGTCTCCACAAGT
rpp30_F_896_CGTTACGCCT	AATGATACGGCGACCACCGAGATCTACACCGTTACGCCTGAGCGGCTGTCTCCACAAGT
rpp30_F_897_ATGCGGAACA	AATGATACGGCGACCACCGAGATCTACACATGCGGAACAGAGCGGCTGTCTCCACAAGT
rpp30_F_898_GACAGGTCAA	AATGATACGGCGACCACCGAGATCTACACGACAGGTCAAGAGCGGCTGTCTCCACAAGT
rpp30_F_899_ATTCGAACGT	AATGATACGGCGACCACCGAGATCTACACATTCGAACGTGAGCGGCTGTCTCCACAAGT
rpp30_F_900_CGCAGAGGTT	AATGATACGGCGACCACCGAGATCTACACCGCAGAGGTTGAGCGGCTGTCTCCACAAGT
rpp30_F_901_GTTCTCAGTT	AATGATACGGCGACCACCGAGATCTACACGTTCTCAGTTGAGCGGCTGTCTCCACAAGT
rpp30_F_902_GCTGAGCAGA	AATGATACGGCGACCACCGAGATCTACACGCTGAGCAGAGAGCGGCTGTCTCCACAAGT
rpp30_F_903_GGAGTTAGTT	AATGATACGGCGACCACCGAGATCTACACGGAGTTAGTTGAGCGGCTGTCTCCACAAGT
rpp30_F_904_GGATGAAGTT	AATGATACGGCGACCACCGAGATCTACACGGATGAAGTTGAGCGGCTGTCTCCACAAGT
rpp30_F_905_ACCACTCGTC	AATGATACGGCGACCACCGAGATCTACACACCACTCGTCGAGCGGCTGTCTCCACAAGT
rpp30_F_906_CTCAGACAGA	AATGATACGGCGACCACCGAGATCTACACCTCAGACAGAGAGCGGCTGTCTCCACAAGT
rpp30_F_907_GAATGCGGAG	AATGATACGGCGACCACCGAGATCTACACGAATGCGGAGGAGCGGCTGTCTCCACAAGT
rpp30_F_908_GACGAATAAG	AATGATACGGCGACCACCGAGATCTACACGACGAATAAGGAGCGGCTGTCTCCACAAGT
rpp30_F_909_GACGAGCCAA	AATGATACGGCGACCACCGAGATCTACACGACGAGCCAAGAGCGGCTGTCTCCACAAGT
rpp30_F_910_GACGAGTTCT	AATGATACGGCGACCACCGAGATCTACACGACGAGTTCTGAGCGGCTGTCTCCACAAGT
rpp30_F_911_TTGGCTCCAA	AATGATACGGCGACCACCGAGATCTACACTTGGCTCCAAGAGCGGCTGTCTCCACAAGT
rpp30_F_912_ACGTGAATGT	AATGATACGGCGACCACCGAGATCTACACACGTGAATGTGAGCGGCTGTCTCCACAAGT
rpp30_F_913_AGAGACTGTA	AATGATACGGCGACCACCGAGATCTACACAGAGACTGTAGAGCGGCTGTCTCCACAAGT
rpp30_F_914_GACGAGCAGT	AATGATACGGCGACCACCGAGATCTACACGACGAGCAGTGAGCGGCTGTCTCCACAAGT
rpp30_F_915_CTCTGGTGAT	AATGATACGGCGACCACCGAGATCTACACCTCTGGTGATGAGCGGCTGTCTCCACAAGT
rpp30_F_916_AGAACGCACA	AATGATACGGCGACCACCGAGATCTACACAGAACGCACAGAGCGGCTGTCTCCACAAGT
rpp30_F_917_CGTGGACGTA	AATGATACGGCGACCACCGAGATCTACACCGTGGACGTAGAGCGGCTGTCTCCACAAGT
rpp30_F_918_TTGACGGTTG	AATGATACGGCGACCACCGAGATCTACACTTGACGGTTGGAGCGGCTGTCTCCACAAGT
rpp30_F_919_GGTCCTATAT	AATGATACGGCGACCACCGAGATCTACACGGTCCTATATGAGCGGCTGTCTCCACAAGT
rpp30_F_920_CGAACGTCGA	AATGATACGGCGACCACCGAGATCTACACCGAACGTCGAGAGCGGCTGTCTCCACAAGT
rpp30_F_921_ACTGTGACGG	AATGATACGGCGACCACCGAGATCTACACACTGTGACGGGAGCGGCTGTCTCCACAAGT
rpp30_F_922_CTTGTCCGCT	AATGATACGGCGACCACCGAGATCTACACCTTGTCCGCTGAGCGGCTGTCTCCACAAGT
rpp30_F_923_GACGTACTCT	AATGATACGGCGACCACCGAGATCTACACGACGTACTCTGAGCGGCTGTCTCCACAAGT
rpp30_F_924_TACGTGCTCG	AATGATACGGCGACCACCGAGATCTACACTACGTGCTCGGAGCGGCTGTCTCCACAAGT
rpp30_F_925_GTGGTGATTG	AATGATACGGCGACCACCGAGATCTACACGTGGTGATTGGAGCGGCTGTCTCCACAAGT
rpp30_F_926_TGATCCGGAG	AATGATACGGCGACCACCGAGATCTACACTGATCCGGAGGAGCGGCTGTCTCCACAAGT
rpp30_F_927_TGCAATGCTG	AATGATACGGCGACCACCGAGATCTACACTGCAATGCTGGAGCGGCTGTCTCCACAAGT
rpp30_F_928_GAACAGTATC	AATGATACGGCGACCACCGAGATCTACACGAACAGTATCGAGCGGCTGTCTCCACAAGT
rpp30_F_929_AGTGGACATG	AATGATACGGCGACCACCGAGATCTACACAGTGGACATGGAGCGGCTGTCTCCACAAGT
rpp30_F_930_AGTGGATTGG	AATGATACGGCGACCACCGAGATCTACACAGTGGATTGGGAGCGGCTGTCTCCACAAGT
rpp30_F_931_AGTCGTGTCA	AATGATACGGCGACCACCGAGATCTACACAGTCGTGTCAGAGCGGCTGTCTCCACAAGT
rpp30_F_932_GAGGAGTGTC	AATGATACGGCGACCACCGAGATCTACACGAGGAGTGTCGAGCGGCTGTCTCCACAAGT
rpp30_F_933_AGGACTCGCT	AATGATACGGCGACCACCGAGATCTACACAGGACTCGCTGAGCGGCTGTCTCCACAAGT
rpp30_F_934_CGTCACTAGG	AATGATACGGCGACCACCGAGATCTACACCGTCACTAGGGAGCGGCTGTCTCCACAAGT
rpp30_F_935_ACGTGGTGAT	AATGATACGGCGACCACCGAGATCTACACACGTGGTGATGAGCGGCTGTCTCCACAAGT
rpp30_F_936_TTCGATGACG	AATGATACGGCGACCACCGAGATCTACACTTCGATGACGGAGCGGCTGTCTCCACAAGT
rpp30_F_937_TAATACCGGA	AATGATACGGCGACCACCGAGATCTACACTAATACCGGAGAGCGGCTGTCTCCACAAGT
rpp30_F_938_TGATGGTTAC	AATGATACGGCGACCACCGAGATCTACACTGATGGTTACGAGCGGCTGTCTCCACAAGT
rpp30_F_939_ACAATCTGTC	AATGATACGGCGACCACCGAGATCTACACACAATCTGTCGAGCGGCTGTCTCCACAAGT
rpp30_F_940_GCTGAAGATG	AATGATACGGCGACCACCGAGATCTACACGCTGAAGATGGAGCGGCTGTCTCCACAAGT
rpp30_F_941_GGTATGGCTG	AATGATACGGCGACCACCGAGATCTACACGGTATGGCTGGAGCGGCTGTCTCCACAAGT
rpp30_F_942_CAATGGCGAG	AATGATACGGCGACCACCGAGATCTACACCAATGGCGAGGAGCGGCTGTCTCCACAAGT
rpp30_F_943_TCCGATTCTC	AATGATACGGCGACCACCGAGATCTACACTCCGATTCTCGAGCGGCTGTCTCCACAAGT
rpp30_F_944_TGCCTTCTCC	AATGATACGGCGACCACCGAGATCTACACTGCCTTCTCCGAGCGGCTGTCTCCACAAGT
rpp30_F_945_ACTCGTATCG	AATGATACGGCGACCACCGAGATCTACACACTCGTATCGGAGCGGCTGTCTCCACAAGT
rpp30_F_946_GCCTACAGGA	AATGATACGGCGACCACCGAGATCTACACGCCTACAGGAGAGCGGCTGTCTCCACAAGT
rpp30_F_947_GCCTACCACT	AATGATACGGCGACCACCGAGATCTACACGCCTACCACTGAGCGGCTGTCTCCACAAGT
rpp30_F_948_GCCTATGCTA	AATGATACGGCGACCACCGAGATCTACACGCCTATGCTAGAGCGGCTGTCTCCACAAGT
rpp30_F_949_GCCTCCACAA	AATGATACGGCGACCACCGAGATCTACACGCCTCCACAAGAGCGGCTGTCTCCACAAGT
rpp30_F_950_GCCTCTACTT	AATGATACGGCGACCACCGAGATCTACACGCCTCTACTTGAGCGGCTGTCTCCACAAGT
rpp30_F_951_GCCTCTGATG	AATGATACGGCGACCACCGAGATCTACACGCCTCTGATGGAGCGGCTGTCTCCACAAGT
rpp30_F_952_GCCTGATGAT	AATGATACGGCGACCACCGAGATCTACACGCCTGATGATGAGCGGCTGTCTCCACAAGT
rpp30_F_953_GCCTTGGAAT	AATGATACGGCGACCACCGAGATCTACACGCCTTGGAATGAGCGGCTGTCTCCACAAGT
rpp30_F_954_GCCTTGTTAA	AATGATACGGCGACCACCGAGATCTACACGCCTTGTTAAGAGCGGCTGTCTCCACAAGT
rpp30_F_955_CCATGGTACC	AATGATACGGCGACCACCGAGATCTACACCCATGGTACCGAGCGGCTGTCTCCACAAGT
rpp30_F_956_TGTGTTAGCG	AATGATACGGCGACCACCGAGATCTACACTGTGTTAGCGGAGCGGCTGTCTCCACAAGT
rpp30_F_957_GCGACCAGTT	AATGATACGGCGACCACCGAGATCTACACGCGACCAGTTGAGCGGCTGTCTCCACAAGT
rpp30_F_958_ATGAGCTCTA	AATGATACGGCGACCACCGAGATCTACACATGAGCTCTAGAGCGGCTGTCTCCACAAGT
rpp30_F_959_GATTCGCAAG	AATGATACGGCGACCACCGAGATCTACACGATTCGCAAGGAGCGGCTGTCTCCACAAGT
rpp30_F_960_TCCTGGATCG	AATGATACGGCGACCACCGAGATCTACACTCCTGGATCGGAGCGGCTGTCTCCACAAGT
rpp30_F_961_ACATCGCACT	AATGATACGGCGACCACCGAGATCTACACACATCGCACTGAGCGGCTGTCTCCACAAGT
rpp30_F_962_AATCCTGGAC	AATGATACGGCGACCACCGAGATCTACACAATCCTGGACGAGCGGCTGTCTCCACAAGT
rpp30_F_963_AATTGGATCC	AATGATACGGCGACCACCGAGATCTACACAATTGGATCCGAGCGGCTGTCTCCACAAGT
rpp30_F_964_GCCTTCGGTT	AATGATACGGCGACCACCGAGATCTACACGCCTTCGGTTGAGCGGCTGTCTCCACAAGT
rpp30_F_965_TCGACTAACC	AATGATACGGCGACCACCGAGATCTACACTCGACTAACCGAGCGGCTGTCTCCACAAGT
rpp30_F_966_ACGTCGTCCT	AATGATACGGCGACCACCGAGATCTACACACGTCGTCCTGAGCGGCTGTCTCCACAAGT
rpp30_F_967_TTGATGCACA	AATGATACGGCGACCACCGAGATCTACACTTGATGCACAGAGCGGCTGTCTCCACAAGT
rpp30_F_968_GTCGTGCGAT	AATGATACGGCGACCACCGAGATCTACACGTCGTGCGATGAGCGGCTGTCTCCACAAGT
rpp30_F_969_GGTCTCGTTA	AATGATACGGCGACCACCGAGATCTACACGGTCTCGTTAGAGCGGCTGTCTCCACAAGT
rpp30_F_970_GAACTCGAGG	AATGATACGGCGACCACCGAGATCTACACGAACTCGAGGGAGCGGCTGTCTCCACAAGT
rpp30_F_971_ACTTCAGCGA	AATGATACGGCGACCACCGAGATCTACACACTTCAGCGAGAGCGGCTGTCTCCACAAGT
rpp30_F_972_ATAGATCTGC	AATGATACGGCGACCACCGAGATCTACACATAGATCTGCGAGCGGCTGTCTCCACAAGT
rpp30_F_973_ACCGCACGAT	AATGATACGGCGACCACCGAGATCTACACACCGCACGATGAGCGGCTGTCTCCACAAGT
rpp30_F_974_ACTCTTGCTG	AATGATACGGCGACCACCGAGATCTACACACTCTTGCTGGAGCGGCTGTCTCCACAAGT
rpp30_F_975_CTGGAGACCT	AATGATACGGCGACCACCGAGATCTACACCTGGAGACCTGAGCGGCTGTCTCCACAAGT
rpp30_F_976_CTAGCTGTTA	AATGATACGGCGACCACCGAGATCTACACCTAGCTGTTAGAGCGGCTGTCTCCACAAGT
rpp30_F_977_AGCTATGCCA	AATGATACGGCGACCACCGAGATCTACACAGCTATGCCAGAGCGGCTGTCTCCACAAGT
rpp30_F_978_CCGCACAATA	AATGATACGGCGACCACCGAGATCTACACCCGCACAATAGAGCGGCTGTCTCCACAAGT
rpp30_F_979_GACTCATCGT	AATGATACGGCGACCACCGAGATCTACACGACTCATCGTGAGCGGCTGTCTCCACAAGT
rpp30_F_980_TCACGGTAGG	AATGATACGGCGACCACCGAGATCTACACTCACGGTAGGGAGCGGCTGTCTCCACAAGT
rpp30_F_981_CACGCCTTAT	AATGATACGGCGACCACCGAGATCTACACCACGCCTTATGAGCGGCTGTCTCCACAAGT
rpp30_F_982_TCAACGACTT	AATGATACGGCGACCACCGAGATCTACACTCAACGACTTGAGCGGCTGTCTCCACAAGT
rpp30_F_983_ACCGTTGCTA	AATGATACGGCGACCACCGAGATCTACACACCGTTGCTAGAGCGGCTGTCTCCACAAGT
rpp30_F_984_AAGTCGAACT	AATGATACGGCGACCACCGAGATCTACACAAGTCGAACTGAGCGGCTGTCTCCACAAGT
rpp30_F_985_TAGTCGAAGG	AATGATACGGCGACCACCGAGATCTACACTAGTCGAAGGGAGCGGCTGTCTCCACAAGT
rpp30_F_986_GAATATTGCC	AATGATACGGCGACCACCGAGATCTACACGAATATTGCCGAGCGGCTGTCTCCACAAGT
rpp30_F_987_TGTGAACCTT	AATGATACGGCGACCACCGAGATCTACACTGTGAACCTTGAGCGGCTGTCTCCACAAGT
rpp30_F_988_TTGTCTCACA	AATGATACGGCGACCACCGAGATCTACACTTGTCTCACAGAGCGGCTGTCTCCACAAGT
rpp30_F_989_GTATTCGTTC	AATGATACGGCGACCACCGAGATCTACACGTATTCGTTCGAGCGGCTGTCTCCACAAGT
rpp30_F_990_ATGGCAAGAT	AATGATACGGCGACCACCGAGATCTACACATGGCAAGATGAGCGGCTGTCTCCACAAGT
rpp30_F_991_ACTCTAGAGG	AATGATACGGCGACCACCGAGATCTACACACTCTAGAGGGAGCGGCTGTCTCCACAAGT
rpp30_F_992_TCCGGTCCTT	AATGATACGGCGACCACCGAGATCTACACTCCGGTCCTTGAGCGGCTGTCTCCACAAGT
rpp30_F_993_GTGTCCTAGC	AATGATACGGCGACCACCGAGATCTACACGTGTCCTAGCGAGCGGCTGTCTCCACAAGT
rpp30_F_994_ACCATGCATC	AATGATACGGCGACCACCGAGATCTACACACCATGCATCGAGCGGCTGTCTCCACAAGT
rpp30_F_995_CCATCGCTAA	AATGATACGGCGACCACCGAGATCTACACCCATCGCTAAGAGCGGCTGTCTCCACAAGT
rpp30_F_996_CTGTACGTAG	AATGATACGGCGACCACCGAGATCTACACCTGTACGTAGGAGCGGCTGTCTCCACAAGT
rpp30_F_997_CGCCAACTAA	AATGATACGGCGACCACCGAGATCTACACCGCCAACTAAGAGCGGCTGTCTCCACAAGT
rpp30_F_998_TCAGAGCTGT	AATGATACGGCGACCACCGAGATCTACACTCAGAGCTGTGAGCGGCTGTCTCCACAAGT
rpp30_F_999_AGTGTGCATT	AATGATACGGCGACCACCGAGATCTACACAGTGTGCATTGAGCGGCTGTCTCCACAAGT
rpp30_F_1000_GTAATCGCGG	AATGATACGGCGACCACCGAGATCTACACGTAATCGCGGGAGCGGCTGTCTCCACAAGT
rpp30_F_1001_CGAGACATTG	AATGATACGGCGACCACCGAGATCTACACCGAGACATTGGAGCGGCTGTCTCCACAAGT
rpp30_F_1002_CGTTATCCGG	AATGATACGGCGACCACCGAGATCTACACCGTTATCCGGGAGCGGCTGTCTCCACAAGT
rpp30_F_1003_GCTGGACACT	AATGATACGGCGACCACCGAGATCTACACGCTGGACACTGAGCGGCTGTCTCCACAAGT
rpp30_F_1004_AACTACGGTA	AATGATACGGCGACCACCGAGATCTACACAACTACGGTAGAGCGGCTGTCTCCACAAGT
rpp30_F_1005_AGGTGTCACC	AATGATACGGCGACCACCGAGATCTACACAGGTGTCACCGAGCGGCTGTCTCCACAAGT
rpp30_F_1006_GGAGTAGTCG	AATGATACGGCGACCACCGAGATCTACACGGAGTAGTCGGAGCGGCTGTCTCCACAAGT
rpp30_F_1007_GTATCGTGAC	AATGATACGGCGACCACCGAGATCTACACGTATCGTGACGAGCGGCTGTCTCCACAAGT
rpp30_F_1008_GGCTGGTGAA	AATGATACGGCGACCACCGAGATCTACACGGCTGGTGAAGAGCGGCTGTCTCCACAAGT
rpp30_F_1009_GTCACGGCTT	AATGATACGGCGACCACCGAGATCTACACGTCACGGCTTGAGCGGCTGTCTCCACAAGT
rpp30_F_1010_AACATGTGTC	AATGATACGGCGACCACCGAGATCTACACAACATGTGTCGAGCGGCTGTCTCCACAAGT
rpp30_F_1011_CCACGCATGA	AATGATACGGCGACCACCGAGATCTACACCCACGCATGAGAGCGGCTGTCTCCACAAGT
rpp30_F_1012_ATCGTACGCT	AATGATACGGCGACCACCGAGATCTACACATCGTACGCTGAGCGGCTGTCTCCACAAGT
rpp30_F_1013_AGTGTCCTTC	AATGATACGGCGACCACCGAGATCTACACAGTGTCCTTCGAGCGGCTGTCTCCACAAGT
rpp30_F_1014_ACCTTCTCCG	AATGATACGGCGACCACCGAGATCTACACACCTTCTCCGGAGCGGCTGTCTCCACAAGT
rpp30_F_1015_CTATCTCAGC	AATGATACGGCGACCACCGAGATCTACACCTATCTCAGCGAGCGGCTGTCTCCACAAGT
rpp30_F_1016_TAGACTCAGC	AATGATACGGCGACCACCGAGATCTACACTAGACTCAGCGAGCGGCTGTCTCCACAAGT
rpp30_F_1017_GCTTACCGTG	AATGATACGGCGACCACCGAGATCTACACGCTTACCGTGGAGCGGCTGTCTCCACAAGT
rpp30_F_1018_GCATAGATCC	AATGATACGGCGACCACCGAGATCTACACGCATAGATCCGAGCGGCTGTCTCCACAAGT
rpp30_F_1019_AGCCACACGA	AATGATACGGCGACCACCGAGATCTACACAGCCACACGAGAGCGGCTGTCTCCACAAGT
rpp30_F_1020_CGACACAAGT	AATGATACGGCGACCACCGAGATCTACACCGACACAAGTGAGCGGCTGTCTCCACAAGT
rpp30_F_1021_AAGGCGTGAT	AATGATACGGCGACCACCGAGATCTACACAAGGCGTGATGAGCGGCTGTCTCCACAAGT
rpp30_F_1022_GTGTCTGCTT	AATGATACGGCGACCACCGAGATCTACACGTGTCTGCTTGAGCGGCTGTCTCCACAAGT
rpp30_F_1023_GTGATAGACG	AATGATACGGCGACCACCGAGATCTACACGTGATAGACGGAGCGGCTGTCTCCACAAGT
rpp30_F_1024_CTAGACAAGC	AATGATACGGCGACCACCGAGATCTACACCTAGACAAGCGAGCGGCTGTCTCCACAAGT
rpp30_F_1025_GAAGCGCCTT	AATGATACGGCGACCACCGAGATCTACACGAAGCGCCTTGAGCGGCTGTCTCCACAAGT
rpp30_F_1026_GTGACAGTAA	AATGATACGGCGACCACCGAGATCTACACGTGACAGTAAGAGCGGCTGTCTCCACAAGT
rpp30_F_1027_GTTAAGACGT	AATGATACGGCGACCACCGAGATCTACACGTTAAGACGTGAGCGGCTGTCTCCACAAGT
rpp30_F_1028_GAGCTTAACA	AATGATACGGCGACCACCGAGATCTACACGAGCTTAACAGAGCGGCTGTCTCCACAAGT
rpp30_F_1029_AACAAGGCGT	AATGATACGGCGACCACCGAGATCTACACAACAAGGCGTGAGCGGCTGTCTCCACAAGT
rpp30_F_1030_GAGATCCGTC	AATGATACGGCGACCACCGAGATCTACACGAGATCCGTCGAGCGGCTGTCTCCACAAGT
rpp30_F_1031_TGAACTGTGA	AATGATACGGCGACCACCGAGATCTACACTGAACTGTGAGAGCGGCTGTCTCCACAAGT
rpp30_F_1032_GCAAGCGATG	AATGATACGGCGACCACCGAGATCTACACGCAAGCGATGGAGCGGCTGTCTCCACAAGT
rpp30_F_1033_ACTCGTACTT	AATGATACGGCGACCACCGAGATCTACACACTCGTACTTGAGCGGCTGTCTCCACAAGT
rpp30_F_1034_ACCGCATCCT	AATGATACGGCGACCACCGAGATCTACACACCGCATCCTGAGCGGCTGTCTCCACAAGT
rpp30_F_1035_AAGTACCTAG	AATGATACGGCGACCACCGAGATCTACACAAGTACCTAGGAGCGGCTGTCTCCACAAGT
rpp30_F_1036_CCGTATCTAA	AATGATACGGCGACCACCGAGATCTACACCCGTATCTAAGAGCGGCTGTCTCCACAAGT
rpp30_F_1037_AACTCACGGC	AATGATACGGCGACCACCGAGATCTACACAACTCACGGCGAGCGGCTGTCTCCACAAGT
rpp30_F_1038_CGAGCATCAT	AATGATACGGCGACCACCGAGATCTACACCGAGCATCATGAGCGGCTGTCTCCACAAGT
rpp30_F_1039_GGAACCTAGC	AATGATACGGCGACCACCGAGATCTACACGGAACCTAGCGAGCGGCTGTCTCCACAAGT
rpp30_F_1040_TCGTTGCCTG	AATGATACGGCGACCACCGAGATCTACACTCGTTGCCTGGAGCGGCTGTCTCCACAAGT
rpp30_F_1041_TTGAAGCTGA	AATGATACGGCGACCACCGAGATCTACACTTGAAGCTGAGAGCGGCTGTCTCCACAAGT
rpp30_F_1042_GTGTCTCTGA	AATGATACGGCGACCACCGAGATCTACACGTGTCTCTGAGAGCGGCTGTCTCCACAAGT
rpp30_F_1043_GAACGGACAC	AATGATACGGCGACCACCGAGATCTACACGAACGGACACGAGCGGCTGTCTCCACAAGT
rpp30_F_1044_TCGAGGCTAT	AATGATACGGCGACCACCGAGATCTACACTCGAGGCTATGAGCGGCTGTCTCCACAAGT
rpp30_F_1045_GACAAGGTTC	AATGATACGGCGACCACCGAGATCTACACGACAAGGTTCGAGCGGCTGTCTCCACAAGT
rpp30_F_1046_CGGCATGATC	AATGATACGGCGACCACCGAGATCTACACCGGCATGATCGAGCGGCTGTCTCCACAAGT
rpp30_F_1047_CAACGTCTAA	AATGATACGGCGACCACCGAGATCTACACCAACGTCTAAGAGCGGCTGTCTCCACAAGT
rpp30_F_1048_GATCGCTATA	AATGATACGGCGACCACCGAGATCTACACGATCGCTATAGAGCGGCTGTCTCCACAAGT
rpp30_F_1049_GCTGTTGTTA	AATGATACGGCGACCACCGAGATCTACACGCTGTTGTTAGAGCGGCTGTCTCCACAAGT
rpp30_F_1050_TTCGAGTCAG	AATGATACGGCGACCACCGAGATCTACACTTCGAGTCAGGAGCGGCTGTCTCCACAAGT
rpp30_F_1051_TGGCTGTTCA	AATGATACGGCGACCACCGAGATCTACACTGGCTGTTCAGAGCGGCTGTCTCCACAAGT
rpp30_F_1052_TTAAGGTCGG	AATGATACGGCGACCACCGAGATCTACACTTAAGGTCGGGAGCGGCTGTCTCCACAAGT
rpp30_F_1053_ATGAGGCGAG	AATGATACGGCGACCACCGAGATCTACACATGAGGCGAGGAGCGGCTGTCTCCACAAGT
rpp30_F_1054_CGCGTAGTAA	AATGATACGGCGACCACCGAGATCTACACCGCGTAGTAAGAGCGGCTGTCTCCACAAGT
rpp30_F_1055_TTAGCAGATC	AATGATACGGCGACCACCGAGATCTACACTTAGCAGATCGAGCGGCTGTCTCCACAAGT
rpp30_F_1056_ATGGCTTCAG	AATGATACGGCGACCACCGAGATCTACACATGGCTTCAGGAGCGGCTGTCTCCACAAGT
rpp30_F_1057_TCTTGTCAGC	AATGATACGGCGACCACCGAGATCTACACTCTTGTCAGCGAGCGGCTGTCTCCACAAGT
rpp30_F_1058_TCTAGACTGG	AATGATACGGCGACCACCGAGATCTACACTCTAGACTGGGAGCGGCTGTCTCCACAAGT
rpp30_F_1059_CCGCTGGAAT	AATGATACGGCGACCACCGAGATCTACACCCGCTGGAATGAGCGGCTGTCTCCACAAGT
rpp30_F_1060_CGTCGAATAC	AATGATACGGCGACCACCGAGATCTACACCGTCGAATACGAGCGGCTGTCTCCACAAGT
rpp30_F_1061_AACCTCGGAA	AATGATACGGCGACCACCGAGATCTACACAACCTCGGAAGAGCGGCTGTCTCCACAAGT
rpp30_F_1062_TGCCTATCCG	AATGATACGGCGACCACCGAGATCTACACTGCCTATCCGGAGCGGCTGTCTCCACAAGT
rpp30_F_1063_GGTATACCTA	AATGATACGGCGACCACCGAGATCTACACGGTATACCTAGAGCGGCTGTCTCCACAAGT
rpp30_F_1064_ATGTAACGGC	AATGATACGGCGACCACCGAGATCTACACATGTAACGGCGAGCGGCTGTCTCCACAAGT
rpp30_F_1065_CTTGTACAAC	AATGATACGGCGACCACCGAGATCTACACCTTGTACAACGAGCGGCTGTCTCCACAAGT
rpp30_F_1066_AATCACGCCT	AATGATACGGCGACCACCGAGATCTACACAATCACGCCTGAGCGGCTGTCTCCACAAGT
rpp30_F_1067_ACACATAGCG	AATGATACGGCGACCACCGAGATCTACACACACATAGCGGAGCGGCTGTCTCCACAAGT
rpp30_F_1068_ACATCGATGC	AATGATACGGCGACCACCGAGATCTACACACATCGATGCGAGCGGCTGTCTCCACAAGT
rpp30_F_1069_AGAGATGTTC	AATGATACGGCGACCACCGAGATCTACACAGAGATGTTCGAGCGGCTGTCTCCACAAGT
rpp30_F_1070_AGATAGTCCG	AATGATACGGCGACCACCGAGATCTACACAGATAGTCCGGAGCGGCTGTCTCCACAAGT
rpp30_F_1071_AGGACTACAC	AATGATACGGCGACCACCGAGATCTACACAGGACTACACGAGCGGCTGTCTCCACAAGT
rpp30_F_1072_AGGTTCTAAC	AATGATACGGCGACCACCGAGATCTACACAGGTTCTAACGAGCGGCTGTCTCCACAAGT
rpp30_F_1073_AGTGATTCAC	AATGATACGGCGACCACCGAGATCTACACAGTGATTCACGAGCGGCTGTCTCCACAAGT
rpp30_F_1074_ATAGATGCGG	AATGATACGGCGACCACCGAGATCTACACATAGATGCGGGAGCGGCTGTCTCCACAAGT
rpp30_F_1075_ATCCAGCTAA	AATGATACGGCGACCACCGAGATCTACACATCCAGCTAAGAGCGGCTGTCTCCACAAGT
rpp30_F_1076_CACACCTGGA	AATGATACGGCGACCACCGAGATCTACACCACACCTGGAGAGCGGCTGTCTCCACAAGT
rpp30_F_1077_CCGCGACTAA	AATGATACGGCGACCACCGAGATCTACACCCGCGACTAAGAGCGGCTGTCTCCACAAGT
rpp30_F_1078_CCTACGAGTC	AATGATACGGCGACCACCGAGATCTACACCCTACGAGTCGAGCGGCTGTCTCCACAAGT
rpp30_F_1079_CGTTCCAGAG	AATGATACGGCGACCACCGAGATCTACACCGTTCCAGAGGAGCGGCTGTCTCCACAAGT
rpp30_F_1080_CTGGAGGCTA	AATGATACGGCGACCACCGAGATCTACACCTGGAGGCTAGAGCGGCTGTCTCCACAAGT
rpp30_F_1081_GCAAGGTAAC	AATGATACGGCGACCACCGAGATCTACACGCAAGGTAACGAGCGGCTGTCTCCACAAGT
rpp30_F_1082_GCCTAGAATT	AATGATACGGCGACCACCGAGATCTACACGCCTAGAATTGAGCGGCTGTCTCCACAAGT
rpp30_F_1083_GCCTGTTATT	AATGATACGGCGACCACCGAGATCTACACGCCTGTTATTGAGCGGCTGTCTCCACAAGT
rpp30_F_1084_GCGGACGATA	AATGATACGGCGACCACCGAGATCTACACGCGGACGATAGAGCGGCTGTCTCCACAAGT
rpp30_F_1085_GCGTCACCAA	AATGATACGGCGACCACCGAGATCTACACGCGTCACCAAGAGCGGCTGTCTCCACAAGT
rpp30_F_1086_GCTGAATGCT	AATGATACGGCGACCACCGAGATCTACACGCTGAATGCTGAGCGGCTGTCTCCACAAGT
rpp30_F_1087_GGAAGTACAA	AATGATACGGCGACCACCGAGATCTACACGGAAGTACAAGAGCGGCTGTCTCCACAAGT
rpp30_F_1088_GGACTTGCGA	AATGATACGGCGACCACCGAGATCTACACGGACTTGCGAGAGCGGCTGTCTCCACAAGT
rpp30_F_1089_GTCGAGGATG	AATGATACGGCGACCACCGAGATCTACACGTCGAGGATGGAGCGGCTGTCTCCACAAGT
rpp30_F_1090_GTCGGACCTA	AATGATACGGCGACCACCGAGATCTACACGTCGGACCTAGAGCGGCTGTCTCCACAAGT
rpp30_F_1091_TAGAGGTCTA	AATGATACGGCGACCACCGAGATCTACACTAGAGGTCTAGAGCGGCTGTCTCCACAAGT
rpp30_F_1092_TAGTGAGACC	AATGATACGGCGACCACCGAGATCTACACTAGTGAGACCGAGCGGCTGTCTCCACAAGT
rpp30_F_1093_TATAGGCGAA	AATGATACGGCGACCACCGAGATCTACACTATAGGCGAAGAGCGGCTGTCTCCACAAGT
rpp30_F_1094_TCAATTGGCG	AATGATACGGCGACCACCGAGATCTACACTCAATTGGCGGAGCGGCTGTCTCCACAAGT
rpp30_F_1095_TCCAGCTAGG	AATGATACGGCGACCACCGAGATCTACACTCCAGCTAGGGAGCGGCTGTCTCCACAAGT
rpp30_F_1096_TGTTGCCAGA	AATGATACGGCGACCACCGAGATCTACACTGTTGCCAGAGAGCGGCTGTCTCCACAAGT
rpp30_F_1097_GAGGTGAGAC	AATGATACGGCGACCACCGAGATCTACACGAGGTGAGACGAGCGGCTGTCTCCACAAGT
rpp30_F_1098_AGGCTGAATG	AATGATACGGCGACCACCGAGATCTACACAGGCTGAATGGAGCGGCTGTCTCCACAAGT
rpp30_F_1099_GACACGACGA	AATGATACGGCGACCACCGAGATCTACACGACACGACGAGAGCGGCTGTCTCCACAAGT
rpp30_F_1100_TCTACGACGA	AATGATACGGCGACCACCGAGATCTACACTCTACGACGAGAGCGGCTGTCTCCACAAGT
rpp30_F_1101_GGCACAATCC	AATGATACGGCGACCACCGAGATCTACACGGCACAATCCGAGCGGCTGTCTCCACAAGT
rpp30_F_1102_GAACTGATCC	AATGATACGGCGACCACCGAGATCTACACGAACTGATCCGAGCGGCTGTCTCCACAAGT
rpp30_F_1103_GAAGGACTCG	AATGATACGGCGACCACCGAGATCTACACGAAGGACTCGGAGCGGCTGTCTCCACAAGT
rpp30_F_1104_TAGCCTCTCA	AATGATACGGCGACCACCGAGATCTACACTAGCCTCTCAGAGCGGCTGTCTCCACAAGT
rpp30_F_1105_GACTACGTGA	AATGATACGGCGACCACCGAGATCTACACGACTACGTGAGAGCGGCTGTCTCCACAAGT
rpp30_F_1106_AGGCTTGGAG	AATGATACGGCGACCACCGAGATCTACACAGGCTTGGAGGAGCGGCTGTCTCCACAAGT
rpp30_F_1107_GCGAATATCA	AATGATACGGCGACCACCGAGATCTACACGCGAATATCAGAGCGGCTGTCTCCACAAGT
rpp30_F_1108_GCGATGATAT	AATGATACGGCGACCACCGAGATCTACACGCGATGATATGAGCGGCTGTCTCCACAAGT
rpp30_F_1109_ATATCCGGAT	AATGATACGGCGACCACCGAGATCTACACATATCCGGATGAGCGGCTGTCTCCACAAGT
rpp30_F_1110_TGACAGTGCC	AATGATACGGCGACCACCGAGATCTACACTGACAGTGCCGAGCGGCTGTCTCCACAAGT
rpp30_F_1111_ACCAGATGTC	AATGATACGGCGACCACCGAGATCTACACACCAGATGTCGAGCGGCTGTCTCCACAAGT
rpp30_F_1112_AGCTATCGTC	AATGATACGGCGACCACCGAGATCTACACAGCTATCGTCGAGCGGCTGTCTCCACAAGT
rpp30_F_1113_AGTCATTGTC	AATGATACGGCGACCACCGAGATCTACACAGTCATTGTCGAGCGGCTGTCTCCACAAGT
rpp30_F_1114_GACAGCGTTA	AATGATACGGCGACCACCGAGATCTACACGACAGCGTTAGAGCGGCTGTCTCCACAAGT
rpp30_F_1115_GCCAACTCAG	AATGATACGGCGACCACCGAGATCTACACGCCAACTCAGGAGCGGCTGTCTCCACAAGT
rpp30_F_1116_GCCAAGTAAT	AATGATACGGCGACCACCGAGATCTACACGCCAAGTAATGAGCGGCTGTCTCCACAAGT
rpp30_F_1117_GCCAATCCTT	AATGATACGGCGACCACCGAGATCTACACGCCAATCCTTGAGCGGCTGTCTCCACAAGT
rpp30_F_1118_GCCACCAATA	AATGATACGGCGACCACCGAGATCTACACGCCACCAATAGAGCGGCTGTCTCCACAAGT
rpp30_F_1119_GCCACGAGAT	AATGATACGGCGACCACCGAGATCTACACGCCACGAGATGAGCGGCTGTCTCCACAAGT
rpp30_F_1120_GCCACGTACA	AATGATACGGCGACCACCGAGATCTACACGCCACGTACAGAGCGGCTGTCTCCACAAGT
rpp30_F_1121_GCCACTCTCA	AATGATACGGCGACCACCGAGATCTACACGCCACTCTCAGAGCGGCTGTCTCCACAAGT
rpp30_F_1122_GCCAGTAGGT	AATGATACGGCGACCACCGAGATCTACACGCCAGTAGGTGAGCGGCTGTCTCCACAAGT
rpp30_F_1123_GCCAGTGAAG	AATGATACGGCGACCACCGAGATCTACACGCCAGTGAAGGAGCGGCTGTCTCCACAAGT
rpp30_F_1124_GCCATACCTG	AATGATACGGCGACCACCGAGATCTACACGCCATACCTGGAGCGGCTGTCTCCACAAGT
rpp30_F_1125_GCCATAGAGG	AATGATACGGCGACCACCGAGATCTACACGCCATAGAGGGAGCGGCTGTCTCCACAAGT
rpp30_F_1126_GCCATCCGAA	AATGATACGGCGACCACCGAGATCTACACGCCATCCGAAGAGCGGCTGTCTCCACAAGT
rpp30_F_1127_GCCATTCAAT	AATGATACGGCGACCACCGAGATCTACACGCCATTCAATGAGCGGCTGTCTCCACAAGT
rpp30_F_1128_TGAGTACTCC	AATGATACGGCGACCACCGAGATCTACACTGAGTACTCCGAGCGGCTGTCTCCACAAGT
rpp30_F_1129_TAGCAGCTAG	AATGATACGGCGACCACCGAGATCTACACTAGCAGCTAGGAGCGGCTGTCTCCACAAGT
rpp30_F_1130_GACGAACGTT	AATGATACGGCGACCACCGAGATCTACACGACGAACGTTGAGCGGCTGTCTCCACAAGT
rpp30_F_1131_ACGTGTCTGG	AATGATACGGCGACCACCGAGATCTACACACGTGTCTGGGAGCGGCTGTCTCCACAAGT
rpp30_F_1132_CGAGGTTACC	AATGATACGGCGACCACCGAGATCTACACCGAGGTTACCGAGCGGCTGTCTCCACAAGT
rpp30_F_1133_AAGTTGCAAG	AATGATACGGCGACCACCGAGATCTACACAAGTTGCAAGGAGCGGCTGTCTCCACAAGT
rpp30_F_1134_AGTCGGACAC	AATGATACGGCGACCACCGAGATCTACACAGTCGGACACGAGCGGCTGTCTCCACAAGT
rpp30_F_1135_AACCGCACAG	AATGATACGGCGACCACCGAGATCTACACAACCGCACAGGAGCGGCTGTCTCCACAAGT
rpp30_F_1136_CACGTTCAAC	AATGATACGGCGACCACCGAGATCTACACCACGTTCAACGAGCGGCTGTCTCCACAAGT
rpp30_F_1137_CTGGAGATTC	AATGATACGGCGACCACCGAGATCTACACCTGGAGATTCGAGCGGCTGTCTCCACAAGT
rpp30_F_1138_TGTCCGACGT	AATGATACGGCGACCACCGAGATCTACACTGTCCGACGTGAGCGGCTGTCTCCACAAGT
rpp30_F_1139_ATTGTCGAAC	AATGATACGGCGACCACCGAGATCTACACATTGTCGAACGAGCGGCTGTCTCCACAAGT
rpp30_F_1140_AGGCTGCCAA	AATGATACGGCGACCACCGAGATCTACACAGGCTGCCAAGAGCGGCTGTCTCCACAAGT
rpp30_F_1141_ACCACCATCC	AATGATACGGCGACCACCGAGATCTACACACCACCATCCGAGCGGCTGTCTCCACAAGT
rpp30_F_1142_GAGTGGTTAA	AATGATACGGCGACCACCGAGATCTACACGAGTGGTTAAGAGCGGCTGTCTCCACAAGT
rpp30_F_1143_AAGGCCGGTT	AATGATACGGCGACCACCGAGATCTACACAAGGCCGGTTGAGCGGCTGTCTCCACAAGT
rpp30_F_1144_CATGAGACGA	AATGATACGGCGACCACCGAGATCTACACCATGAGACGAGAGCGGCTGTCTCCACAAGT
rpp30_F_1145_TTGATCTGTC	AATGATACGGCGACCACCGAGATCTACACTTGATCTGTCGAGCGGCTGTCTCCACAAGT
rpp30_F_1146_GAGCCAACAT	AATGATACGGCGACCACCGAGATCTACACGAGCCAACATGAGCGGCTGTCTCCACAAGT
rpp30_F_1147_CAGTAGGCGA	AATGATACGGCGACCACCGAGATCTACACCAGTAGGCGAGAGCGGCTGTCTCCACAAGT
rpp30_F_1148_ACAGGAGATG	AATGATACGGCGACCACCGAGATCTACACACAGGAGATGGAGCGGCTGTCTCCACAAGT
rpp30_F_1149_GGCAGACATC	AATGATACGGCGACCACCGAGATCTACACGGCAGACATCGAGCGGCTGTCTCCACAAGT
rpp30_F_1150_ACGACGTAGT	AATGATACGGCGACCACCGAGATCTACACACGACGTAGTGAGCGGCTGTCTCCACAAGT
rpp30_F_1151_AGGCTCTGTA	AATGATACGGCGACCACCGAGATCTACACAGGCTCTGTAGAGCGGCTGTCTCCACAAGT
rpp30_F_1152_AACTGGCGTA	AATGATACGGCGACCACCGAGATCTACACAACTGGCGTAGAGCGGCTGTCTCCACAAGT
rpp30_F_1153_ATCGCATTAG	AATGATACGGCGACCACCGAGATCTACACATCGCATTAGGAGCGGCTGTCTCCACAAGT
rpp30_F_1154_ATCCATGATG	AATGATACGGCGACCACCGAGATCTACACATCCATGATGGAGCGGCTGTCTCCACAAGT
rpp30_F_1155_GCATCGTGTT	AATGATACGGCGACCACCGAGATCTACACGCATCGTGTTGAGCGGCTGTCTCCACAAGT
rpp30_F_1156_AGTACAGTTC	AATGATACGGCGACCACCGAGATCTACACAGTACAGTTCGAGCGGCTGTCTCCACAAGT
rpp30_F_1157_CATGACGAGC	AATGATACGGCGACCACCGAGATCTACACCATGACGAGCGAGCGGCTGTCTCCACAAGT
rpp30_F_1158_AGTGAAGCTG	AATGATACGGCGACCACCGAGATCTACACAGTGAAGCTGGAGCGGCTGTCTCCACAAGT
rpp30_F_1159_AATGAGGCCG	AATGATACGGCGACCACCGAGATCTACACAATGAGGCCGGAGCGGCTGTCTCCACAAGT
rpp30_F_1160_TCGTCGGTAC	AATGATACGGCGACCACCGAGATCTACACTCGTCGGTACGAGCGGCTGTCTCCACAAGT
rpp30_F_1161_GAGTTGCACA	AATGATACGGCGACCACCGAGATCTACACGAGTTGCACAGAGCGGCTGTCTCCACAAGT
rpp30_F_1162_AATCTGCATG	AATGATACGGCGACCACCGAGATCTACACAATCTGCATGGAGCGGCTGTCTCCACAAGT
rpp30_F_1163_AACCGTCAGC	AATGATACGGCGACCACCGAGATCTACACAACCGTCAGCGAGCGGCTGTCTCCACAAGT
rpp30_F_1164_ACTGCATGAG	AATGATACGGCGACCACCGAGATCTACACACTGCATGAGGAGCGGCTGTCTCCACAAGT
rpp30_F_1165_ACGGCTTATC	AATGATACGGCGACCACCGAGATCTACACACGGCTTATCGAGCGGCTGTCTCCACAAGT
rpp30_F_1166_GGTACAAGTT	AATGATACGGCGACCACCGAGATCTACACGGTACAAGTTGAGCGGCTGTCTCCACAAGT
rpp30_F_1167_GGACATAAGC	AATGATACGGCGACCACCGAGATCTACACGGACATAAGCGAGCGGCTGTCTCCACAAGT
rpp30_F_1168_AGCTGGACTA	AATGATACGGCGACCACCGAGATCTACACAGCTGGACTAGAGCGGCTGTCTCCACAAGT
rpp30_F_1169_AACTGCCAAG	AATGATACGGCGACCACCGAGATCTACACAACTGCCAAGGAGCGGCTGTCTCCACAAGT
rpp30_F_1170_TGCGCCTGAA	AATGATACGGCGACCACCGAGATCTACACTGCGCCTGAAGAGCGGCTGTCTCCACAAGT
rpp30_F_1171_CTATCGAATC	AATGATACGGCGACCACCGAGATCTACACCTATCGAATCGAGCGGCTGTCTCCACAAGT
rpp30_F_1172_TTCTGCAATC	AATGATACGGCGACCACCGAGATCTACACTTCTGCAATCGAGCGGCTGTCTCCACAAGT
rpp30_F_1173_GTTGTGGCAC	AATGATACGGCGACCACCGAGATCTACACGTTGTGGCACGAGCGGCTGTCTCCACAAGT
rpp30_F_1174_CTGAAGGTGT	AATGATACGGCGACCACCGAGATCTACACCTGAAGGTGTGAGCGGCTGTCTCCACAAGT
rpp30_F_1175_AGTAACCGCT	AATGATACGGCGACCACCGAGATCTACACAGTAACCGCTGAGCGGCTGTCTCCACAAGT
rpp30_F_1176_AGGTAATCAC	AATGATACGGCGACCACCGAGATCTACACAGGTAATCACGAGCGGCTGTCTCCACAAGT
rpp30_F_1177_AAGCTAGCAA	AATGATACGGCGACCACCGAGATCTACACAAGCTAGCAAGAGCGGCTGTCTCCACAAGT
rpp30_F_1178_ACCGTTAATC	AATGATACGGCGACCACCGAGATCTACACACCGTTAATCGAGCGGCTGTCTCCACAAGT
rpp30_F_1179_AGAGGAGCTA	AATGATACGGCGACCACCGAGATCTACACAGAGGAGCTAGAGCGGCTGTCTCCACAAGT
rpp30_F_1180_AGGAGATTAG	AATGATACGGCGACCACCGAGATCTACACAGGAGATTAGGAGCGGCTGTCTCCACAAGT
rpp30_F_1181_GCCTGTACAC	AATGATACGGCGACCACCGAGATCTACACGCCTGTACACGAGCGGCTGTCTCCACAAGT
rpp30_F_1182_GCTGTGAATT	AATGATACGGCGACCACCGAGATCTACACGCTGTGAATTGAGCGGCTGTCTCCACAAGT
rpp30_F_1183_CATTCGTTAC	AATGATACGGCGACCACCGAGATCTACACCATTCGTTACGAGCGGCTGTCTCCACAAGT
rpp30_F_1184_GCACTCAATT	AATGATACGGCGACCACCGAGATCTACACGCACTCAATTGAGCGGCTGTCTCCACAAGT
rpp30_F_1185_AGTCAGACTG	AATGATACGGCGACCACCGAGATCTACACAGTCAGACTGGAGCGGCTGTCTCCACAAGT
rpp30_F_1186_CGACACATCC	AATGATACGGCGACCACCGAGATCTACACCGACACATCCGAGCGGCTGTCTCCACAAGT
rpp30_F_1187_CGAGCAGTTC	AATGATACGGCGACCACCGAGATCTACACCGAGCAGTTCGAGCGGCTGTCTCCACAAGT
rpp30_F_1188_AGATGGAACA	AATGATACGGCGACCACCGAGATCTACACAGATGGAACAGAGCGGCTGTCTCCACAAGT
rpp30_F_1189_AATGTAGACG	AATGATACGGCGACCACCGAGATCTACACAATGTAGACGGAGCGGCTGTCTCCACAAGT
rpp30_F_1190_CCTCGCCTTA	AATGATACGGCGACCACCGAGATCTACACCCTCGCCTTAGAGCGGCTGTCTCCACAAGT
rpp30_F_1191_GGTACGACAC	AATGATACGGCGACCACCGAGATCTACACGGTACGACACGAGCGGCTGTCTCCACAAGT
rpp30_F_1192_GCTTCACGAC	AATGATACGGCGACCACCGAGATCTACACGCTTCACGACGAGCGGCTGTCTCCACAAGT
rpp30_F_1193_GTCGAAGACC	AATGATACGGCGACCACCGAGATCTACACGTCGAAGACCGAGCGGCTGTCTCCACAAGT
rpp30_F_1194_CGAGTGCTTC	AATGATACGGCGACCACCGAGATCTACACCGAGTGCTTCGAGCGGCTGTCTCCACAAGT
rpp30_F_1195_CGGACATTAC	AATGATACGGCGACCACCGAGATCTACACCGGACATTACGAGCGGCTGTCTCCACAAGT
rpp30_F_1196_ATGTCTGGTG	AATGATACGGCGACCACCGAGATCTACACATGTCTGGTGGAGCGGCTGTCTCCACAAGT
rpp30_F_1197_TCTAGGCGTT	AATGATACGGCGACCACCGAGATCTACACTCTAGGCGTTGAGCGGCTGTCTCCACAAGT
rpp30_F_1198_CATAATCAGC	AATGATACGGCGACCACCGAGATCTACACCATAATCAGCGAGCGGCTGTCTCCACAAGT
rpp30_F_1199_AGATTAGGAG	AATGATACGGCGACCACCGAGATCTACACAGATTAGGAGGAGCGGCTGTCTCCACAAGT
rpp30_F_1200_ATCAGAGGAG	AATGATACGGCGACCACCGAGATCTACACATCAGAGGAGGAGCGGCTGTCTCCACAAGT
rpp30_F_1201_CTAGAAGGAG	AATGATACGGCGACCACCGAGATCTACACCTAGAAGGAGGAGCGGCTGTCTCCACAAGT
rpp30_F_1202_CTCTGCGGTT	AATGATACGGCGACCACCGAGATCTACACCTCTGCGGTTGAGCGGCTGTCTCCACAAGT
rpp30_F_1203_TCGAGAACAG	AATGATACGGCGACCACCGAGATCTACACTCGAGAACAGGAGCGGCTGTCTCCACAAGT
rpp30_F_1204_CCAGACTACA	AATGATACGGCGACCACCGAGATCTACACCCAGACTACAGAGCGGCTGTCTCCACAAGT
rpp30_F_1205_CGAACCTACA	AATGATACGGCGACCACCGAGATCTACACCGAACCTACAGAGCGGCTGTCTCCACAAGT
rpp30_F_1206_GAGAGTTACA	AATGATACGGCGACCACCGAGATCTACACGAGAGTTACAGAGCGGCTGTCTCCACAAGT
rpp30_F_1207_AGAGAACGGC	AATGATACGGCGACCACCGAGATCTACACAGAGAACGGCGAGCGGCTGTCTCCACAAGT
rpp30_F_1208_TACCGATGAC	AATGATACGGCGACCACCGAGATCTACACTACCGATGACGAGCGGCTGTCTCCACAAGT
rpp30_F_1209_AGTGAGGAAC	AATGATACGGCGACCACCGAGATCTACACAGTGAGGAACGAGCGGCTGTCTCCACAAGT
rpp30_F_1210_TGGTACATAC	AATGATACGGCGACCACCGAGATCTACACTGGTACATACGAGCGGCTGTCTCCACAAGT
rpp30_F_1211_AGATGCCTAG	AATGATACGGCGACCACCGAGATCTACACAGATGCCTAGGAGCGGCTGTCTCCACAAGT
rpp30_F_1212_GTGAAGGACT	AATGATACGGCGACCACCGAGATCTACACGTGAAGGACTGAGCGGCTGTCTCCACAAGT
rpp30_F_1213_GTGACACACT	AATGATACGGCGACCACCGAGATCTACACGTGACACACTGAGCGGCTGTCTCCACAAGT
rpp30_F_1214_TACTTCACAG	AATGATACGGCGACCACCGAGATCTACACTACTTCACAGGAGCGGCTGTCTCCACAAGT
rpp30_F_1215_TGAATCACAG	AATGATACGGCGACCACCGAGATCTACACTGAATCACAGGAGCGGCTGTCTCCACAAGT
rpp30_F_1216_TTCCACACAG	AATGATACGGCGACCACCGAGATCTACACTTCCACACAGGAGCGGCTGTCTCCACAAGT
rpp30_F_1217_GCGGTATAGC	AATGATACGGCGACCACCGAGATCTACACGCGGTATAGCGAGCGGCTGTCTCCACAAGT
rpp30_F_1218_GGACGGCTAT	AATGATACGGCGACCACCGAGATCTACACGGACGGCTATGAGCGGCTGTCTCCACAAGT
rpp30_F_1219_GGAGGCAATA	AATGATACGGCGACCACCGAGATCTACACGGAGGCAATAGAGCGGCTGTCTCCACAAGT
rpp30_F_1220_TGTCGAACAG	AATGATACGGCGACCACCGAGATCTACACTGTCGAACAGGAGCGGCTGTCTCCACAAGT
rpp30_F_1221_TGTCGATGAT	AATGATACGGCGACCACCGAGATCTACACTGTCGATGATGAGCGGCTGTCTCCACAAGT
rpp30_F_1222_ATCCGCCTAT	AATGATACGGCGACCACCGAGATCTACACATCCGCCTATGAGCGGCTGTCTCCACAAGT
rpp30_F_1223_CAGAGCTTCG	AATGATACGGCGACCACCGAGATCTACACCAGAGCTTCGGAGCGGCTGTCTCCACAAGT
rpp30_F_1224_GCACTCATGG	AATGATACGGCGACCACCGAGATCTACACGCACTCATGGGAGCGGCTGTCTCCACAAGT
rpp30_F_1225_TTCGAGGTGT	AATGATACGGCGACCACCGAGATCTACACTTCGAGGTGTGAGCGGCTGTCTCCACAAGT
rpp30_F_1226_TCAAGCTTAG	AATGATACGGCGACCACCGAGATCTACACTCAAGCTTAGGAGCGGCTGTCTCCACAAGT
rpp30_F_1227_TCGTGTACTT	AATGATACGGCGACCACCGAGATCTACACTCGTGTACTTGAGCGGCTGTCTCCACAAGT
rpp30_F_1228_ATAGCAGTCA	AATGATACGGCGACCACCGAGATCTACACATAGCAGTCAGAGCGGCTGTCTCCACAAGT
rpp30_F_1229_GTCTGAGGCT	AATGATACGGCGACCACCGAGATCTACACGTCTGAGGCTGAGCGGCTGTCTCCACAAGT
rpp30_F_1230_TACGTGGATC	AATGATACGGCGACCACCGAGATCTACACTACGTGGATCGAGCGGCTGTCTCCACAAGT
rpp30_F_1231_TGCGATGAGC	AATGATACGGCGACCACCGAGATCTACACTGCGATGAGCGAGCGGCTGTCTCCACAAGT
rpp30_F_1232_GCAACTGCCA	AATGATACGGCGACCACCGAGATCTACACGCAACTGCCAGAGCGGCTGTCTCCACAAGT
rpp30_F_1233_GAGGATCTTG	AATGATACGGCGACCACCGAGATCTACACGAGGATCTTGGAGCGGCTGTCTCCACAAGT
rpp30_F_1234_GGACGTCATG	AATGATACGGCGACCACCGAGATCTACACGGACGTCATGGAGCGGCTGTCTCCACAAGT
rpp30_F_1235_CTGATTGTGG	AATGATACGGCGACCACCGAGATCTACACCTGATTGTGGGAGCGGCTGTCTCCACAAGT
rpp30_F_1236_GTCCAGTCTG	AATGATACGGCGACCACCGAGATCTACACGTCCAGTCTGGAGCGGCTGTCTCCACAAGT
rpp30_F_1237_AGGAGTCTCG	AATGATACGGCGACCACCGAGATCTACACAGGAGTCTCGGAGCGGCTGTCTCCACAAGT
rpp30_F_1238_TCAACAGACC	AATGATACGGCGACCACCGAGATCTACACTCAACAGACCGAGCGGCTGTCTCCACAAGT
rpp30_F_1239_ACGGATATGC	AATGATACGGCGACCACCGAGATCTACACACGGATATGCGAGCGGCTGTCTCCACAAGT
rpp30_F_1240_GGTTACCAAC	AATGATACGGCGACCACCGAGATCTACACGGTTACCAACGAGCGGCTGTCTCCACAAGT
rpp30_F_1241_CACAGTACTG	AATGATACGGCGACCACCGAGATCTACACCACAGTACTGGAGCGGCTGTCTCCACAAGT
rpp30_F_1242_TGCTACTGTC	AATGATACGGCGACCACCGAGATCTACACTGCTACTGTCGAGCGGCTGTCTCCACAAGT
rpp30_F_1243_ACTCGTCGAA	AATGATACGGCGACCACCGAGATCTACACACTCGTCGAAGAGCGGCTGTCTCCACAAGT
rpp30_F_1244_CGATTCCTCG	AATGATACGGCGACCACCGAGATCTACACCGATTCCTCGGAGCGGCTGTCTCCACAAGT
rpp30_F_1245_AGCTTGAGCT	AATGATACGGCGACCACCGAGATCTACACAGCTTGAGCTGAGCGGCTGTCTCCACAAGT
rpp30_F_1246_ACCAGGTTCC	AATGATACGGCGACCACCGAGATCTACACACCAGGTTCCGAGCGGCTGTCTCCACAAGT
rpp30_F_1247_ACACCACCAT	AATGATACGGCGACCACCGAGATCTACACACACCACCATGAGCGGCTGTCTCCACAAGT
rpp30_F_1248_TGCGCTGCTA	AATGATACGGCGACCACCGAGATCTACACTGCGCTGCTAGAGCGGCTGTCTCCACAAGT
rpp30_F_1249_ATCGAGCCAC	AATGATACGGCGACCACCGAGATCTACACATCGAGCCACGAGCGGCTGTCTCCACAAGT
rpp30_F_1250_CGAGACAGAT	AATGATACGGCGACCACCGAGATCTACACCGAGACAGATGAGCGGCTGTCTCCACAAGT
rpp30_F_1251_ATTGACACAG	AATGATACGGCGACCACCGAGATCTACACATTGACACAGGAGCGGCTGTCTCCACAAGT
rpp30_F_1252_GGCCTTATGC	AATGATACGGCGACCACCGAGATCTACACGGCCTTATGCGAGCGGCTGTCTCCACAAGT
rpp30_F_1253_CGTCAACGGA	AATGATACGGCGACCACCGAGATCTACACCGTCAACGGAGAGCGGCTGTCTCCACAAGT
rpp30_F_1254_CATGGCAACC	AATGATACGGCGACCACCGAGATCTACACCATGGCAACCGAGCGGCTGTCTCCACAAGT
rpp30_F_1255_TTCCTGGCTG	AATGATACGGCGACCACCGAGATCTACACTTCCTGGCTGGAGCGGCTGTCTCCACAAGT
rpp30_F_1256_TACACTGCAA	AATGATACGGCGACCACCGAGATCTACACTACACTGCAAGAGCGGCTGTCTCCACAAGT
rpp30_F_1257_GCGTATCATC	AATGATACGGCGACCACCGAGATCTACACGCGTATCATCGAGCGGCTGTCTCCACAAGT
rpp30_F_1258_ATATCCAGTC	AATGATACGGCGACCACCGAGATCTACACATATCCAGTCGAGCGGCTGTCTCCACAAGT
rpp30_F_1259_GCCTAACTTC	AATGATACGGCGACCACCGAGATCTACACGCCTAACTTCGAGCGGCTGTCTCCACAAGT
rpp30_F_1260_CATTGTGACA	AATGATACGGCGACCACCGAGATCTACACCATTGTGACAGAGCGGCTGTCTCCACAAGT
rpp30_F_1261_GTGGTGCAAC	AATGATACGGCGACCACCGAGATCTACACGTGGTGCAACGAGCGGCTGTCTCCACAAGT
rpp30_F_1262_GGTTACTCGA	AATGATACGGCGACCACCGAGATCTACACGGTTACTCGAGAGCGGCTGTCTCCACAAGT
rpp30_F_1263_AGGATCACGG	AATGATACGGCGACCACCGAGATCTACACAGGATCACGGGAGCGGCTGTCTCCACAAGT
rpp30_F_1264_GCCTATATAG	AATGATACGGCGACCACCGAGATCTACACGCCTATATAGGAGCGGCTGTCTCCACAAGT
rpp30_F_1265_AACGCGGACA	AATGATACGGCGACCACCGAGATCTACACAACGCGGACAGAGCGGCTGTCTCCACAAGT
rpp30_F_1266_AACACGCTGA	AATGATACGGCGACCACCGAGATCTACACAACACGCTGAGAGCGGCTGTCTCCACAAGT
rpp30_F_1267_GTCTTGTCTC	AATGATACGGCGACCACCGAGATCTACACGTCTTGTCTCGAGCGGCTGTCTCCACAAGT
rpp30_F_1268_ACACTCGCGT	AATGATACGGCGACCACCGAGATCTACACACACTCGCGTGAGCGGCTGTCTCCACAAGT
rpp30_F_1269_CAACGAGTCA	AATGATACGGCGACCACCGAGATCTACACCAACGAGTCAGAGCGGCTGTCTCCACAAGT
rpp30_F_1270_AGCCAAGTTA	AATGATACGGCGACCACCGAGATCTACACAGCCAAGTTAGAGCGGCTGTCTCCACAAGT
rpp30_F_1271_AGCTCCTTCG	AATGATACGGCGACCACCGAGATCTACACAGCTCCTTCGGAGCGGCTGTCTCCACAAGT
rpp30_F_1272_GAGAGACTTC	AATGATACGGCGACCACCGAGATCTACACGAGAGACTTCGAGCGGCTGTCTCCACAAGT
rpp30_F_1273_TACCAGACGG	AATGATACGGCGACCACCGAGATCTACACTACCAGACGGGAGCGGCTGTCTCCACAAGT
rpp30_F_1274_CTAAGCCATC	AATGATACGGCGACCACCGAGATCTACACCTAAGCCATCGAGCGGCTGTCTCCACAAGT
rpp30_F_1275_CCATGAACAG	AATGATACGGCGACCACCGAGATCTACACCCATGAACAGGAGCGGCTGTCTCCACAAGT
rpp30_F_1276_GAATTGCGGC	AATGATACGGCGACCACCGAGATCTACACGAATTGCGGCGAGCGGCTGTCTCCACAAGT
rpp30_F_1277_TCGATCAGGC	AATGATACGGCGACCACCGAGATCTACACTCGATCAGGCGAGCGGCTGTCTCCACAAGT
rpp30_F_1278_TTAGGCTAAG	AATGATACGGCGACCACCGAGATCTACACTTAGGCTAAGGAGCGGCTGTCTCCACAAGT
rpp30_F_1279_GAAGGTACAG	AATGATACGGCGACCACCGAGATCTACACGAAGGTACAGGAGCGGCTGTCTCCACAAGT
rpp30_F_1280_CTAGAGGTCG	AATGATACGGCGACCACCGAGATCTACACCTAGAGGTCGGAGCGGCTGTCTCCACAAGT
rpp30_F_1281_TACAAGGTCG	AATGATACGGCGACCACCGAGATCTACACTACAAGGTCGGAGCGGCTGTCTCCACAAGT
rpp30_F_1282_AAGGCTCGGA	AATGATACGGCGACCACCGAGATCTACACAAGGCTCGGAGAGCGGCTGTCTCCACAAGT
rpp30_F_1283_ACAACGCCAG	AATGATACGGCGACCACCGAGATCTACACACAACGCCAGGAGCGGCTGTCTCCACAAGT
rpp30_F_1284_AGTAAGAACC	AATGATACGGCGACCACCGAGATCTACACAGTAAGAACCGAGCGGCTGTCTCCACAAGT
rpp30_F_1285_ACGCCAATGA	AATGATACGGCGACCACCGAGATCTACACACGCCAATGAGAGCGGCTGTCTCCACAAGT
rpp30_F_1286_ACGCCACGTA	AATGATACGGCGACCACCGAGATCTACACACGCCACGTAGAGCGGCTGTCTCCACAAGT
rpp30_F_1287_CAACATGTCC	AATGATACGGCGACCACCGAGATCTACACCAACATGTCCGAGCGGCTGTCTCCACAAGT
rpp30_F_1288_ATGCTCACAG	AATGATACGGCGACCACCGAGATCTACACATGCTCACAGGAGCGGCTGTCTCCACAAGT
rpp30_F_1289_ACTGCTTACA	AATGATACGGCGACCACCGAGATCTACACACTGCTTACAGAGCGGCTGTCTCCACAAGT
rpp30_F_1290_CGAAGCGCAA	AATGATACGGCGACCACCGAGATCTACACCGAAGCGCAAGAGCGGCTGTCTCCACAAGT
rpp30_F_1291_GAACACTCGG	AATGATACGGCGACCACCGAGATCTACACGAACACTCGGGAGCGGCTGTCTCCACAAGT
rpp30_F_1292_TACTACTCGG	AATGATACGGCGACCACCGAGATCTACACTACTACTCGGGAGCGGCTGTCTCCACAAGT
rpp30_F_1293_CATAGACTCG	AATGATACGGCGACCACCGAGATCTACACCATAGACTCGGAGCGGCTGTCTCCACAAGT
rpp30_F_1294_GGACAGGTTG	AATGATACGGCGACCACCGAGATCTACACGGACAGGTTGGAGCGGCTGTCTCCACAAGT
rpp30_F_1295_CAGAAGCAGA	AATGATACGGCGACCACCGAGATCTACACCAGAAGCAGAGAGCGGCTGTCTCCACAAGT
rpp30_F_1296_AACCGAGGTT	AATGATACGGCGACCACCGAGATCTACACAACCGAGGTTGAGCGGCTGTCTCCACAAGT
rpp30_F_1297_TTACTGAGTC	AATGATACGGCGACCACCGAGATCTACACTTACTGAGTCGAGCGGCTGTCTCCACAAGT
rpp30_F_1298_ATAACGGCGG	AATGATACGGCGACCACCGAGATCTACACATAACGGCGGGAGCGGCTGTCTCCACAAGT
rpp30_F_1299_CATTAGCCAG	AATGATACGGCGACCACCGAGATCTACACCATTAGCCAGGAGCGGCTGTCTCCACAAGT
rpp30_F_1300_CTCTAATGGC	AATGATACGGCGACCACCGAGATCTACACCTCTAATGGCGAGCGGCTGTCTCCACAAGT
rpp30_F_1301_GTCAAGCTCG	AATGATACGGCGACCACCGAGATCTACACGTCAAGCTCGGAGCGGCTGTCTCCACAAGT
rpp30_F_1302_GTTATGCTCC	AATGATACGGCGACCACCGAGATCTACACGTTATGCTCCGAGCGGCTGTCTCCACAAGT
rpp30_F_1303_AAGTAGATGC	AATGATACGGCGACCACCGAGATCTACACAAGTAGATGCGAGCGGCTGTCTCCACAAGT
rpp30_F_1304_TGCACTGTAT	AATGATACGGCGACCACCGAGATCTACACTGCACTGTATGAGCGGCTGTCTCCACAAGT
rpp30_F_1305_AGCACATCAA	AATGATACGGCGACCACCGAGATCTACACAGCACATCAAGAGCGGCTGTCTCCACAAGT
rpp30_F_1306_ACTAGGCTCG	AATGATACGGCGACCACCGAGATCTACACACTAGGCTCGGAGCGGCTGTCTCCACAAGT
rpp30_F_1307_CATCTGCTCG	AATGATACGGCGACCACCGAGATCTACACCATCTGCTCGGAGCGGCTGTCTCCACAAGT
rpp30_F_1308_GCGCAGTGAT	AATGATACGGCGACCACCGAGATCTACACGCGCAGTGATGAGCGGCTGTCTCCACAAGT
rpp30_F_1309_CATAAGGCTG	AATGATACGGCGACCACCGAGATCTACACCATAAGGCTGGAGCGGCTGTCTCCACAAGT
rpp30_F_1310_GATCACATGA	AATGATACGGCGACCACCGAGATCTACACGATCACATGAGAGCGGCTGTCTCCACAAGT
rpp30_F_1311_ACGGTAGTCC	AATGATACGGCGACCACCGAGATCTACACACGGTAGTCCGAGCGGCTGTCTCCACAAGT
rpp30_F_1312_AAGAGCTATC	AATGATACGGCGACCACCGAGATCTACACAAGAGCTATCGAGCGGCTGTCTCCACAAGT
rpp30_F_1313_CCTTCGAAGA	AATGATACGGCGACCACCGAGATCTACACCCTTCGAAGAGAGCGGCTGTCTCCACAAGT
rpp30_F_1314_CCACGAAGGT	AATGATACGGCGACCACCGAGATCTACACCCACGAAGGTGAGCGGCTGTCTCCACAAGT
rpp30_F_1315_CAAGCGTACC	AATGATACGGCGACCACCGAGATCTACACCAAGCGTACCGAGCGGCTGTCTCCACAAGT
rpp30_F_1316_CCTTCAGGCT	AATGATACGGCGACCACCGAGATCTACACCCTTCAGGCTGAGCGGCTGTCTCCACAAGT
rpp30_F_1317_GTGTGTTAAC	AATGATACGGCGACCACCGAGATCTACACGTGTGTTAACGAGCGGCTGTCTCCACAAGT
rpp30_F_1318_AAGACCGAGC	AATGATACGGCGACCACCGAGATCTACACAAGACCGAGCGAGCGGCTGTCTCCACAAGT
rpp30_F_1319_GTCGGTTACC	AATGATACGGCGACCACCGAGATCTACACGTCGGTTACCGAGCGGCTGTCTCCACAAGT
rpp30_F_1320_ATATCGGTCG	AATGATACGGCGACCACCGAGATCTACACATATCGGTCGGAGCGGCTGTCTCCACAAGT
rpp30_F_1321_GCGAACGGAT	AATGATACGGCGACCACCGAGATCTACACGCGAACGGATGAGCGGCTGTCTCCACAAGT
rpp30_F_1322_AGAGTGGCTG	AATGATACGGCGACCACCGAGATCTACACAGAGTGGCTGGAGCGGCTGTCTCCACAAGT
rpp30_F_1323_CAGGAGCATC	AATGATACGGCGACCACCGAGATCTACACCAGGAGCATCGAGCGGCTGTCTCCACAAGT
rpp30_F_1324_GCCAGACGTT	AATGATACGGCGACCACCGAGATCTACACGCCAGACGTTGAGCGGCTGTCTCCACAAGT
rpp30_F_1325_TGGCATGCTT	AATGATACGGCGACCACCGAGATCTACACTGGCATGCTTGAGCGGCTGTCTCCACAAGT
rpp30_F_1326_TAGCGGAGAG	AATGATACGGCGACCACCGAGATCTACACTAGCGGAGAGGAGCGGCTGTCTCCACAAGT
rpp30_F_1327_CTGAGATGAC	AATGATACGGCGACCACCGAGATCTACACCTGAGATGACGAGCGGCTGTCTCCACAAGT
rpp30_F_1328_CCGATGTAAC	AATGATACGGCGACCACCGAGATCTACACCCGATGTAACGAGCGGCTGTCTCCACAAGT
rpp30_F_1329_AGAGATGACA	AATGATACGGCGACCACCGAGATCTACACAGAGATGACAGAGCGGCTGTCTCCACAAGT
rpp30_F_1330_CAGACCTATA	AATGATACGGCGACCACCGAGATCTACACCAGACCTATAGAGCGGCTGTCTCCACAAGT
rpp30_F_1331_CTCAGAGTCA	AATGATACGGCGACCACCGAGATCTACACCTCAGAGTCAGAGCGGCTGTCTCCACAAGT
rpp30_F_1332_AGGTACCATC	AATGATACGGCGACCACCGAGATCTACACAGGTACCATCGAGCGGCTGTCTCCACAAGT
rpp30_F_1333_TCGATAGACT	AATGATACGGCGACCACCGAGATCTACACTCGATAGACTGAGCGGCTGTCTCCACAAGT
rpp30_F_1334_ATCTATGGAG	AATGATACGGCGACCACCGAGATCTACACATCTATGGAGGAGCGGCTGTCTCCACAAGT
rpp30_F_1335_AACGAGAACC	AATGATACGGCGACCACCGAGATCTACACAACGAGAACCGAGCGGCTGTCTCCACAAGT
rpp30_F_1336_GTTGAACAGC	AATGATACGGCGACCACCGAGATCTACACGTTGAACAGCGAGCGGCTGTCTCCACAAGT
rpp30_F_1337_AGTTACGACC	AATGATACGGCGACCACCGAGATCTACACAGTTACGACCGAGCGGCTGTCTCCACAAGT
rpp30_F_1338_CACAACGACC	AATGATACGGCGACCACCGAGATCTACACCACAACGACCGAGCGGCTGTCTCCACAAGT
rpp30_F_1339_CCTAGTGACC	AATGATACGGCGACCACCGAGATCTACACCCTAGTGACCGAGCGGCTGTCTCCACAAGT
rpp30_F_1340_GATCCTGACC	AATGATACGGCGACCACCGAGATCTACACGATCCTGACCGAGCGGCTGTCTCCACAAGT
rpp30_F_1341_TTCCACGACC	AATGATACGGCGACCACCGAGATCTACACTTCCACGACCGAGCGGCTGTCTCCACAAGT
rpp30_F_1342_TTGTAGGAGC	AATGATACGGCGACCACCGAGATCTACACTTGTAGGAGCGAGCGGCTGTCTCCACAAGT
rpp30_F_1343_AGGATCAGTC	AATGATACGGCGACCACCGAGATCTACACAGGATCAGTCGAGCGGCTGTCTCCACAAGT
rpp30_F_1344_ATGCGATCAC	AATGATACGGCGACCACCGAGATCTACACATGCGATCACGAGCGGCTGTCTCCACAAGT
rpp30_F_1345_TCCGCAATTC	AATGATACGGCGACCACCGAGATCTACACTCCGCAATTCGAGCGGCTGTCTCCACAAGT
rpp30_F_1346_CATCCTCGTG	AATGATACGGCGACCACCGAGATCTACACCATCCTCGTGGAGCGGCTGTCTCCACAAGT
rpp30_F_1347_GCTGATTGGC	AATGATACGGCGACCACCGAGATCTACACGCTGATTGGCGAGCGGCTGTCTCCACAAGT
rpp30_F_1348_GGATAAGATC	AATGATACGGCGACCACCGAGATCTACACGGATAAGATCGAGCGGCTGTCTCCACAAGT
rpp30_F_1349_AACCAGCCTA	AATGATACGGCGACCACCGAGATCTACACAACCAGCCTAGAGCGGCTGTCTCCACAAGT
rpp30_F_1350_CCTCGAGAAC	AATGATACGGCGACCACCGAGATCTACACCCTCGAGAACGAGCGGCTGTCTCCACAAGT
rpp30_F_1351_ACCGGACATC	AATGATACGGCGACCACCGAGATCTACACACCGGACATCGAGCGGCTGTCTCCACAAGT
rpp30_F_1352_GTGCTGATAC	AATGATACGGCGACCACCGAGATCTACACGTGCTGATACGAGCGGCTGTCTCCACAAGT
rpp30_F_1353_CGTACCTGGT	AATGATACGGCGACCACCGAGATCTACACCGTACCTGGTGAGCGGCTGTCTCCACAAGT
rpp30_F_1354_AGGACGCAAT	AATGATACGGCGACCACCGAGATCTACACAGGACGCAATGAGCGGCTGTCTCCACAAGT
rpp30_F_1355_CCGGAGAACA	AATGATACGGCGACCACCGAGATCTACACCCGGAGAACAGAGCGGCTGTCTCCACAAGT
rpp30_F_1356_ACGTCTACGT	AATGATACGGCGACCACCGAGATCTACACACGTCTACGTGAGCGGCTGTCTCCACAAGT
rpp30_F_1357_GCCTACTTGT	AATGATACGGCGACCACCGAGATCTACACGCCTACTTGTGAGCGGCTGTCTCCACAAGT
rpp30_F_1358_ACATCTGACC	AATGATACGGCGACCACCGAGATCTACACACATCTGACCGAGCGGCTGTCTCCACAAGT
rpp30_F_1359_CTGACCAACC	AATGATACGGCGACCACCGAGATCTACACCTGACCAACCGAGCGGCTGTCTCCACAAGT
rpp30_F_1360_TCTGTTCACC	AATGATACGGCGACCACCGAGATCTACACTCTGTTCACCGAGCGGCTGTCTCCACAAGT
rpp30_F_1361_TACAACGGCT	AATGATACGGCGACCACCGAGATCTACACTACAACGGCTGAGCGGCTGTCTCCACAAGT
rpp30_F_1362_AACTCTACAG	AATGATACGGCGACCACCGAGATCTACACAACTCTACAGGAGCGGCTGTCTCCACAAGT
rpp30_F_1363_AGGCATACAG	AATGATACGGCGACCACCGAGATCTACACAGGCATACAGGAGCGGCTGTCTCCACAAGT
rpp30_F_1364_CCTAGTACAG	AATGATACGGCGACCACCGAGATCTACACCCTAGTACAGGAGCGGCTGTCTCCACAAGT
rpp30_F_1365_GTCAGTACAG	AATGATACGGCGACCACCGAGATCTACACGTCAGTACAGGAGCGGCTGTCTCCACAAGT
rpp30_F_1366_CGTCAGAGAC	AATGATACGGCGACCACCGAGATCTACACCGTCAGAGACGAGCGGCTGTCTCCACAAGT
rpp30_F_1367_ATAGCGGCAA	AATGATACGGCGACCACCGAGATCTACACATAGCGGCAAGAGCGGCTGTCTCCACAAGT
rpp30_F_1368_AGTATGGAGC	AATGATACGGCGACCACCGAGATCTACACAGTATGGAGCGAGCGGCTGTCTCCACAAGT
rpp30_F_1369_GACGATATGG	AATGATACGGCGACCACCGAGATCTACACGACGATATGGGAGCGGCTGTCTCCACAAGT
rpp30_F_1370_ACTCGATACC	AATGATACGGCGACCACCGAGATCTACACACTCGATACCGAGCGGCTGTCTCCACAAGT
rpp30_F_1371_TACGCCATCC	AATGATACGGCGACCACCGAGATCTACACTACGCCATCCGAGCGGCTGTCTCCACAAGT
rpp30_F_1372_TCCAATGATC	AATGATACGGCGACCACCGAGATCTACACTCCAATGATCGAGCGGCTGTCTCCACAAGT
rpp30_F_1373_GACTCGTCAG	AATGATACGGCGACCACCGAGATCTACACGACTCGTCAGGAGCGGCTGTCTCCACAAGT
rpp30_F_1374_GGATCCAATG	AATGATACGGCGACCACCGAGATCTACACGGATCCAATGGAGCGGCTGTCTCCACAAGT
rpp30_F_1375_TGTATTCCAC	AATGATACGGCGACCACCGAGATCTACACTGTATTCCACGAGCGGCTGTCTCCACAAGT
rpp30_F_1376_AGCAAGCTAT	AATGATACGGCGACCACCGAGATCTACACAGCAAGCTATGAGCGGCTGTCTCCACAAGT
rpp30_F_1377_AACCACCGTG	AATGATACGGCGACCACCGAGATCTACACAACCACCGTGGAGCGGCTGTCTCCACAAGT
rpp30_F_1378_AGATAACTCG	AATGATACGGCGACCACCGAGATCTACACAGATAACTCGGAGCGGCTGTCTCCACAAGT
rpp30_F_1379_GGCAGTGGTA	AATGATACGGCGACCACCGAGATCTACACGGCAGTGGTAGAGCGGCTGTCTCCACAAGT
rpp30_F_1380_AACAAGCTCC	AATGATACGGCGACCACCGAGATCTACACAACAAGCTCCGAGCGGCTGTCTCCACAAGT
rpp30_F_1381_TGGCAACAAC	AATGATACGGCGACCACCGAGATCTACACTGGCAACAACGAGCGGCTGTCTCCACAAGT
rpp30_F_1382_CGTGCTACAG	AATGATACGGCGACCACCGAGATCTACACCGTGCTACAGGAGCGGCTGTCTCCACAAGT
rpp30_F_1383_CAGTCACTCG	AATGATACGGCGACCACCGAGATCTACACCAGTCACTCGGAGCGGCTGTCTCCACAAGT
rpp30_F_1384_TACCGACTCG	AATGATACGGCGACCACCGAGATCTACACTACCGACTCGGAGCGGCTGTCTCCACAAGT
rpp30_F_1385_TTGATACTCG	AATGATACGGCGACCACCGAGATCTACACTTGATACTCGGAGCGGCTGTCTCCACAAGT
rpp30_F_1386_AGCTTAACCG	AATGATACGGCGACCACCGAGATCTACACAGCTTAACCGGAGCGGCTGTCTCCACAAGT
rpp30_F_1387_AGACAATACC	AATGATACGGCGACCACCGAGATCTACACAGACAATACCGAGCGGCTGTCTCCACAAGT
rpp30_F_1388_AGGTCAGAAC	AATGATACGGCGACCACCGAGATCTACACAGGTCAGAACGAGCGGCTGTCTCCACAAGT
rpp30_F_1389_GTATCAGAAC	AATGATACGGCGACCACCGAGATCTACACGTATCAGAACGAGCGGCTGTCTCCACAAGT
rpp30_F_1390_GGAAGCGAAC	AATGATACGGCGACCACCGAGATCTACACGGAAGCGAACGAGCGGCTGTCTCCACAAGT
rpp30_F_1391_AGAATGCTGC	AATGATACGGCGACCACCGAGATCTACACAGAATGCTGCGAGCGGCTGTCTCCACAAGT
rpp30_F_1392_ACGCGGTAAC	AATGATACGGCGACCACCGAGATCTACACACGCGGTAACGAGCGGCTGTCTCCACAAGT
rpp30_F_1393_TCACTTCAGC	AATGATACGGCGACCACCGAGATCTACACTCACTTCAGCGAGCGGCTGTCTCCACAAGT
rpp30_F_1394_TTGACTAGCT	AATGATACGGCGACCACCGAGATCTACACTTGACTAGCTGAGCGGCTGTCTCCACAAGT
rpp30_F_1395_TGCTGTGAGT	AATGATACGGCGACCACCGAGATCTACACTGCTGTGAGTGAGCGGCTGTCTCCACAAGT
rpp30_F_1396_ACAACCTACC	AATGATACGGCGACCACCGAGATCTACACACAACCTACCGAGCGGCTGTCTCCACAAGT
rpp30_F_1397_ACGTGCGTAG	AATGATACGGCGACCACCGAGATCTACACACGTGCGTAGGAGCGGCTGTCTCCACAAGT
rpp30_F_1398_GGTAGATACC	AATGATACGGCGACCACCGAGATCTACACGGTAGATACCGAGCGGCTGTCTCCACAAGT
rpp30_F_1399_GCTAGTGGTT	AATGATACGGCGACCACCGAGATCTACACGCTAGTGGTTGAGCGGCTGTCTCCACAAGT
rpp30_F_1400_TCAACAAGTC	AATGATACGGCGACCACCGAGATCTACACTCAACAAGTCGAGCGGCTGTCTCCACAAGT
rpp30_F_1401_GTTAGCCACC	AATGATACGGCGACCACCGAGATCTACACGTTAGCCACCGAGCGGCTGTCTCCACAAGT
rpp30_F_1402_ATCCATCACC	AATGATACGGCGACCACCGAGATCTACACATCCATCACCGAGCGGCTGTCTCCACAAGT
rpp30_F_1403_GATATAGACC	AATGATACGGCGACCACCGAGATCTACACGATATAGACCGAGCGGCTGTCTCCACAAGT
rpp30_F_1404_GCAATACACC	AATGATACGGCGACCACCGAGATCTACACGCAATACACCGAGCGGCTGTCTCCACAAGT
rpp30_F_1405_TTACTCTACC	AATGATACGGCGACCACCGAGATCTACACTTACTCTACCGAGCGGCTGTCTCCACAAGT
rpp30_F_1406_TTCACATACC	AATGATACGGCGACCACCGAGATCTACACTTCACATACCGAGCGGCTGTCTCCACAAGT
rpp30_F_1407_ACTCGCCTAG	AATGATACGGCGACCACCGAGATCTACACACTCGCCTAGGAGCGGCTGTCTCCACAAGT
rpp30_F_1408_TATCAAGACG	AATGATACGGCGACCACCGAGATCTACACTATCAAGACGGAGCGGCTGTCTCCACAAGT
rpp30_F_1409_AATTCGCCTG	AATGATACGGCGACCACCGAGATCTACACAATTCGCCTGGAGCGGCTGTCTCCACAAGT
rpp30_F_1410_GCTTCGCCTA	AATGATACGGCGACCACCGAGATCTACACGCTTCGCCTAGAGCGGCTGTCTCCACAAGT
rpp30_F_1411_TGGCTCAGTG	AATGATACGGCGACCACCGAGATCTACACTGGCTCAGTGGAGCGGCTGTCTCCACAAGT
rpp30_F_1412_AACATCCTAG	AATGATACGGCGACCACCGAGATCTACACAACATCCTAGGAGCGGCTGTCTCCACAAGT
rpp30_F_1413_CCATCCTCAC	AATGATACGGCGACCACCGAGATCTACACCCATCCTCACGAGCGGCTGTCTCCACAAGT
rpp30_F_1414_CTTAGGTACC	AATGATACGGCGACCACCGAGATCTACACCTTAGGTACCGAGCGGCTGTCTCCACAAGT
rpp30_F_1415_AGGCACTCTG	AATGATACGGCGACCACCGAGATCTACACAGGCACTCTGGAGCGGCTGTCTCCACAAGT
rpp30_F_1416_TGCGCGATAC	AATGATACGGCGACCACCGAGATCTACACTGCGCGATACGAGCGGCTGTCTCCACAAGT
rpp30_F_1417_GCAGACATGT	AATGATACGGCGACCACCGAGATCTACACGCAGACATGTGAGCGGCTGTCTCCACAAGT
rpp30_F_1418_ACGGCAGACT	AATGATACGGCGACCACCGAGATCTACACACGGCAGACTGAGCGGCTGTCTCCACAAGT
rpp30_F_1419_TCTACACAGC	AATGATACGGCGACCACCGAGATCTACACTCTACACAGCGAGCGGCTGTCTCCACAAGT
rpp30_F_1420_CACATGCTGC	AATGATACGGCGACCACCGAGATCTACACCACATGCTGCGAGCGGCTGTCTCCACAAGT
rpp30_F_1421_AACCAGTCCG	AATGATACGGCGACCACCGAGATCTACACAACCAGTCCGGAGCGGCTGTCTCCACAAGT
rpp30_F_1422_GAGGACACAG	AATGATACGGCGACCACCGAGATCTACACGAGGACACAGGAGCGGCTGTCTCCACAAGT
rpp30_F_1423_AGAAGACTCC	AATGATACGGCGACCACCGAGATCTACACAGAAGACTCCGAGCGGCTGTCTCCACAAGT
rpp30_F_1424_CCAACGTGAC	AATGATACGGCGACCACCGAGATCTACACCCAACGTGACGAGCGGCTGTCTCCACAAGT
rpp30_F_1425_GCTGAGTTAC	AATGATACGGCGACCACCGAGATCTACACGCTGAGTTACGAGCGGCTGTCTCCACAAGT
rpp30_F_1426_CTTAAGCCGG	AATGATACGGCGACCACCGAGATCTACACCTTAAGCCGGGAGCGGCTGTCTCCACAAGT
rpp30_F_1427_AAGGTGAATC	AATGATACGGCGACCACCGAGATCTACACAAGGTGAATCGAGCGGCTGTCTCCACAAGT
rpp30_F_1428_AAGAGCGGCT	AATGATACGGCGACCACCGAGATCTACACAAGAGCGGCTGAGCGGCTGTCTCCACAAGT
rpp30_F_1429_TTCTAGAGCT	AATGATACGGCGACCACCGAGATCTACACTTCTAGAGCTGAGCGGCTGTCTCCACAAGT
rpp30_F_1430_TCGACATTCC	AATGATACGGCGACCACCGAGATCTACACTCGACATTCCGAGCGGCTGTCTCCACAAGT
rpp30_F_1431_AATACCGACA	AATGATACGGCGACCACCGAGATCTACACAATACCGACAGAGCGGCTGTCTCCACAAGT
rpp30_F_1432_CTAATGCGAC	AATGATACGGCGACCACCGAGATCTACACCTAATGCGACGAGCGGCTGTCTCCACAAGT
rpp30_F_1433_GCCAGTAACC	AATGATACGGCGACCACCGAGATCTACACGCCAGTAACCGAGCGGCTGTCTCCACAAGT
rpp30_F_1434_TAGCAACGTC	AATGATACGGCGACCACCGAGATCTACACTAGCAACGTCGAGCGGCTGTCTCCACAAGT
rpp30_F_1435_CAGTTGCGTC	AATGATACGGCGACCACCGAGATCTACACCAGTTGCGTCGAGCGGCTGTCTCCACAAGT
rpp30_F_1436_ACCAAGAGAC	AATGATACGGCGACCACCGAGATCTACACACCAAGAGACGAGCGGCTGTCTCCACAAGT
rpp30_F_1437_TTCATGAGAC	AATGATACGGCGACCACCGAGATCTACACTTCATGAGACGAGCGGCTGTCTCCACAAGT
rpp30_F_1438_AACGAATCAC	AATGATACGGCGACCACCGAGATCTACACAACGAATCACGAGCGGCTGTCTCCACAAGT
rpp30_F_1439_TCACGTCCAC	AATGATACGGCGACCACCGAGATCTACACTCACGTCCACGAGCGGCTGTCTCCACAAGT
rpp30_F_1440_CGACAACGCT	AATGATACGGCGACCACCGAGATCTACACCGACAACGCTGAGCGGCTGTCTCCACAAGT
rpp30_F_1441_CACTGCATCC	AATGATACGGCGACCACCGAGATCTACACCACTGCATCCGAGCGGCTGTCTCCACAAGT
rpp30_F_1442_TGAGCATACC	AATGATACGGCGACCACCGAGATCTACACTGAGCATACCGAGCGGCTGTCTCCACAAGT
rpp30_F_1443_TGAGGTGATC	AATGATACGGCGACCACCGAGATCTACACTGAGGTGATCGAGCGGCTGTCTCCACAAGT
rpp30_F_1444_GGCTCATAGC	AATGATACGGCGACCACCGAGATCTACACGGCTCATAGCGAGCGGCTGTCTCCACAAGT
rpp30_F_1445_TTGGCAAGGC	AATGATACGGCGACCACCGAGATCTACACTTGGCAAGGCGAGCGGCTGTCTCCACAAGT
rpp30_F_1446_CGCATGGCTT	AATGATACGGCGACCACCGAGATCTACACCGCATGGCTTGAGCGGCTGTCTCCACAAGT
rpp30_F_1447_TAACGCCACG	AATGATACGGCGACCACCGAGATCTACACTAACGCCACGGAGCGGCTGTCTCCACAAGT
rpp30_F_1448_TTGAGACGTC	AATGATACGGCGACCACCGAGATCTACACTTGAGACGTCGAGCGGCTGTCTCCACAAGT
rpp30_F_1449_ATCTCAAGTG	AATGATACGGCGACCACCGAGATCTACACATCTCAAGTGGAGCGGCTGTCTCCACAAGT
rpp30_F_1450_AGGAACTGAC	AATGATACGGCGACCACCGAGATCTACACAGGAACTGACGAGCGGCTGTCTCCACAAGT
rpp30_F_1451_AGTACTGAAC	AATGATACGGCGACCACCGAGATCTACACAGTACTGAACGAGCGGCTGTCTCCACAAGT
rpp30_F_1452_GACGTGTTAC	AATGATACGGCGACCACCGAGATCTACACGACGTGTTACGAGCGGCTGTCTCCACAAGT
rpp30_F_1453_TGAGATCAGT	AATGATACGGCGACCACCGAGATCTACACTGAGATCAGTGAGCGGCTGTCTCCACAAGT
rpp30_F_1454_TGAGCGCTTA	AATGATACGGCGACCACCGAGATCTACACTGAGCGCTTAGAGCGGCTGTCTCCACAAGT
rpp30_F_1455_GAGTACAAGC	AATGATACGGCGACCACCGAGATCTACACGAGTACAAGCGAGCGGCTGTCTCCACAAGT
rpp30_F_1456_GATCGCAGTC	AATGATACGGCGACCACCGAGATCTACACGATCGCAGTCGAGCGGCTGTCTCCACAAGT
rpp30_F_1457_TTAAGGCCAC	AATGATACGGCGACCACCGAGATCTACACTTAAGGCCACGAGCGGCTGTCTCCACAAGT
rpp30_F_1458_CAAGATTCAC	AATGATACGGCGACCACCGAGATCTACACCAAGATTCACGAGCGGCTGTCTCCACAAGT
rpp30_F_1459_CTATCAGCAA	AATGATACGGCGACCACCGAGATCTACACCTATCAGCAAGAGCGGCTGTCTCCACAAGT
rpp30_F_1460_TATGGCACGT	AATGATACGGCGACCACCGAGATCTACACTATGGCACGTGAGCGGCTGTCTCCACAAGT
rpp30_F_1461_CGTTAGGACA	AATGATACGGCGACCACCGAGATCTACACCGTTAGGACAGAGCGGCTGTCTCCACAAGT
rpp30_F_1462_GACCTGGACA	AATGATACGGCGACCACCGAGATCTACACGACCTGGACAGAGCGGCTGTCTCCACAAGT
rpp30_F_1463_GATGAGGACA	AATGATACGGCGACCACCGAGATCTACACGATGAGGACAGAGCGGCTGTCTCCACAAGT
rpp30_F_1464_GCGATGGACA	AATGATACGGCGACCACCGAGATCTACACGCGATGGACAGAGCGGCTGTCTCCACAAGT
rpp30_F_1465_GGCCACTAAC	AATGATACGGCGACCACCGAGATCTACACGGCCACTAACGAGCGGCTGTCTCCACAAGT
rpp30_F_1466_GTAAGACCTC	AATGATACGGCGACCACCGAGATCTACACGTAAGACCTCGAGCGGCTGTCTCCACAAGT
rpp30_F_1467_GCTGTTATCC	AATGATACGGCGACCACCGAGATCTACACGCTGTTATCCGAGCGGCTGTCTCCACAAGT
rpp30_F_1468_ATCCACAGTC	AATGATACGGCGACCACCGAGATCTACACATCCACAGTCGAGCGGCTGTCTCCACAAGT
rpp30_F_1469_GACAACGGAC	AATGATACGGCGACCACCGAGATCTACACGACAACGGACGAGCGGCTGTCTCCACAAGT
rpp30_F_1470_AGTTCTCAGC	AATGATACGGCGACCACCGAGATCTACACAGTTCTCAGCGAGCGGCTGTCTCCACAAGT
rpp30_F_1471_ACTTGGTCGG	AATGATACGGCGACCACCGAGATCTACACACTTGGTCGGGAGCGGCTGTCTCCACAAGT
rpp30_F_1472_AAGGTCGTGC	AATGATACGGCGACCACCGAGATCTACACAAGGTCGTGCGAGCGGCTGTCTCCACAAGT
rpp30_F_1473_GTTACTGACA	AATGATACGGCGACCACCGAGATCTACACGTTACTGACAGAGCGGCTGTCTCCACAAGT
rpp30_F_1474_GCTGCCATAG	AATGATACGGCGACCACCGAGATCTACACGCTGCCATAGGAGCGGCTGTCTCCACAAGT
rpp30_F_1475_CGCGCCAATT	AATGATACGGCGACCACCGAGATCTACACCGCGCCAATTGAGCGGCTGTCTCCACAAGT
rpp30_F_1476_ACCAGGTGAG	AATGATACGGCGACCACCGAGATCTACACACCAGGTGAGGAGCGGCTGTCTCCACAAGT
rpp30_F_1477_TTACGAGACT	AATGATACGGCGACCACCGAGATCTACACTTACGAGACTGAGCGGCTGTCTCCACAAGT
rpp30_F_1478_AGAACCTCAC	AATGATACGGCGACCACCGAGATCTACACAGAACCTCACGAGCGGCTGTCTCCACAAGT
rpp30_F_1479_TCAGACATAC	AATGATACGGCGACCACCGAGATCTACACTCAGACATACGAGCGGCTGTCTCCACAAGT
rpp30_F_1480_GCGCTAATTG	AATGATACGGCGACCACCGAGATCTACACGCGCTAATTGGAGCGGCTGTCTCCACAAGT
rpp30_F_1481_GAATGTCAGC	AATGATACGGCGACCACCGAGATCTACACGAATGTCAGCGAGCGGCTGTCTCCACAAGT
rpp30_F_1482_TTCTTGGTGC	AATGATACGGCGACCACCGAGATCTACACTTCTTGGTGCGAGCGGCTGTCTCCACAAGT
rpp30_F_1483_CACAGCAATC	AATGATACGGCGACCACCGAGATCTACACCACAGCAATCGAGCGGCTGTCTCCACAAGT
rpp30_F_1484_ACCGTAACAC	AATGATACGGCGACCACCGAGATCTACACACCGTAACACGAGCGGCTGTCTCCACAAGT
rpp30_F_1485_TTAGACGCCA	AATGATACGGCGACCACCGAGATCTACACTTAGACGCCAGAGCGGCTGTCTCCACAAGT
rpp30_F_1486_CACTTCCACC	AATGATACGGCGACCACCGAGATCTACACCACTTCCACCGAGCGGCTGTCTCCACAAGT
rpp30_F_1487_TAGTACCACC	AATGATACGGCGACCACCGAGATCTACACTAGTACCACCGAGCGGCTGTCTCCACAAGT
rpp30_F_1488_TCAACCTCCG	AATGATACGGCGACCACCGAGATCTACACTCAACCTCCGGAGCGGCTGTCTCCACAAGT
rpp30_F_1489_ACAGTGCCAC	AATGATACGGCGACCACCGAGATCTACACACAGTGCCACGAGCGGCTGTCTCCACAAGT
rpp30_F_1490_ATTCTTCCAC	AATGATACGGCGACCACCGAGATCTACACATTCTTCCACGAGCGGCTGTCTCCACAAGT
rpp30_F_1491_CAGGTTATAC	AATGATACGGCGACCACCGAGATCTACACCAGGTTATACGAGCGGCTGTCTCCACAAGT
rpp30_F_1492_CCACTCACAC	AATGATACGGCGACCACCGAGATCTACACCCACTCACACGAGCGGCTGTCTCCACAAGT
rpp30_F_1493_CGATTGTCAC	AATGATACGGCGACCACCGAGATCTACACCGATTGTCACGAGCGGCTGTCTCCACAAGT
rpp30_F_1494_GACGAACTAC	AATGATACGGCGACCACCGAGATCTACACGACGAACTACGAGCGGCTGTCTCCACAAGT
rpp30_F_1495_GCCAGATCAC	AATGATACGGCGACCACCGAGATCTACACGCCAGATCACGAGCGGCTGTCTCCACAAGT
rpp30_F_1496_GTTCAGTCAC	AATGATACGGCGACCACCGAGATCTACACGTTCAGTCACGAGCGGCTGTCTCCACAAGT
rpp30_F_1497_TTAACCACAC	AATGATACGGCGACCACCGAGATCTACACTTAACCACACGAGCGGCTGTCTCCACAAGT
rpp30_F_1498_CCAAGAGGTC	AATGATACGGCGACCACCGAGATCTACACCCAAGAGGTCGAGCGGCTGTCTCCACAAGT
rpp30_F_1499_GCAGCTTCAA	AATGATACGGCGACCACCGAGATCTACACGCAGCTTCAAGAGCGGCTGTCTCCACAAGT
rpp30_F_1500_TTGGCGAATC	AATGATACGGCGACCACCGAGATCTACACTTGGCGAATCGAGCGGCTGTCTCCACAAGT
rpp30_F_1501_AGTAGGCGTG	AATGATACGGCGACCACCGAGATCTACACAGTAGGCGTGGAGCGGCTGTCTCCACAAGT
rpp30_F_1502_CGATATCACC	AATGATACGGCGACCACCGAGATCTACACCGATATCACCGAGCGGCTGTCTCCACAAGT
rpp30_F_1503_TGAACTCACC	AATGATACGGCGACCACCGAGATCTACACTGAACTCACCGAGCGGCTGTCTCCACAAGT
rpp30_F_1504_TTCGCTGATT	AATGATACGGCGACCACCGAGATCTACACTTCGCTGATTGAGCGGCTGTCTCCACAAGT
rpp30_F_1505_TCGTTACGTC	AATGATACGGCGACCACCGAGATCTACACTCGTTACGTCGAGCGGCTGTCTCCACAAGT
rpp30_F_1506_ACACAACGGT	AATGATACGGCGACCACCGAGATCTACACACACAACGGTGAGCGGCTGTCTCCACAAGT
rpp30_F_1507_GCCTAACGGT	AATGATACGGCGACCACCGAGATCTACACGCCTAACGGTGAGCGGCTGTCTCCACAAGT
rpp30_F_1508_GCTTATGAGC	AATGATACGGCGACCACCGAGATCTACACGCTTATGAGCGAGCGGCTGTCTCCACAAGT
rpp30_F_1509_ATTGCATGCT	AATGATACGGCGACCACCGAGATCTACACATTGCATGCTGAGCGGCTGTCTCCACAAGT
rpp30_F_1510_TTCGCCTCGA	AATGATACGGCGACCACCGAGATCTACACTTCGCCTCGAGAGCGGCTGTCTCCACAAGT
rpp30_F_1511_AAGTGGCGAC	AATGATACGGCGACCACCGAGATCTACACAAGTGGCGACGAGCGGCTGTCTCCACAAGT
rpp30_F_1512_GGATTGGACG	AATGATACGGCGACCACCGAGATCTACACGGATTGGACGGAGCGGCTGTCTCCACAAGT
rpp30_F_1513_GAGCTGCTGT	AATGATACGGCGACCACCGAGATCTACACGAGCTGCTGTGAGCGGCTGTCTCCACAAGT
rpp30_F_1514_AGCAGTCCTG	AATGATACGGCGACCACCGAGATCTACACAGCAGTCCTGGAGCGGCTGTCTCCACAAGT
rpp30_F_1515_CTGTTAGAAC	AATGATACGGCGACCACCGAGATCTACACCTGTTAGAACGAGCGGCTGTCTCCACAAGT
rpp30_F_1516_GAGATACCAC	AATGATACGGCGACCACCGAGATCTACACGAGATACCACGAGCGGCTGTCTCCACAAGT
rpp30_F_1517_GATAAGGAAC	AATGATACGGCGACCACCGAGATCTACACGATAAGGAACGAGCGGCTGTCTCCACAAGT
rpp30_F_1518_TAGTGACTAC	AATGATACGGCGACCACCGAGATCTACACTAGTGACTACGAGCGGCTGTCTCCACAAGT
rpp30_F_1519_ACCAGTGGAT	AATGATACGGCGACCACCGAGATCTACACACCAGTGGATGAGCGGCTGTCTCCACAAGT
rpp30_F_1520_TTAGTCAGCT	AATGATACGGCGACCACCGAGATCTACACTTAGTCAGCTGAGCGGCTGTCTCCACAAGT
rpp30_F_1521_ATTCTTGTGG	AATGATACGGCGACCACCGAGATCTACACATTCTTGTGGGAGCGGCTGTCTCCACAAGT
rpp30_F_1522_CACGATAGTC	AATGATACGGCGACCACCGAGATCTACACCACGATAGTCGAGCGGCTGTCTCCACAAGT
rpp30_F_1523_CATGTCAGTC	AATGATACGGCGACCACCGAGATCTACACCATGTCAGTCGAGCGGCTGTCTCCACAAGT
rpp30_F_1524_CTAGCCTCAG	AATGATACGGCGACCACCGAGATCTACACCTAGCCTCAGGAGCGGCTGTCTCCACAAGT
rpp30_F_1525_GCCACAGCAA	AATGATACGGCGACCACCGAGATCTACACGCCACAGCAAGAGCGGCTGTCTCCACAAGT
rpp30_F_1526_AAGATACACC	AATGATACGGCGACCACCGAGATCTACACAAGATACACCGAGCGGCTGTCTCCACAAGT
rpp30_F_1527_CATCAATACC	AATGATACGGCGACCACCGAGATCTACACCATCAATACCGAGCGGCTGTCTCCACAAGT
rpp30_F_1528_GACTAGTACC	AATGATACGGCGACCACCGAGATCTACACGACTAGTACCGAGCGGCTGTCTCCACAAGT
rpp30_F_1529_ACAGCCTCTG	AATGATACGGCGACCACCGAGATCTACACACAGCCTCTGGAGCGGCTGTCTCCACAAGT
rpp30_F_1530_TTGACAGACA	AATGATACGGCGACCACCGAGATCTACACTTGACAGACAGAGCGGCTGTCTCCACAAGT
rpp30_F_1531_ACGCATTCTC	AATGATACGGCGACCACCGAGATCTACACACGCATTCTCGAGCGGCTGTCTCCACAAGT
rpp30_F_1532_ACCGAAGACA	AATGATACGGCGACCACCGAGATCTACACACCGAAGACAGAGCGGCTGTCTCCACAAGT
rpp30_F_1533_ACATTGAGAC	AATGATACGGCGACCACCGAGATCTACACACATTGAGACGAGCGGCTGTCTCCACAAGT
rpp30_F_1534_ATAACGAGAC	AATGATACGGCGACCACCGAGATCTACACATAACGAGACGAGCGGCTGTCTCCACAAGT
rpp30_F_1535_CATAGAGGAC	AATGATACGGCGACCACCGAGATCTACACCATAGAGGACGAGCGGCTGTCTCCACAAGT
rpp30_F_1536_CGTTATACAC	AATGATACGGCGACCACCGAGATCTACACCGTTATACACGAGCGGCTGTCTCCACAAGT
rpp30_F_1537_TAGGCCTCAC	AATGATACGGCGACCACCGAGATCTACACTAGGCCTCACGAGCGGCTGTCTCCACAAGT
rpp30_F_1538_CATCACGCTA	AATGATACGGCGACCACCGAGATCTACACCATCACGCTAGAGCGGCTGTCTCCACAAGT
rpp30_F_1539_TAAGTAGGAC	AATGATACGGCGACCACCGAGATCTACACTAAGTAGGACGAGCGGCTGTCTCCACAAGT
rpp30_F_1540_TATCTAAGGC	AATGATACGGCGACCACCGAGATCTACACTATCTAAGGCGAGCGGCTGTCTCCACAAGT
rpp30_F_1541_GAGAGAGACT	AATGATACGGCGACCACCGAGATCTACACGAGAGAGACTGAGCGGCTGTCTCCACAAGT
rpp30_F_1542_TTGGCCGACT	AATGATACGGCGACCACCGAGATCTACACTTGGCCGACTGAGCGGCTGTCTCCACAAGT
rpp30_F_1543_CAGAACGTTC	AATGATACGGCGACCACCGAGATCTACACCAGAACGTTCGAGCGGCTGTCTCCACAAGT
rpp30_F_1544_GTCGCAAGTA	AATGATACGGCGACCACCGAGATCTACACGTCGCAAGTAGAGCGGCTGTCTCCACAAGT
rpp30_F_1545_CTGCCTTCAC	AATGATACGGCGACCACCGAGATCTACACCTGCCTTCACGAGCGGCTGTCTCCACAAGT
rpp30_F_1546_GGTTCCGCAT	AATGATACGGCGACCACCGAGATCTACACGGTTCCGCATGAGCGGCTGTCTCCACAAGT
rpp30_F_1547_GGATGGTATC	AATGATACGGCGACCACCGAGATCTACACGGATGGTATCGAGCGGCTGTCTCCACAAGT
rpp30_F_1548_ATCTGATGCC	AATGATACGGCGACCACCGAGATCTACACATCTGATGCCGAGCGGCTGTCTCCACAAGT
rpp30_F_1549_AACTGCTACC	AATGATACGGCGACCACCGAGATCTACACAACTGCTACCGAGCGGCTGTCTCCACAAGT
rpp30_F_1550_TTGGATACAG	AATGATACGGCGACCACCGAGATCTACACTTGGATACAGGAGCGGCTGTCTCCACAAGT
rpp30_F_1551_TTGGAGTCTC	AATGATACGGCGACCACCGAGATCTACACTTGGAGTCTCGAGCGGCTGTCTCCACAAGT
rpp30_F_1552_TCCAGTAGAC	AATGATACGGCGACCACCGAGATCTACACTCCAGTAGACGAGCGGCTGTCTCCACAAGT
rpp30_F_1553_CGGTTGCCTT	AATGATACGGCGACCACCGAGATCTACACCGGTTGCCTTGAGCGGCTGTCTCCACAAGT
rpp30_F_1554_CACAGATGCC	AATGATACGGCGACCACCGAGATCTACACCACAGATGCCGAGCGGCTGTCTCCACAAGT
rpp30_F_1555_ACACACAGAC	AATGATACGGCGACCACCGAGATCTACACACACACAGACGAGCGGCTGTCTCCACAAGT
rpp30_F_1556_GCCTGGATTC	AATGATACGGCGACCACCGAGATCTACACGCCTGGATTCGAGCGGCTGTCTCCACAAGT
rpp30_F_1557_TCACGTGGTT	AATGATACGGCGACCACCGAGATCTACACTCACGTGGTTGAGCGGCTGTCTCCACAAGT
rpp30_F_1558_GCTGCGATCA	AATGATACGGCGACCACCGAGATCTACACGCTGCGATCAGAGCGGCTGTCTCCACAAGT
rpp30_F_1559_TTCATCGATC	AATGATACGGCGACCACCGAGATCTACACTTCATCGATCGAGCGGCTGTCTCCACAAGT
rpp30_F_1560_AGCAAGATGC	AATGATACGGCGACCACCGAGATCTACACAGCAAGATGCGAGCGGCTGTCTCCACAAGT
rpp30_F_1561_AGCCAATTGC	AATGATACGGCGACCACCGAGATCTACACAGCCAATTGCGAGCGGCTGTCTCCACAAGT
rpp30_F_1562_GATATCAGCT	AATGATACGGCGACCACCGAGATCTACACGATATCAGCTGAGCGGCTGTCTCCACAAGT
rpp30_F_1563_ACTACTAGAC	AATGATACGGCGACCACCGAGATCTACACACTACTAGACGAGCGGCTGTCTCCACAAGT
rpp30_F_1564_GCGACTGAAC	AATGATACGGCGACCACCGAGATCTACACGCGACTGAACGAGCGGCTGTCTCCACAAGT
rpp30_F_1565_AACAACGAGA	AATGATACGGCGACCACCGAGATCTACACAACAACGAGAGAGCGGCTGTCTCCACAAGT
rpp30_F_1566_AACACAGTAG	AATGATACGGCGACCACCGAGATCTACACAACACAGTAGGAGCGGCTGTCTCCACAAGT
rpp30_F_1567_AACACCATTG	AATGATACGGCGACCACCGAGATCTACACAACACCATTGGAGCGGCTGTCTCCACAAGT
rpp30_F_1568_AACACGTCCA	AATGATACGGCGACCACCGAGATCTACACAACACGTCCAGAGCGGCTGTCTCCACAAGT
rpp30_F_1569_AACAGGATTC	AATGATACGGCGACCACCGAGATCTACACAACAGGATTCGAGCGGCTGTCTCCACAAGT
rpp30_F_1570_AACATCAAGC	AATGATACGGCGACCACCGAGATCTACACAACATCAAGCGAGCGGCTGTCTCCACAAGT
rpp30_F_1571_AACATGCAGT	AATGATACGGCGACCACCGAGATCTACACAACATGCAGTGAGCGGCTGTCTCCACAAGT
rpp30_F_1572_AACCAACCAG	AATGATACGGCGACCACCGAGATCTACACAACCAACCAGGAGCGGCTGTCTCCACAAGT
rpp30_F_1573_AACCAATAGG	AATGATACGGCGACCACCGAGATCTACACAACCAATAGGGAGCGGCTGTCTCCACAAGT
rpp30_F_1574_AACCAGCGAT	AATGATACGGCGACCACCGAGATCTACACAACCAGCGATGAGCGGCTGTCTCCACAAGT
rpp30_F_1575_AACCGAATGC	AATGATACGGCGACCACCGAGATCTACACAACCGAATGCGAGCGGCTGTCTCCACAAGT
rpp30_F_1576_AACCGATCGT	AATGATACGGCGACCACCGAGATCTACACAACCGATCGTGAGCGGCTGTCTCCACAAGT
rpp30_F_1577_AACCTGAAGG	AATGATACGGCGACCACCGAGATCTACACAACCTGAAGGGAGCGGCTGTCTCCACAAGT
rpp30_F_1578_AACCTTAGAG	AATGATACGGCGACCACCGAGATCTACACAACCTTAGAGGAGCGGCTGTCTCCACAAGT
rpp30_F_1579_AACGAACCGT	AATGATACGGCGACCACCGAGATCTACACAACGAACCGTGAGCGGCTGTCTCCACAAGT
rpp30_F_1580_AACGACAGAA	AATGATACGGCGACCACCGAGATCTACACAACGACAGAAGAGCGGCTGTCTCCACAAGT
rpp30_F_1581_AACGACCACA	AATGATACGGCGACCACCGAGATCTACACAACGACCACAGAGCGGCTGTCTCCACAAGT
rpp30_F_1582_AACGACTCCT	AATGATACGGCGACCACCGAGATCTACACAACGACTCCTGAGCGGCTGTCTCCACAAGT
rpp30_F_1583_AACGAGTTAG	AATGATACGGCGACCACCGAGATCTACACAACGAGTTAGGAGCGGCTGTCTCCACAAGT
rpp30_F_1584_AACGATTCTG	AATGATACGGCGACCACCGAGATCTACACAACGATTCTGGAGCGGCTGTCTCCACAAGT
rpp30_F_1585_AACGCACAAC	AATGATACGGCGACCACCGAGATCTACACAACGCACAACGAGCGGCTGTCTCCACAAGT
rpp30_F_1586_AACTACATGG	AATGATACGGCGACCACCGAGATCTACACAACTACATGGGAGCGGCTGTCTCCACAAGT
rpp30_F_1587_AACTACGTCT	AATGATACGGCGACCACCGAGATCTACACAACTACGTCTGAGCGGCTGTCTCCACAAGT
rpp30_F_1588_AACTAGAGAG	AATGATACGGCGACCACCGAGATCTACACAACTAGAGAGGAGCGGCTGTCTCCACAAGT
rpp30_F_1589_AACTCACCTT	AATGATACGGCGACCACCGAGATCTACACAACTCACCTTGAGCGGCTGTCTCCACAAGT
rpp30_F_1590_AACTGCCTTC	AATGATACGGCGACCACCGAGATCTACACAACTGCCTTCGAGCGGCTGTCTCCACAAGT
rpp30_F_1591_AACTGGATGA	AATGATACGGCGACCACCGAGATCTACACAACTGGATGAGAGCGGCTGTCTCCACAAGT
rpp30_F_1592_AACTGGCCAT	AATGATACGGCGACCACCGAGATCTACACAACTGGCCATGAGCGGCTGTCTCCACAAGT
rpp30_F_1593_AAGAACCTCT	AATGATACGGCGACCACCGAGATCTACACAAGAACCTCTGAGCGGCTGTCTCCACAAGT
rpp30_F_1594_AAGAAGGATG	AATGATACGGCGACCACCGAGATCTACACAAGAAGGATGGAGCGGCTGTCTCCACAAGT
rpp30_F_1595_AAGACCAGGA	AATGATACGGCGACCACCGAGATCTACACAAGACCAGGAGAGCGGCTGTCTCCACAAGT
rpp30_F_1596_AAGACTGACT	AATGATACGGCGACCACCGAGATCTACACAAGACTGACTGAGCGGCTGTCTCCACAAGT
rpp30_F_1597_AAGAGACCAA	AATGATACGGCGACCACCGAGATCTACACAAGAGACCAAGAGCGGCTGTCTCCACAAGT
rpp30_F_1598_AAGAGTAGGT	AATGATACGGCGACCACCGAGATCTACACAAGAGTAGGTGAGCGGCTGTCTCCACAAGT
rpp30_F_1599_AAGCAAGTTG	AATGATACGGCGACCACCGAGATCTACACAAGCAAGTTGGAGCGGCTGTCTCCACAAGT
rpp30_F_1600_AAGCACTGAG	AATGATACGGCGACCACCGAGATCTACACAAGCACTGAGGAGCGGCTGTCTCCACAAGT
rpp30_F_1601_AAGCCAGATT	AATGATACGGCGACCACCGAGATCTACACAAGCCAGATTGAGCGGCTGTCTCCACAAGT
rpp30_F_1602_AAGGACACGA	AATGATACGGCGACCACCGAGATCTACACAAGGACACGAGAGCGGCTGTCTCCACAAGT
rpp30_F_1603_AAGGACGTAA	AATGATACGGCGACCACCGAGATCTACACAAGGACGTAAGAGCGGCTGTCTCCACAAGT
rpp30_F_1604_AAGGATGAGA	AATGATACGGCGACCACCGAGATCTACACAAGGATGAGAGAGCGGCTGTCTCCACAAGT
rpp30_F_1605_AAGGATTCCA	AATGATACGGCGACCACCGAGATCTACACAAGGATTCCAGAGCGGCTGTCTCCACAAGT
rpp30_F_1606_AAGGCAACCT	AATGATACGGCGACCACCGAGATCTACACAAGGCAACCTGAGCGGCTGTCTCCACAAGT
rpp30_F_1607_AAGGCAGGAA	AATGATACGGCGACCACCGAGATCTACACAAGGCAGGAAGAGCGGCTGTCTCCACAAGT
rpp30_F_1608_AAGGCATAGT	AATGATACGGCGACCACCGAGATCTACACAAGGCATAGTGAGCGGCTGTCTCCACAAGT
rpp30_F_1609_AAGGCTCATT	AATGATACGGCGACCACCGAGATCTACACAAGGCTCATTGAGCGGCTGTCTCCACAAGT
rpp30_F_1610_AAGTAACGTG	AATGATACGGCGACCACCGAGATCTACACAAGTAACGTGGAGCGGCTGTCTCCACAAGT
rpp30_F_1611_AAGTCTCAGG	AATGATACGGCGACCACCGAGATCTACACAAGTCTCAGGGAGCGGCTGTCTCCACAAGT
rpp30_F_1612_AAGTTCGAGA	AATGATACGGCGACCACCGAGATCTACACAAGTTCGAGAGAGCGGCTGTCTCCACAAGT
rpp30_F_1613_AATACACTCC	AATGATACGGCGACCACCGAGATCTACACAATACACTCCGAGCGGCTGTCTCCACAAGT
rpp30_F_1614_AATCCATCTG	AATGATACGGCGACCACCGAGATCTACACAATCCATCTGGAGCGGCTGTCTCCACAAGT
rpp30_F_1615_AATCCGTTCT	AATGATACGGCGACCACCGAGATCTACACAATCCGTTCTGAGCGGCTGTCTCCACAAGT
rpp30_F_1616_AATCGAGTCT	AATGATACGGCGACCACCGAGATCTACACAATCGAGTCTGAGCGGCTGTCTCCACAAGT
rpp30_F_1617_AATCGTCCAT	AATGATACGGCGACCACCGAGATCTACACAATCGTCCATGAGCGGCTGTCTCCACAAGT
rpp30_F_1618_AATCGTCTTG	AATGATACGGCGACCACCGAGATCTACACAATCGTCTTGGAGCGGCTGTCTCCACAAGT
rpp30_F_1619_AATCTGTCGT	AATGATACGGCGACCACCGAGATCTACACAATCTGTCGTGAGCGGCTGTCTCCACAAGT
rpp30_F_1620_AATGAACGAC	AATGATACGGCGACCACCGAGATCTACACAATGAACGACGAGCGGCTGTCTCCACAAGT
rpp30_F_1621_AATGAGCAAG	AATGATACGGCGACCACCGAGATCTACACAATGAGCAAGGAGCGGCTGTCTCCACAAGT
rpp30_F_1622_AATGCGAAGA	AATGATACGGCGACCACCGAGATCTACACAATGCGAAGAGAGCGGCTGTCTCCACAAGT
rpp30_F_1623_AATGCTGAGT	AATGATACGGCGACCACCGAGATCTACACAATGCTGAGTGAGCGGCTGTCTCCACAAGT
rpp30_F_1624_AATGCTGTTG	AATGATACGGCGACCACCGAGATCTACACAATGCTGTTGGAGCGGCTGTCTCCACAAGT
rpp30_F_1625_AATTACCAGG	AATGATACGGCGACCACCGAGATCTACACAATTACCAGGGAGCGGCTGTCTCCACAAGT
rpp30_F_1626_AATTGCCACT	AATGATACGGCGACCACCGAGATCTACACAATTGCCACTGAGCGGCTGTCTCCACAAGT
rpp30_F_1627_ACAACCTCGA	AATGATACGGCGACCACCGAGATCTACACACAACCTCGAGAGCGGCTGTCTCCACAAGT
rpp30_F_1628_ACAACGAATG	AATGATACGGCGACCACCGAGATCTACACACAACGAATGGAGCGGCTGTCTCCACAAGT
rpp30_F_1629_ACAACTTAGG	AATGATACGGCGACCACCGAGATCTACACACAACTTAGGGAGCGGCTGTCTCCACAAGT
rpp30_F_1630_ACAACTTGCT	AATGATACGGCGACCACCGAGATCTACACACAACTTGCTGAGCGGCTGTCTCCACAAGT
rpp30_F_1631_ACAAGCCACT	AATGATACGGCGACCACCGAGATCTACACACAAGCCACTGAGCGGCTGTCTCCACAAGT
rpp30_F_1632_ACAAGCCTAA	AATGATACGGCGACCACCGAGATCTACACACAAGCCTAAGAGCGGCTGTCTCCACAAGT
rpp30_F_1633_ACAAGTAGGA	AATGATACGGCGACCACCGAGATCTACACACAAGTAGGAGAGCGGCTGTCTCCACAAGT
rpp30_F_1634_ACAAGTCTTG	AATGATACGGCGACCACCGAGATCTACACACAAGTCTTGGAGCGGCTGTCTCCACAAGT
rpp30_F_1635_ACAAGTTCAG	AATGATACGGCGACCACCGAGATCTACACACAAGTTCAGGAGCGGCTGTCTCCACAAGT
rpp30_F_1636_ACAATGGTTG	AATGATACGGCGACCACCGAGATCTACACACAATGGTTGGAGCGGCTGTCTCCACAAGT
rpp30_F_1637_ACACAGGCAA	AATGATACGGCGACCACCGAGATCTACACACACAGGCAAGAGCGGCTGTCTCCACAAGT
rpp30_F_1638_ACACATGAGA	AATGATACGGCGACCACCGAGATCTACACACACATGAGAGAGCGGCTGTCTCCACAAGT
rpp30_F_1639_ACACATGCCT	AATGATACGGCGACCACCGAGATCTACACACACATGCCTGAGCGGCTGTCTCCACAAGT
rpp30_F_1640_ACACCATATC	AATGATACGGCGACCACCGAGATCTACACACACCATATCGAGCGGCTGTCTCCACAAGT
rpp30_F_1641_ACACCTGATG	AATGATACGGCGACCACCGAGATCTACACACACCTGATGGAGCGGCTGTCTCCACAAGT
rpp30_F_1642_ACACTCAGGA	AATGATACGGCGACCACCGAGATCTACACACACTCAGGAGAGCGGCTGTCTCCACAAGT
rpp30_F_1643_ACACTGTCTG	AATGATACGGCGACCACCGAGATCTACACACACTGTCTGGAGCGGCTGTCTCCACAAGT
rpp30_F_1644_ACACTTCCAA	AATGATACGGCGACCACCGAGATCTACACACACTTCCAAGAGCGGCTGTCTCCACAAGT
rpp30_F_1645_ACAGAACAGG	AATGATACGGCGACCACCGAGATCTACACACAGAACAGGGAGCGGCTGTCTCCACAAGT
rpp30_F_1646_ACAGATCCTA	AATGATACGGCGACCACCGAGATCTACACACAGATCCTAGAGCGGCTGTCTCCACAAGT
rpp30_F_1647_ACAGGACTGC	AATGATACGGCGACCACCGAGATCTACACACAGGACTGCGAGCGGCTGTCTCCACAAGT
rpp30_F_1648_ACATAGCGAG	AATGATACGGCGACCACCGAGATCTACACACATAGCGAGGAGCGGCTGTCTCCACAAGT
rpp30_F_1649_ACATAGTAGC	AATGATACGGCGACCACCGAGATCTACACACATAGTAGCGAGCGGCTGTCTCCACAAGT
rpp30_F_1650_ACATCCGTGA	AATGATACGGCGACCACCGAGATCTACACACATCCGTGAGAGCGGCTGTCTCCACAAGT
rpp30_F_1651_ACATTCCATC	AATGATACGGCGACCACCGAGATCTACACACATTCCATCGAGCGGCTGTCTCCACAAGT
rpp30_F_1652_ACATTGGCGA	AATGATACGGCGACCACCGAGATCTACACACATTGGCGAGAGCGGCTGTCTCCACAAGT
rpp30_F_1653_ACCAACAAGG	AATGATACGGCGACCACCGAGATCTACACACCAACAAGGGAGCGGCTGTCTCCACAAGT
rpp30_F_1654_ACCAACACTA	AATGATACGGCGACCACCGAGATCTACACACCAACACTAGAGCGGCTGTCTCCACAAGT
rpp30_F_1655_ACCAACTATC	AATGATACGGCGACCACCGAGATCTACACACCAACTATCGAGCGGCTGTCTCCACAAGT
rpp30_F_1656_ACCAAGGATT	AATGATACGGCGACCACCGAGATCTACACACCAAGGATTGAGCGGCTGTCTCCACAAGT
rpp30_F_1657_ACCACAAGAA	AATGATACGGCGACCACCGAGATCTACACACCACAAGAAGAGCGGCTGTCTCCACAAGT
rpp30_F_1658_ACCACATAAG	AATGATACGGCGACCACCGAGATCTACACACCACATAAGGAGCGGCTGTCTCCACAAGT
rpp30_F_1659_ACCAGATACT	AATGATACGGCGACCACCGAGATCTACACACCAGATACTGAGCGGCTGTCTCCACAAGT
rpp30_F_1660_ACCAGGAAGA	AATGATACGGCGACCACCGAGATCTACACACCAGGAAGAGAGCGGCTGTCTCCACAAGT
rpp30_F_1661_ACCATCTTAC	AATGATACGGCGACCACCGAGATCTACACACCATCTTACGAGCGGCTGTCTCCACAAGT
rpp30_F_1662_ACCATTACTG	AATGATACGGCGACCACCGAGATCTACACACCATTACTGGAGCGGCTGTCTCCACAAGT
rpp30_F_1663_ACCGAGAATG	AATGATACGGCGACCACCGAGATCTACACACCGAGAATGGAGCGGCTGTCTCCACAAGT
rpp30_F_1664_ACCGTCCTCA	AATGATACGGCGACCACCGAGATCTACACACCGTCCTCAGAGCGGCTGTCTCCACAAGT
rpp30_F_1665_ACCTACTTAG	AATGATACGGCGACCACCGAGATCTACACACCTACTTAGGAGCGGCTGTCTCCACAAGT
rpp30_F_1666_ACCTGAACGA	AATGATACGGCGACCACCGAGATCTACACACCTGAACGAGAGCGGCTGTCTCCACAAGT
rpp30_F_1667_ACCTGTCTAT	AATGATACGGCGACCACCGAGATCTACACACCTGTCTATGAGCGGCTGTCTCCACAAGT
rpp30_F_1668_ACCTTATAGG	AATGATACGGCGACCACCGAGATCTACACACCTTATAGGGAGCGGCTGTCTCCACAAGT
rpp30_F_1669_ACGAAGTCAA	AATGATACGGCGACCACCGAGATCTACACACGAAGTCAAGAGCGGCTGTCTCCACAAGT
rpp30_F_1670_ACGAATCAGT	AATGATACGGCGACCACCGAGATCTACACACGAATCAGTGAGCGGCTGTCTCCACAAGT
rpp30_F_1671_ACGACCTCAG	AATGATACGGCGACCACCGAGATCTACACACGACCTCAGGAGCGGCTGTCTCCACAAGT
rpp30_F_1672_ACGACTATCT	AATGATACGGCGACCACCGAGATCTACACACGACTATCTGAGCGGCTGTCTCCACAAGT
rpp30_F_1673_ACGAGATAGG	AATGATACGGCGACCACCGAGATCTACACACGAGATAGGGAGCGGCTGTCTCCACAAGT
rpp30_F_1674_ACGATAGCCA	AATGATACGGCGACCACCGAGATCTACACACGATAGCCAGAGCGGCTGTCTCCACAAGT
rpp30_F_1675_ACGCATAACT	AATGATACGGCGACCACCGAGATCTACACACGCATAACTGAGCGGCTGTCTCCACAAGT
rpp30_F_1676_ACGCTTCAAG	AATGATACGGCGACCACCGAGATCTACACACGCTTCAAGGAGCGGCTGTCTCCACAAGT
rpp30_F_1677_ACGTAATTGG	AATGATACGGCGACCACCGAGATCTACACACGTAATTGGGAGCGGCTGTCTCCACAAGT
rpp30_F_1678_ACGTACACCT	AATGATACGGCGACCACCGAGATCTACACACGTACACCTGAGCGGCTGTCTCCACAAGT
rpp30_F_1679_ACGTCACGAG	AATGATACGGCGACCACCGAGATCTACACACGTCACGAGGAGCGGCTGTCTCCACAAGT
rpp30_F_1680_ACTAACCTTG	AATGATACGGCGACCACCGAGATCTACACACTAACCTTGGAGCGGCTGTCTCCACAAGT
rpp30_F_1681_ACTACAACTG	AATGATACGGCGACCACCGAGATCTACACACTACAACTGGAGCGGCTGTCTCCACAAGT
rpp30_F_1682_ACTACCAAGC	AATGATACGGCGACCACCGAGATCTACACACTACCAAGCGAGCGGCTGTCTCCACAAGT
rpp30_F_1683_ACTACCACAA	AATGATACGGCGACCACCGAGATCTACACACTACCACAAGAGCGGCTGTCTCCACAAGT
rpp30_F_1684_ACTACGAACA	AATGATACGGCGACCACCGAGATCTACACACTACGAACAGAGCGGCTGTCTCCACAAGT
rpp30_F_1685_ACTAGAGCAA	AATGATACGGCGACCACCGAGATCTACACACTAGAGCAAGAGCGGCTGTCTCCACAAGT
rpp30_F_1686_ACTAGTCAAG	AATGATACGGCGACCACCGAGATCTACACACTAGTCAAGGAGCGGCTGTCTCCACAAGT
rpp30_F_1687_ACTCAGCCAT	AATGATACGGCGACCACCGAGATCTACACACTCAGCCATGAGCGGCTGTCTCCACAAGT
rpp30_F_1688_ACTCATTCAG	AATGATACGGCGACCACCGAGATCTACACACTCATTCAGGAGCGGCTGTCTCCACAAGT
rpp30_F_1689_ACTCCTCAAT	AATGATACGGCGACCACCGAGATCTACACACTCCTCAATGAGCGGCTGTCTCCACAAGT
rpp30_F_1690_ACTCCTTAGC	AATGATACGGCGACCACCGAGATCTACACACTCCTTAGCGAGCGGCTGTCTCCACAAGT
rpp30_F_1691_ACTCGACTGA	AATGATACGGCGACCACCGAGATCTACACACTCGACTGAGAGCGGCTGTCTCCACAAGT
rpp30_F_1692_ACTCTGCTCT	AATGATACGGCGACCACCGAGATCTACACACTCTGCTCTGAGCGGCTGTCTCCACAAGT
rpp30_F_1693_ACTGAGTTCA	AATGATACGGCGACCACCGAGATCTACACACTGAGTTCAGAGCGGCTGTCTCCACAAGT
rpp30_F_1694_ACTGCCATTA	AATGATACGGCGACCACCGAGATCTACACACTGCCATTAGAGCGGCTGTCTCCACAAGT
rpp30_F_1695_ACTGGCTATT	AATGATACGGCGACCACCGAGATCTACACACTGGCTATTGAGCGGCTGTCTCCACAAGT
rpp30_F_1696_ACTGGTAAGT	AATGATACGGCGACCACCGAGATCTACACACTGGTAAGTGAGCGGCTGTCTCCACAAGT
rpp30_F_1697_ACTTACAGAG	AATGATACGGCGACCACCGAGATCTACACACTTACAGAGGAGCGGCTGTCTCCACAAGT
rpp30_F_1698_AGAACACAAC	AATGATACGGCGACCACCGAGATCTACACAGAACACAACGAGCGGCTGTCTCCACAAGT
rpp30_F_1699_AGAACACTGA	AATGATACGGCGACCACCGAGATCTACACAGAACACTGAGAGCGGCTGTCTCCACAAGT
rpp30_F_1700_AGAACTCCAA	AATGATACGGCGACCACCGAGATCTACACAGAACTCCAAGAGCGGCTGTCTCCACAAGT
rpp30_F_1701_AGAATACAGG	AATGATACGGCGACCACCGAGATCTACACAGAATACAGGGAGCGGCTGTCTCCACAAGT
rpp30_F_1702_AGAATGAGGA	AATGATACGGCGACCACCGAGATCTACACAGAATGAGGAGAGCGGCTGTCTCCACAAGT
rpp30_F_1703_AGACAACCTG	AATGATACGGCGACCACCGAGATCTACACAGACAACCTGGAGCGGCTGTCTCCACAAGT
rpp30_F_1704_AGACAGATGA	AATGATACGGCGACCACCGAGATCTACACAGACAGATGAGAGCGGCTGTCTCCACAAGT
rpp30_F_1705_AGACCGATTC	AATGATACGGCGACCACCGAGATCTACACAGACCGATTCGAGCGGCTGTCTCCACAAGT
rpp30_F_1706_AGACGACATT	AATGATACGGCGACCACCGAGATCTACACAGACGACATTGAGCGGCTGTCTCCACAAGT
rpp30_F_1707_AGACGTAACC	AATGATACGGCGACCACCGAGATCTACACAGACGTAACCGAGCGGCTGTCTCCACAAGT
rpp30_F_1708_AGACTACTAG	AATGATACGGCGACCACCGAGATCTACACAGACTACTAGGAGCGGCTGTCTCCACAAGT
rpp30_F_1709_AGAGAAGTGG	AATGATACGGCGACCACCGAGATCTACACAGAGAAGTGGGAGCGGCTGTCTCCACAAGT
rpp30_F_1710_AGAGACTAAG	AATGATACGGCGACCACCGAGATCTACACAGAGACTAAGGAGCGGCTGTCTCCACAAGT
rpp30_F_1711_AGAGAGTCGT	AATGATACGGCGACCACCGAGATCTACACAGAGAGTCGTGAGCGGCTGTCTCCACAAGT
rpp30_F_1712_AGAGCAACGA	AATGATACGGCGACCACCGAGATCTACACAGAGCAACGAGAGCGGCTGTCTCCACAAGT
rpp30_F_1713_AGAGCCTTCC	AATGATACGGCGACCACCGAGATCTACACAGAGCCTTCCGAGCGGCTGTCTCCACAAGT
rpp30_F_1714_AGAGGATTCT	AATGATACGGCGACCACCGAGATCTACACAGAGGATTCTGAGCGGCTGTCTCCACAAGT
rpp30_F_1715_AGAGGCATGA	AATGATACGGCGACCACCGAGATCTACACAGAGGCATGAGAGCGGCTGTCTCCACAAGT
rpp30_F_1716_AGAGGCCAAT	AATGATACGGCGACCACCGAGATCTACACAGAGGCCAATGAGCGGCTGTCTCCACAAGT
rpp30_F_1717_AGCAAGACAA	AATGATACGGCGACCACCGAGATCTACACAGCAAGACAAGAGCGGCTGTCTCCACAAGT
rpp30_F_1718_AGCAGACCGA	AATGATACGGCGACCACCGAGATCTACACAGCAGACCGAGAGCGGCTGTCTCCACAAGT
rpp30_F_1719_AGCCACTGAA	AATGATACGGCGACCACCGAGATCTACACAGCCACTGAAGAGCGGCTGTCTCCACAAGT
rpp30_F_1720_AGCCATTCCT	AATGATACGGCGACCACCGAGATCTACACAGCCATTCCTGAGCGGCTGTCTCCACAAGT
rpp30_F_1721_AGCCTAACAA	AATGATACGGCGACCACCGAGATCTACACAGCCTAACAAGAGCGGCTGTCTCCACAAGT
rpp30_F_1722_AGCTAACGAG	AATGATACGGCGACCACCGAGATCTACACAGCTAACGAGGAGCGGCTGTCTCCACAAGT
rpp30_F_1723_AGCTAGAAGG	AATGATACGGCGACCACCGAGATCTACACAGCTAGAAGGGAGCGGCTGTCTCCACAAGT
rpp30_F_1724_AGGAACCAAG	AATGATACGGCGACCACCGAGATCTACACAGGAACCAAGGAGCGGCTGTCTCCACAAGT
rpp30_F_1725_AGGACCTTCA	AATGATACGGCGACCACCGAGATCTACACAGGACCTTCAGAGCGGCTGTCTCCACAAGT
rpp30_F_1726_AGGATATCTG	AATGATACGGCGACCACCGAGATCTACACAGGATATCTGGAGCGGCTGTCTCCACAAGT
rpp30_F_1727_AGGCAATCGT	AATGATACGGCGACCACCGAGATCTACACAGGCAATCGTGAGCGGCTGTCTCCACAAGT
rpp30_F_1728_AGGCAGTAAT	AATGATACGGCGACCACCGAGATCTACACAGGCAGTAATGAGCGGCTGTCTCCACAAGT
rpp30_F_1729_AGGTACAGGA	AATGATACGGCGACCACCGAGATCTACACAGGTACAGGAGAGCGGCTGTCTCCACAAGT
rpp30_F_1730_AGTACGAGAT	AATGATACGGCGACCACCGAGATCTACACAGTACGAGATGAGCGGCTGTCTCCACAAGT
rpp30_F_1731_AGTATACCAG	AATGATACGGCGACCACCGAGATCTACACAGTATACCAGGAGCGGCTGTCTCCACAAGT
rpp30_F_1732_AGTCACAACA	AATGATACGGCGACCACCGAGATCTACACAGTCACAACAGAGCGGCTGTCTCCACAAGT
rpp30_F_1733_AGTCCTCCAG	AATGATACGGCGACCACCGAGATCTACACAGTCCTCCAGGAGCGGCTGTCTCCACAAGT
rpp30_F_1734_AGTCTCAGAA	AATGATACGGCGACCACCGAGATCTACACAGTCTCAGAAGAGCGGCTGTCTCCACAAGT
rpp30_F_1735_AGTCTTCATC	AATGATACGGCGACCACCGAGATCTACACAGTCTTCATCGAGCGGCTGTCTCCACAAGT
rpp30_F_1736_AGTGCCATGT	AATGATACGGCGACCACCGAGATCTACACAGTGCCATGTGAGCGGCTGTCTCCACAAGT
rpp30_F_1737_AGTGCGTCAT	AATGATACGGCGACCACCGAGATCTACACAGTGCGTCATGAGCGGCTGTCTCCACAAGT
rpp30_F_1738_AGTTCCTGAC	AATGATACGGCGACCACCGAGATCTACACAGTTCCTGACGAGCGGCTGTCTCCACAAGT
rpp30_F_1739_ATACCACATG	AATGATACGGCGACCACCGAGATCTACACATACCACATGGAGCGGCTGTCTCCACAAGT
rpp30_F_1740_ATACCATCGA	AATGATACGGCGACCACCGAGATCTACACATACCATCGAGAGCGGCTGTCTCCACAAGT
rpp30_F_1741_ATACCTCACA	AATGATACGGCGACCACCGAGATCTACACATACCTCACAGAGCGGCTGTCTCCACAAGT
rpp30_F_1742_ATACGACTCA	AATGATACGGCGACCACCGAGATCTACACATACGACTCAGAGCGGCTGTCTCCACAAGT
rpp30_F_1743_ATAGCCTAAC	AATGATACGGCGACCACCGAGATCTACACATAGCCTAACGAGCGGCTGTCTCCACAAGT
rpp30_F_1744_ATAGGATAGG	AATGATACGGCGACCACCGAGATCTACACATAGGATAGGGAGCGGCTGTCTCCACAAGT
rpp30_F_1745_ATAGTCTTGG	AATGATACGGCGACCACCGAGATCTACACATAGTCTTGGGAGCGGCTGTCTCCACAAGT
rpp30_F_1746_ATCAACTGGA	AATGATACGGCGACCACCGAGATCTACACATCAACTGGAGAGCGGCTGTCTCCACAAGT
rpp30_F_1747_ATCAATCCAG	AATGATACGGCGACCACCGAGATCTACACATCAATCCAGGAGCGGCTGTCTCCACAAGT
rpp30_F_1748_ATCATGCCTG	AATGATACGGCGACCACCGAGATCTACACATCATGCCTGGAGCGGCTGTCTCCACAAGT
rpp30_F_1749_ATCCACCATT	AATGATACGGCGACCACCGAGATCTACACATCCACCATTGAGCGGCTGTCTCCACAAGT
rpp30_F_1750_ATCCAGTCAT	AATGATACGGCGACCACCGAGATCTACACATCCAGTCATGAGCGGCTGTCTCCACAAGT
rpp30_F_1751_ATCCGATCCA	AATGATACGGCGACCACCGAGATCTACACATCCGATCCAGAGCGGCTGTCTCCACAAGT
rpp30_F_1752_ATCCTAAGGA	AATGATACGGCGACCACCGAGATCTACACATCCTAAGGAGAGCGGCTGTCTCCACAAGT
rpp30_F_1753_ATCCTCGAAG	AATGATACGGCGACCACCGAGATCTACACATCCTCGAAGGAGCGGCTGTCTCCACAAGT
rpp30_F_1754_ATCCTGCATA	AATGATACGGCGACCACCGAGATCTACACATCCTGCATAGAGCGGCTGTCTCCACAAGT
rpp30_F_1755_ATCCTTCTAG	AATGATACGGCGACCACCGAGATCTACACATCCTTCTAGGAGCGGCTGTCTCCACAAGT
rpp30_F_1756_ATCTCCACGA	AATGATACGGCGACCACCGAGATCTACACATCTCCACGAGAGCGGCTGTCTCCACAAGT
rpp30_F_1757_ATCTGCCTCA	AATGATACGGCGACCACCGAGATCTACACATCTGCCTCAGAGCGGCTGTCTCCACAAGT
rpp30_F_1758_ATGAAGGTCA	AATGATACGGCGACCACCGAGATCTACACATGAAGGTCAGAGCGGCTGTCTCCACAAGT
rpp30_F_1759_ATGACCGAAG	AATGATACGGCGACCACCGAGATCTACACATGACCGAAGGAGCGGCTGTCTCCACAAGT
rpp30_F_1760_ATGACGAGTT	AATGATACGGCGACCACCGAGATCTACACATGACGAGTTGAGCGGCTGTCTCCACAAGT
rpp30_F_1761_ATGCGTACAA	AATGATACGGCGACCACCGAGATCTACACATGCGTACAAGAGCGGCTGTCTCCACAAGT
rpp30_F_1762_ATGGACATCT	AATGATACGGCGACCACCGAGATCTACACATGGACATCTGAGCGGCTGTCTCCACAAGT
rpp30_F_1763_ATTACGATGC	AATGATACGGCGACCACCGAGATCTACACATTACGATGCGAGCGGCTGTCTCCACAAGT
rpp30_F_1764_ATTGGACAGA	AATGATACGGCGACCACCGAGATCTACACATTGGACAGAGAGCGGCTGTCTCCACAAGT
rpp30_F_1765_ATTGTCATCC	AATGATACGGCGACCACCGAGATCTACACATTGTCATCCGAGCGGCTGTCTCCACAAGT
rpp30_F_1766_CAACAAGCGA	AATGATACGGCGACCACCGAGATCTACACCAACAAGCGAGAGCGGCTGTCTCCACAAGT
rpp30_F_1767_CAACATAGGT	AATGATACGGCGACCACCGAGATCTACACCAACATAGGTGAGCGGCTGTCTCCACAAGT
rpp30_F_1768_CAACATGAAG	AATGATACGGCGACCACCGAGATCTACACCAACATGAAGGAGCGGCTGTCTCCACAAGT
rpp30_F_1769_CAACTACAAC	AATGATACGGCGACCACCGAGATCTACACCAACTACAACGAGCGGCTGTCTCCACAAGT
rpp30_F_1770_CAACTCAGAA	AATGATACGGCGACCACCGAGATCTACACCAACTCAGAAGAGCGGCTGTCTCCACAAGT
rpp30_F_1771_CAAGACCTGA	AATGATACGGCGACCACCGAGATCTACACCAAGACCTGAGAGCGGCTGTCTCCACAAGT
rpp30_F_1772_CAAGATCCTT	AATGATACGGCGACCACCGAGATCTACACCAAGATCCTTGAGCGGCTGTCTCCACAAGT
rpp30_F_1773_CAAGCCATAG	AATGATACGGCGACCACCGAGATCTACACCAAGCCATAGGAGCGGCTGTCTCCACAAGT
rpp30_F_1774_CAAGGATAAG	AATGATACGGCGACCACCGAGATCTACACCAAGGATAAGGAGCGGCTGTCTCCACAAGT
rpp30_F_1775_CAAGTCATCC	AATGATACGGCGACCACCGAGATCTACACCAAGTCATCCGAGCGGCTGTCTCCACAAGT
rpp30_F_1776_CAATAGGAGT	AATGATACGGCGACCACCGAGATCTACACCAATAGGAGTGAGCGGCTGTCTCCACAAGT
rpp30_F_1777_CAATATGCCT	AATGATACGGCGACCACCGAGATCTACACCAATATGCCTGAGCGGCTGTCTCCACAAGT
rpp30_F_1778_CAATTACCTG	AATGATACGGCGACCACCGAGATCTACACCAATTACCTGGAGCGGCTGTCTCCACAAGT
rpp30_F_1779_CAATTCCGAT	AATGATACGGCGACCACCGAGATCTACACCAATTCCGATGAGCGGCTGTCTCCACAAGT
rpp30_F_1780_CACAACTCTG	AATGATACGGCGACCACCGAGATCTACACCACAACTCTGGAGCGGCTGTCTCCACAAGT
rpp30_F_1781_CACAACTTCA	AATGATACGGCGACCACCGAGATCTACACCACAACTTCAGAGCGGCTGTCTCCACAAGT
rpp30_F_1782_CACAAGAAGG	AATGATACGGCGACCACCGAGATCTACACCACAAGAAGGGAGCGGCTGTCTCCACAAGT
rpp30_F_1783_CACACCACTA	AATGATACGGCGACCACCGAGATCTACACCACACCACTAGAGCGGCTGTCTCCACAAGT
rpp30_F_1784_CACAGAACGA	AATGATACGGCGACCACCGAGATCTACACCACAGAACGAGAGCGGCTGTCTCCACAAGT
rpp30_F_1785_CACAGACTAT	AATGATACGGCGACCACCGAGATCTACACCACAGACTATGAGCGGCTGTCTCCACAAGT
rpp30_F_1786_CACAGTTAAG	AATGATACGGCGACCACCGAGATCTACACCACAGTTAAGGAGCGGCTGTCTCCACAAGT
rpp30_F_1787_CACATATAGG	AATGATACGGCGACCACCGAGATCTACACCACATATAGGGAGCGGCTGTCTCCACAAGT
rpp30_F_1788_CACATGCGAA	AATGATACGGCGACCACCGAGATCTACACCACATGCGAAGAGCGGCTGTCTCCACAAGT
rpp30_F_1789_CACATTCGTG	AATGATACGGCGACCACCGAGATCTACACCACATTCGTGGAGCGGCTGTCTCCACAAGT
rpp30_F_1790_CACCAACAGA	AATGATACGGCGACCACCGAGATCTACACCACCAACAGAGAGCGGCTGTCTCCACAAGT
rpp30_F_1791_CACCAATTAC	AATGATACGGCGACCACCGAGATCTACACCACCAATTACGAGCGGCTGTCTCCACAAGT
rpp30_F_1792_CACCATAACA	AATGATACGGCGACCACCGAGATCTACACCACCATAACAGAGCGGCTGTCTCCACAAGT
rpp30_F_1793_CACCTCCTTA	AATGATACGGCGACCACCGAGATCTACACCACCTCCTTAGAGCGGCTGTCTCCACAAGT
rpp30_F_1794_CACCTTACAA	AATGATACGGCGACCACCGAGATCTACACCACCTTACAAGAGCGGCTGTCTCCACAAGT
rpp30_F_1795_CACGAGATTA	AATGATACGGCGACCACCGAGATCTACACCACGAGATTAGAGCGGCTGTCTCCACAAGT
rpp30_F_1796_CACGTTGCTT	AATGATACGGCGACCACCGAGATCTACACCACGTTGCTTGAGCGGCTGTCTCCACAAGT
rpp30_F_1797_CACTACTCAA	AATGATACGGCGACCACCGAGATCTACACCACTACTCAAGAGCGGCTGTCTCCACAAGT
rpp30_F_1798_CACTATCCGA	AATGATACGGCGACCACCGAGATCTACACCACTATCCGAGAGCGGCTGTCTCCACAAGT
rpp30_F_1799_CACTATTGCT	AATGATACGGCGACCACCGAGATCTACACCACTATTGCTGAGCGGCTGTCTCCACAAGT
rpp30_F_1800_CACTTCCTGT	AATGATACGGCGACCACCGAGATCTACACCACTTCCTGTGAGCGGCTGTCTCCACAAGT
rpp30_F_1801_CACTTCTAAG	AATGATACGGCGACCACCGAGATCTACACCACTTCTAAGGAGCGGCTGTCTCCACAAGT
rpp30_F_1802_CAGAGATGGA	AATGATACGGCGACCACCGAGATCTACACCAGAGATGGAGAGCGGCTGTCTCCACAAGT
rpp30_F_1803_CAGTACTTCC	AATGATACGGCGACCACCGAGATCTACACCAGTACTTCCGAGCGGCTGTCTCCACAAGT
rpp30_F_1804_CAGTTGATTG	AATGATACGGCGACCACCGAGATCTACACCAGTTGATTGGAGCGGCTGTCTCCACAAGT
rpp30_F_1805_CATACAATGC	AATGATACGGCGACCACCGAGATCTACACCATACAATGCGAGCGGCTGTCTCCACAAGT
rpp30_F_1806_CATACTCCTA	AATGATACGGCGACCACCGAGATCTACACCATACTCCTAGAGCGGCTGTCTCCACAAGT
rpp30_F_1807_CATCAGGTAG	AATGATACGGCGACCACCGAGATCTACACCATCAGGTAGGAGCGGCTGTCTCCACAAGT
rpp30_F_1808_CATCATGGCT	AATGATACGGCGACCACCGAGATCTACACCATCATGGCTGAGCGGCTGTCTCCACAAGT
rpp30_F_1809_CATCCACTAT	AATGATACGGCGACCACCGAGATCTACACCATCCACTATGAGCGGCTGTCTCCACAAGT
rpp30_F_1810_CATGAATAGG	AATGATACGGCGACCACCGAGATCTACACCATGAATAGGGAGCGGCTGTCTCCACAAGT
rpp30_F_1811_CATTCACGAA	AATGATACGGCGACCACCGAGATCTACACCATTCACGAAGAGCGGCTGTCTCCACAAGT
rpp30_F_1812_CCAACACTCC	AATGATACGGCGACCACCGAGATCTACACCCAACACTCCGAGCGGCTGTCTCCACAAGT
rpp30_F_1813_CCAACCACTG	AATGATACGGCGACCACCGAGATCTACACCCAACCACTGGAGCGGCTGTCTCCACAAGT
rpp30_F_1814_CCAAGAGAAG	AATGATACGGCGACCACCGAGATCTACACCCAAGAGAAGGAGCGGCTGTCTCCACAAGT
rpp30_F_1815_CCAATACAGT	AATGATACGGCGACCACCGAGATCTACACCCAATACAGTGAGCGGCTGTCTCCACAAGT
rpp30_F_1816_CCAATAGCGA	AATGATACGGCGACCACCGAGATCTACACCCAATAGCGAGAGCGGCTGTCTCCACAAGT
rpp30_F_1817_CCACATAACC	AATGATACGGCGACCACCGAGATCTACACCCACATAACCGAGCGGCTGTCTCCACAAGT
rpp30_F_1818_CCACCGAACA	AATGATACGGCGACCACCGAGATCTACACCCACCGAACAGAGCGGCTGTCTCCACAAGT
rpp30_F_1819_CCAGAAGTTG	AATGATACGGCGACCACCGAGATCTACACCCAGAAGTTGGAGCGGCTGTCTCCACAAGT
rpp30_F_1820_CCAGGAATTC	AATGATACGGCGACCACCGAGATCTACACCCAGGAATTCGAGCGGCTGTCTCCACAAGT
rpp30_F_1821_CCATAACTAC	AATGATACGGCGACCACCGAGATCTACACCCATAACTACGAGCGGCTGTCTCCACAAGT
rpp30_F_1822_CCATCACAGA	AATGATACGGCGACCACCGAGATCTACACCCATCACAGAGAGCGGCTGTCTCCACAAGT
rpp30_F_1823_CCATCATTAG	AATGATACGGCGACCACCGAGATCTACACCCATCATTAGGAGCGGCTGTCTCCACAAGT
rpp30_F_1824_CCATTGTTGC	AATGATACGGCGACCACCGAGATCTACACCCATTGTTGCGAGCGGCTGTCTCCACAAGT
rpp30_F_1825_CCGAATTGAA	AATGATACGGCGACCACCGAGATCTACACCCGAATTGAAGAGCGGCTGTCTCCACAAGT
rpp30_F_1826_CCGACAACGA	AATGATACGGCGACCACCGAGATCTACACCCGACAACGAGAGCGGCTGTCTCCACAAGT
rpp30_F_1827_CCGATAACTT	AATGATACGGCGACCACCGAGATCTACACCCGATAACTTGAGCGGCTGTCTCCACAAGT
rpp30_F_1828_CCGATGCGTT	AATGATACGGCGACCACCGAGATCTACACCCGATGCGTTGAGCGGCTGTCTCCACAAGT
rpp30_F_1829_CCGTAACCTG	AATGATACGGCGACCACCGAGATCTACACCCGTAACCTGGAGCGGCTGTCTCCACAAGT
rpp30_F_1830_CCGTCCATGA	AATGATACGGCGACCACCGAGATCTACACCCGTCCATGAGAGCGGCTGTCTCCACAAGT
rpp30_F_1831_CCGTTAATAG	AATGATACGGCGACCACCGAGATCTACACCCGTTAATAGGAGCGGCTGTCTCCACAAGT
rpp30_F_1832_CCGTTACTCT	AATGATACGGCGACCACCGAGATCTACACCCGTTACTCTGAGCGGCTGTCTCCACAAGT
rpp30_F_1833_CCGTTCTTCA	AATGATACGGCGACCACCGAGATCTACACCCGTTCTTCAGAGCGGCTGTCTCCACAAGT
rpp30_F_1834_CCGTTGTCAA	AATGATACGGCGACCACCGAGATCTACACCCGTTGTCAAGAGCGGCTGTCTCCACAAGT
rpp30_F_1835_CCTAACATCT	AATGATACGGCGACCACCGAGATCTACACCCTAACATCTGAGCGGCTGTCTCCACAAGT
rpp30_F_1836_CCTACTGCGA	AATGATACGGCGACCACCGAGATCTACACCCTACTGCGAGAGCGGCTGTCTCCACAAGT
rpp30_F_1837_CCTAGGAAGC	AATGATACGGCGACCACCGAGATCTACACCCTAGGAAGCGAGCGGCTGTCTCCACAAGT
rpp30_F_1838_CCTATTGATG	AATGATACGGCGACCACCGAGATCTACACCCTATTGATGGAGCGGCTGTCTCCACAAGT
rpp30_F_1839_CCTCAACCAA	AATGATACGGCGACCACCGAGATCTACACCCTCAACCAAGAGCGGCTGTCTCCACAAGT
rpp30_F_1840_CCTCATTCTT	AATGATACGGCGACCACCGAGATCTACACCCTCATTCTTGAGCGGCTGTCTCCACAAGT
rpp30_F_1841_CCTCTACGAG	AATGATACGGCGACCACCGAGATCTACACCCTCTACGAGGAGCGGCTGTCTCCACAAGT
rpp30_F_1842_CCTGAATCTG	AATGATACGGCGACCACCGAGATCTACACCCTGAATCTGGAGCGGCTGTCTCCACAAGT
rpp30_F_1843_CCTTACGTTG	AATGATACGGCGACCACCGAGATCTACACCCTTACGTTGGAGCGGCTGTCTCCACAAGT
rpp30_F_1844_CCTTAGAATG	AATGATACGGCGACCACCGAGATCTACACCCTTAGAATGGAGCGGCTGTCTCCACAAGT
rpp30_F_1845_CCTTCCGTCA	AATGATACGGCGACCACCGAGATCTACACCCTTCCGTCAGAGCGGCTGTCTCCACAAGT
rpp30_F_1846_CCTTCCTCTT	AATGATACGGCGACCACCGAGATCTACACCCTTCCTCTTGAGCGGCTGTCTCCACAAGT
rpp30_F_1847_CGAACCAAGG	AATGATACGGCGACCACCGAGATCTACACCGAACCAAGGGAGCGGCTGTCTCCACAAGT
rpp30_F_1848_CGAACCAGTA	AATGATACGGCGACCACCGAGATCTACACCGAACCAGTAGAGCGGCTGTCTCCACAAGT
rpp30_F_1849_CGAACGCTTG	AATGATACGGCGACCACCGAGATCTACACCGAACGCTTGGAGCGGCTGTCTCCACAAGT
rpp30_F_1850_CGAAGACACA	AATGATACGGCGACCACCGAGATCTACACCGAAGACACAGAGCGGCTGTCTCCACAAGT
rpp30_F_1851_CGAAGATGAA	AATGATACGGCGACCACCGAGATCTACACCGAAGATGAAGAGCGGCTGTCTCCACAAGT
rpp30_F_1852_CGAAGCTCTT	AATGATACGGCGACCACCGAGATCTACACCGAAGCTCTTGAGCGGCTGTCTCCACAAGT
rpp30_F_1853_CGAAGTAACT	AATGATACGGCGACCACCGAGATCTACACCGAAGTAACTGAGCGGCTGTCTCCACAAGT
rpp30_F_1854_CGAATCTAAG	AATGATACGGCGACCACCGAGATCTACACCGAATCTAAGGAGCGGCTGTCTCCACAAGT
rpp30_F_1855_CGACAATCTT	AATGATACGGCGACCACCGAGATCTACACCGACAATCTTGAGCGGCTGTCTCCACAAGT
rpp30_F_1856_CGACAGAATG	AATGATACGGCGACCACCGAGATCTACACCGACAGAATGGAGCGGCTGTCTCCACAAGT
rpp30_F_1857_CGACCAATAG	AATGATACGGCGACCACCGAGATCTACACCGACCAATAGGAGCGGCTGTCTCCACAAGT
rpp30_F_1858_CGACTAAGTA	AATGATACGGCGACCACCGAGATCTACACCGACTAAGTAGAGCGGCTGTCTCCACAAGT
rpp30_F_1859_CGACTCACTT	AATGATACGGCGACCACCGAGATCTACACCGACTCACTTGAGCGGCTGTCTCCACAAGT
rpp30_F_1860_CGACTGACAA	AATGATACGGCGACCACCGAGATCTACACCGACTGACAAGAGCGGCTGTCTCCACAAGT
rpp30_F_1861_CGAGATTCGA	AATGATACGGCGACCACCGAGATCTACACCGAGATTCGAGAGCGGCTGTCTCCACAAGT
rpp30_F_1862_CGAGGACTAA	AATGATACGGCGACCACCGAGATCTACACCGAGGACTAAGAGCGGCTGTCTCCACAAGT
rpp30_F_1863_CGAGTCATAA	AATGATACGGCGACCACCGAGATCTACACCGAGTCATAAGAGCGGCTGTCTCCACAAGT
rpp30_F_1864_CGATTAGTTG	AATGATACGGCGACCACCGAGATCTACACCGATTAGTTGGAGCGGCTGTCTCCACAAGT
rpp30_F_1865_CGCACTCAAG	AATGATACGGCGACCACCGAGATCTACACCGCACTCAAGGAGCGGCTGTCTCCACAAGT
rpp30_F_1866_CGTAACTCAG	AATGATACGGCGACCACCGAGATCTACACCGTAACTCAGGAGCGGCTGTCTCCACAAGT
rpp30_F_1867_CGTACCAACT	AATGATACGGCGACCACCGAGATCTACACCGTACCAACTGAGCGGCTGTCTCCACAAGT
rpp30_F_1868_CGTACCGTTA	AATGATACGGCGACCACCGAGATCTACACCGTACCGTTAGAGCGGCTGTCTCCACAAGT
rpp30_F_1869_CGTAGTTAGC	AATGATACGGCGACCACCGAGATCTACACCGTAGTTAGCGAGCGGCTGTCTCCACAAGT
rpp30_F_1870_CGTCATTCCA	AATGATACGGCGACCACCGAGATCTACACCGTCATTCCAGAGCGGCTGTCTCCACAAGT
rpp30_F_1871_CGTCCTTGTT	AATGATACGGCGACCACCGAGATCTACACCGTCCTTGTTGAGCGGCTGTCTCCACAAGT
rpp30_F_1872_CGTCTGAATT	AATGATACGGCGACCACCGAGATCTACACCGTCTGAATTGAGCGGCTGTCTCCACAAGT
rpp30_F_1873_CGTGATGAGG	AATGATACGGCGACCACCGAGATCTACACCGTGATGAGGGAGCGGCTGTCTCCACAAGT
rpp30_F_1874_CGTTACAATC	AATGATACGGCGACCACCGAGATCTACACCGTTACAATCGAGCGGCTGTCTCCACAAGT
rpp30_F_1875_CGTTCTACCT	AATGATACGGCGACCACCGAGATCTACACCGTTCTACCTGAGCGGCTGTCTCCACAAGT
rpp30_F_1876_CTAATGCTGG	AATGATACGGCGACCACCGAGATCTACACCTAATGCTGGGAGCGGCTGTCTCCACAAGT
rpp30_F_1877_CTACACTATC	AATGATACGGCGACCACCGAGATCTACACCTACACTATCGAGCGGCTGTCTCCACAAGT
rpp30_F_1878_CTACACTCCT	AATGATACGGCGACCACCGAGATCTACACCTACACTCCTGAGCGGCTGTCTCCACAAGT
rpp30_F_1879_CTACCAAGGA	AATGATACGGCGACCACCGAGATCTACACCTACCAAGGAGAGCGGCTGTCTCCACAAGT
rpp30_F_1880_CTACGTTGAG	AATGATACGGCGACCACCGAGATCTACACCTACGTTGAGGAGCGGCTGTCTCCACAAGT
rpp30_F_1881_CTACTGCATT	AATGATACGGCGACCACCGAGATCTACACCTACTGCATTGAGCGGCTGTCTCCACAAGT
rpp30_F_1882_CTAGCACTGA	AATGATACGGCGACCACCGAGATCTACACCTAGCACTGAGAGCGGCTGTCTCCACAAGT
rpp30_F_1883_CTAGCTCAAT	AATGATACGGCGACCACCGAGATCTACACCTAGCTCAATGAGCGGCTGTCTCCACAAGT
rpp30_F_1884_CTATACCGAG	AATGATACGGCGACCACCGAGATCTACACCTATACCGAGGAGCGGCTGTCTCCACAAGT
rpp30_F_1885_CTATGACGAT	AATGATACGGCGACCACCGAGATCTACACCTATGACGATGAGCGGCTGTCTCCACAAGT
rpp30_F_1886_CTATTCCAGT	AATGATACGGCGACCACCGAGATCTACACCTATTCCAGTGAGCGGCTGTCTCCACAAGT
rpp30_F_1887_CTCAAGATGA	AATGATACGGCGACCACCGAGATCTACACCTCAAGATGAGAGCGGCTGTCTCCACAAGT
rpp30_F_1888_CTCACGATCC	AATGATACGGCGACCACCGAGATCTACACCTCACGATCCGAGCGGCTGTCTCCACAAGT
rpp30_F_1889_CTCACTCCGA	AATGATACGGCGACCACCGAGATCTACACCTCACTCCGAGAGCGGCTGTCTCCACAAGT
rpp30_F_1890_CTCAGATTAG	AATGATACGGCGACCACCGAGATCTACACCTCAGATTAGGAGCGGCTGTCTCCACAAGT
rpp30_F_1891_CTCATATCTG	AATGATACGGCGACCACCGAGATCTACACCTCATATCTGGAGCGGCTGTCTCCACAAGT
rpp30_F_1892_CTCCAACCTT	AATGATACGGCGACCACCGAGATCTACACCTCCAACCTTGAGCGGCTGTCTCCACAAGT
rpp30_F_1893_CTCCACCACA	AATGATACGGCGACCACCGAGATCTACACCTCCACCACAGAGCGGCTGTCTCCACAAGT
rpp30_F_1894_CTCCACTCTA	AATGATACGGCGACCACCGAGATCTACACCTCCACTCTAGAGCGGCTGTCTCCACAAGT
rpp30_F_1895_CTCCAGAAGT	AATGATACGGCGACCACCGAGATCTACACCTCCAGAAGTGAGCGGCTGTCTCCACAAGT
rpp30_F_1896_CTCCGTAGTA	AATGATACGGCGACCACCGAGATCTACACCTCCGTAGTAGAGCGGCTGTCTCCACAAGT
rpp30_F_1897_CTCTACATTG	AATGATACGGCGACCACCGAGATCTACACCTCTACATTGGAGCGGCTGTCTCCACAAGT
rpp30_F_1898_CTCTAGTCCT	AATGATACGGCGACCACCGAGATCTACACCTCTAGTCCTGAGCGGCTGTCTCCACAAGT
rpp30_F_1899_CTGAGCCTAC	AATGATACGGCGACCACCGAGATCTACACCTGAGCCTACGAGCGGCTGTCTCCACAAGT
rpp30_F_1900_CTGGAATACT	AATGATACGGCGACCACCGAGATCTACACCTGGAATACTGAGCGGCTGTCTCCACAAGT
rpp30_F_1901_CTGTCTGAGT	AATGATACGGCGACCACCGAGATCTACACCTGTCTGAGTGAGCGGCTGTCTCCACAAGT
rpp30_F_1902_CTTACCTAAG	AATGATACGGCGACCACCGAGATCTACACCTTACCTAAGGAGCGGCTGTCTCCACAAGT
rpp30_F_1903_CTTCACTGTT	AATGATACGGCGACCACCGAGATCTACACCTTCACTGTTGAGCGGCTGTCTCCACAAGT
rpp30_F_1904_CTTCCTCGAA	AATGATACGGCGACCACCGAGATCTACACCTTCCTCGAAGAGCGGCTGTCTCCACAAGT
rpp30_F_1905_CTTCTCACTA	AATGATACGGCGACCACCGAGATCTACACCTTCTCACTAGAGCGGCTGTCTCCACAAGT
rpp30_F_1906_GAACACAGTT	AATGATACGGCGACCACCGAGATCTACACGAACACAGTTGAGCGGCTGTCTCCACAAGT
rpp30_F_1907_GAACACGTAA	AATGATACGGCGACCACCGAGATCTACACGAACACGTAAGAGCGGCTGTCTCCACAAGT
rpp30_F_1908_GAACAGTTGT	AATGATACGGCGACCACCGAGATCTACACGAACAGTTGTGAGCGGCTGTCTCCACAAGT
rpp30_F_1909_GAACCAGAAG	AATGATACGGCGACCACCGAGATCTACACGAACCAGAAGGAGCGGCTGTCTCCACAAGT
rpp30_F_1910_GAACGAATCT	AATGATACGGCGACCACCGAGATCTACACGAACGAATCTGAGCGGCTGTCTCCACAAGT
rpp30_F_1911_GAACTGTAAG	AATGATACGGCGACCACCGAGATCTACACGAACTGTAAGGAGCGGCTGTCTCCACAAGT
rpp30_F_1912_GAATTGTCTG	AATGATACGGCGACCACCGAGATCTACACGAATTGTCTGGAGCGGCTGTCTCCACAAGT
rpp30_F_1913_GACACTAGAG	AATGATACGGCGACCACCGAGATCTACACGACACTAGAGGAGCGGCTGTCTCCACAAGT
rpp30_F_1914_GACAGTAAGA	AATGATACGGCGACCACCGAGATCTACACGACAGTAAGAGAGCGGCTGTCTCCACAAGT
rpp30_F_1915_GACATAGCTA	AATGATACGGCGACCACCGAGATCTACACGACATAGCTAGAGCGGCTGTCTCCACAAGT
rpp30_F_1916_GACATCACTG	AATGATACGGCGACCACCGAGATCTACACGACATCACTGGAGCGGCTGTCTCCACAAGT
rpp30_F_1917_GACCAACTGT	AATGATACGGCGACCACCGAGATCTACACGACCAACTGTGAGCGGCTGTCTCCACAAGT
rpp30_F_1918_GACCAAGGAA	AATGATACGGCGACCACCGAGATCTACACGACCAAGGAAGAGCGGCTGTCTCCACAAGT
rpp30_F_1919_GACCGAATTA	AATGATACGGCGACCACCGAGATCTACACGACCGAATTAGAGCGGCTGTCTCCACAAGT
rpp30_F_1920_GACCTCTTAT	AATGATACGGCGACCACCGAGATCTACACGACCTCTTATGAGCGGCTGTCTCCACAAGT
rpp30_F_1921_GACCTGAGTT	AATGATACGGCGACCACCGAGATCTACACGACCTGAGTTGAGCGGCTGTCTCCACAAGT
rpp30_F_1922_GACTGACATG	AATGATACGGCGACCACCGAGATCTACACGACTGACATGGAGCGGCTGTCTCCACAAGT
rpp30_F_1923_GACTGGATAT	AATGATACGGCGACCACCGAGATCTACACGACTGGATATGAGCGGCTGTCTCCACAAGT
rpp30_F_1924_GACTGTTCCT	AATGATACGGCGACCACCGAGATCTACACGACTGTTCCTGAGCGGCTGTCTCCACAAGT
rpp30_F_1925_GAGACAGGTA	AATGATACGGCGACCACCGAGATCTACACGAGACAGGTAGAGCGGCTGTCTCCACAAGT
rpp30_F_1926_GAGATAGTGA	AATGATACGGCGACCACCGAGATCTACACGAGATAGTGAGAGCGGCTGTCTCCACAAGT
rpp30_F_1927_GAGATGCTAA	AATGATACGGCGACCACCGAGATCTACACGAGATGCTAAGAGCGGCTGTCTCCACAAGT
rpp30_F_1928_GAGCAGACTA	AATGATACGGCGACCACCGAGATCTACACGAGCAGACTAGAGCGGCTGTCTCCACAAGT
rpp30_F_1929_GAGCAGGATT	AATGATACGGCGACCACCGAGATCTACACGAGCAGGATTGAGCGGCTGTCTCCACAAGT
rpp30_F_1930_GAGTACCGAA	AATGATACGGCGACCACCGAGATCTACACGAGTACCGAAGAGCGGCTGTCTCCACAAGT
rpp30_F_1931_GAGTACGACT	AATGATACGGCGACCACCGAGATCTACACGAGTACGACTGAGCGGCTGTCTCCACAAGT
rpp30_F_1932_GAGTCATTGA	AATGATACGGCGACCACCGAGATCTACACGAGTCATTGAGAGCGGCTGTCTCCACAAGT
rpp30_F_1933_GATACACATC	AATGATACGGCGACCACCGAGATCTACACGATACACATCGAGCGGCTGTCTCCACAAGT
rpp30_F_1934_GATAGGTTCA	AATGATACGGCGACCACCGAGATCTACACGATAGGTTCAGAGCGGCTGTCTCCACAAGT
rpp30_F_1935_GATCAGCCTT	AATGATACGGCGACCACCGAGATCTACACGATCAGCCTTGAGCGGCTGTCTCCACAAGT
rpp30_F_1936_GATCCTACGA	AATGATACGGCGACCACCGAGATCTACACGATCCTACGAGAGCGGCTGTCTCCACAAGT
rpp30_F_1937_GATCTGCAAT	AATGATACGGCGACCACCGAGATCTACACGATCTGCAATGAGCGGCTGTCTCCACAAGT
rpp30_F_1938_GATGCTCATG	AATGATACGGCGACCACCGAGATCTACACGATGCTCATGGAGCGGCTGTCTCCACAAGT
rpp30_F_1939_GATTCCTCAA	AATGATACGGCGACCACCGAGATCTACACGATTCCTCAAGAGCGGCTGTCTCCACAAGT
rpp30_F_1940_GCAACCACAT	AATGATACGGCGACCACCGAGATCTACACGCAACCACATGAGCGGCTGTCTCCACAAGT
rpp30_F_1941_GCAATCGAGA	AATGATACGGCGACCACCGAGATCTACACGCAATCGAGAGAGCGGCTGTCTCCACAAGT
rpp30_F_1942_GCACGATTAG	AATGATACGGCGACCACCGAGATCTACACGCACGATTAGGAGCGGCTGTCTCCACAAGT
rpp30_F_1943_GCAGTCCAAT	AATGATACGGCGACCACCGAGATCTACACGCAGTCCAATGAGCGGCTGTCTCCACAAGT
rpp30_F_1944_GCATAGCTGG	AATGATACGGCGACCACCGAGATCTACACGCATAGCTGGGAGCGGCTGTCTCCACAAGT
rpp30_F_1945_GCATGTCTAA	AATGATACGGCGACCACCGAGATCTACACGCATGTCTAAGAGCGGCTGTCTCCACAAGT
rpp30_F_1946_GCTAACGCTT	AATGATACGGCGACCACCGAGATCTACACGCTAACGCTTGAGCGGCTGTCTCCACAAGT
rpp30_F_1947_GCTAATATGC	AATGATACGGCGACCACCGAGATCTACACGCTAATATGCGAGCGGCTGTCTCCACAAGT
rpp30_F_1948_GCTACAGATA	AATGATACGGCGACCACCGAGATCTACACGCTACAGATAGAGCGGCTGTCTCCACAAGT
rpp30_F_1949_GCTATGTGCT	AATGATACGGCGACCACCGAGATCTACACGCTATGTGCTGAGCGGCTGTCTCCACAAGT
rpp30_F_1950_GCTATTAGGA	AATGATACGGCGACCACCGAGATCTACACGCTATTAGGAGAGCGGCTGTCTCCACAAGT
rpp30_F_1951_GTATTGAAGC	AATGATACGGCGACCACCGAGATCTACACGTATTGAAGCGAGCGGCTGTCTCCACAAGT
rpp30_F_1952_GTCCTTACAT	AATGATACGGCGACCACCGAGATCTACACGTCCTTACATGAGCGGCTGTCTCCACAAGT
rpp30_F_1953_GTCTCTGAAT	AATGATACGGCGACCACCGAGATCTACACGTCTCTGAATGAGCGGCTGTCTCCACAAGT
rpp30_F_1954_GTTATACAGG	AATGATACGGCGACCACCGAGATCTACACGTTATACAGGGAGCGGCTGTCTCCACAAGT
rpp30_F_1955_GTTCACAGAA	AATGATACGGCGACCACCGAGATCTACACGTTCACAGAAGAGCGGCTGTCTCCACAAGT
rpp30_F_1956_GTTCATCAAG	AATGATACGGCGACCACCGAGATCTACACGTTCATCAAGGAGCGGCTGTCTCCACAAGT
rpp30_F_1957_GTTGCTTAGG	AATGATACGGCGACCACCGAGATCTACACGTTGCTTAGGGAGCGGCTGTCTCCACAAGT
rpp30_F_1958_TAAGTGCATG	AATGATACGGCGACCACCGAGATCTACACTAAGTGCATGGAGCGGCTGTCTCCACAAGT
rpp30_F_1959_TAATGCGTGA	AATGATACGGCGACCACCGAGATCTACACTAATGCGTGAGAGCGGCTGTCTCCACAAGT
rpp30_F_1960_TACACTGTTC	AATGATACGGCGACCACCGAGATCTACACTACACTGTTCGAGCGGCTGTCTCCACAAGT
rpp30_F_1961_TACCAATCTG	AATGATACGGCGACCACCGAGATCTACACTACCAATCTGGAGCGGCTGTCTCCACAAGT
rpp30_F_1962_TACCACAAGC	AATGATACGGCGACCACCGAGATCTACACTACCACAAGCGAGCGGCTGTCTCCACAAGT
rpp30_F_1963_TACGACATAG	AATGATACGGCGACCACCGAGATCTACACTACGACATAGGAGCGGCTGTCTCCACAAGT
rpp30_F_1964_TACGAGGAGG	AATGATACGGCGACCACCGAGATCTACACTACGAGGAGGGAGCGGCTGTCTCCACAAGT
rpp30_F_1965_TACGTACAGG	AATGATACGGCGACCACCGAGATCTACACTACGTACAGGGAGCGGCTGTCTCCACAAGT
rpp30_F_1966_TAGACATCGA	AATGATACGGCGACCACCGAGATCTACACTAGACATCGAGAGCGGCTGTCTCCACAAGT
rpp30_F_1967_TAGAGAGGTT	AATGATACGGCGACCACCGAGATCTACACTAGAGAGGTTGAGCGGCTGTCTCCACAAGT
rpp30_F_1968_TAGCAGAAGA	AATGATACGGCGACCACCGAGATCTACACTAGCAGAAGAGAGCGGCTGTCTCCACAAGT
rpp30_F_1969_TAGGAGAATG	AATGATACGGCGACCACCGAGATCTACACTAGGAGAATGGAGCGGCTGTCTCCACAAGT
rpp30_F_1970_TAGGCATGAG	AATGATACGGCGACCACCGAGATCTACACTAGGCATGAGGAGCGGCTGTCTCCACAAGT
rpp30_F_1971_TAGGTACACA	AATGATACGGCGACCACCGAGATCTACACTAGGTACACAGAGCGGCTGTCTCCACAAGT
rpp30_F_1972_TATGAGGCAT	AATGATACGGCGACCACCGAGATCTACACTATGAGGCATGAGCGGCTGTCTCCACAAGT
rpp30_F_1973_TATGCGTTAG	AATGATACGGCGACCACCGAGATCTACACTATGCGTTAGGAGCGGCTGTCTCCACAAGT
rpp30_F_1974_TATGTCCAAG	AATGATACGGCGACCACCGAGATCTACACTATGTCCAAGGAGCGGCTGTCTCCACAAGT
rpp30_F_1975_TCAACCTGGT	AATGATACGGCGACCACCGAGATCTACACTCAACCTGGTGAGCGGCTGTCTCCACAAGT
rpp30_F_1976_TCAAGGTTGC	AATGATACGGCGACCACCGAGATCTACACTCAAGGTTGCGAGCGGCTGTCTCCACAAGT
rpp30_F_1977_TCAGAGAAGG	AATGATACGGCGACCACCGAGATCTACACTCAGAGAAGGGAGCGGCTGTCTCCACAAGT
rpp30_F_1978_TCAGGACTTA	AATGATACGGCGACCACCGAGATCTACACTCAGGACTTAGAGCGGCTGTCTCCACAAGT
rpp30_F_1979_TCATGGCAAG	AATGATACGGCGACCACCGAGATCTACACTCATGGCAAGGAGCGGCTGTCTCCACAAGT
rpp30_F_1980_TCCAGAATCC	AATGATACGGCGACCACCGAGATCTACACTCCAGAATCCGAGCGGCTGTCTCCACAAGT
rpp30_F_1981_TCCATACGAT	AATGATACGGCGACCACCGAGATCTACACTCCATACGATGAGCGGCTGTCTCCACAAGT
rpp30_F_1982_TCCGACATCT	AATGATACGGCGACCACCGAGATCTACACTCCGACATCTGAGCGGCTGTCTCCACAAGT
rpp30_F_1983_TCCGAGTTAT	AATGATACGGCGACCACCGAGATCTACACTCCGAGTTATGAGCGGCTGTCTCCACAAGT
rpp30_F_1984_TCCTTGAACT	AATGATACGGCGACCACCGAGATCTACACTCCTTGAACTGAGCGGCTGTCTCCACAAGT
rpp30_F_1985_TCGACCACTA	AATGATACGGCGACCACCGAGATCTACACTCGACCACTAGAGCGGCTGTCTCCACAAGT
rpp30_F_1986_TCGATGAGAA	AATGATACGGCGACCACCGAGATCTACACTCGATGAGAAGAGCGGCTGTCTCCACAAGT
rpp30_F_1987_TCGCTTCATT	AATGATACGGCGACCACCGAGATCTACACTCGCTTCATTGAGCGGCTGTCTCCACAAGT
rpp30_F_1988_TCTCATGCAA	AATGATACGGCGACCACCGAGATCTACACTCTCATGCAAGAGCGGCTGTCTCCACAAGT
rpp30_F_1989_TCTGTTCGTT	AATGATACGGCGACCACCGAGATCTACACTCTGTTCGTTGAGCGGCTGTCTCCACAAGT
rpp30_F_1990_TCTTCTCCGA	AATGATACGGCGACCACCGAGATCTACACTCTTCTCCGAGAGCGGCTGTCTCCACAAGT
rpp30_F_1991_TGAATGTCCT	AATGATACGGCGACCACCGAGATCTACACTGAATGTCCTGAGCGGCTGTCTCCACAAGT
rpp30_F_1992_TGACAATCCA	AATGATACGGCGACCACCGAGATCTACACTGACAATCCAGAGCGGCTGTCTCCACAAGT
rpp30_F_1993_TGAGAATGAG	AATGATACGGCGACCACCGAGATCTACACTGAGAATGAGGAGCGGCTGTCTCCACAAGT
rpp30_F_1994_TGATACGAGC	AATGATACGGCGACCACCGAGATCTACACTGATACGAGCGAGCGGCTGTCTCCACAAGT
rpp30_F_1995_TGATCCGTCC	AATGATACGGCGACCACCGAGATCTACACTGATCCGTCCGAGCGGCTGTCTCCACAAGT
rpp30_F_1996_TGATGAATCC	AATGATACGGCGACCACCGAGATCTACACTGATGAATCCGAGCGGCTGTCTCCACAAGT
rpp30_F_1997_TGCTACCATT	AATGATACGGCGACCACCGAGATCTACACTGCTACCATTGAGCGGCTGTCTCCACAAGT
rpp30_F_1998_TGCTATACCT	AATGATACGGCGACCACCGAGATCTACACTGCTATACCTGAGCGGCTGTCTCCACAAGT
rpp30_F_1999_TGTCCACGAG	AATGATACGGCGACCACCGAGATCTACACTGTCCACGAGGAGCGGCTGTCTCCACAAGT
rpp30_F_2000_TGTCTCCTCA	AATGATACGGCGACCACCGAGATCTACACTGTCTCCTCAGAGCGGCTGTCTCCACAAGT
rpp30_F_2001_TGTCTTGCTA	AATGATACGGCGACCACCGAGATCTACACTGTCTTGCTAGAGCGGCTGTCTCCACAAGT
rpp30_F_2002_TTAGGTGCCT	AATGATACGGCGACCACCGAGATCTACACTTAGGTGCCTGAGCGGCTGTCTCCACAAGT
rpp30_F_2003_TTCGACAGAT	AATGATACGGCGACCACCGAGATCTACACTTCGACAGATGAGCGGCTGTCTCCACAAGT
rpp30_F_2004_TTCTGATCCT	AATGATACGGCGACCACCGAGATCTACACTTCTGATCCTGAGCGGCTGTCTCCACAAGT
rpp30_F_2005_TTCTTCTAGC	AATGATACGGCGACCACCGAGATCTACACTTCTTCTAGCGAGCGGCTGTCTCCACAAGT
rpp30_F_2006_GTAACGCATC	AATGATACGGCGACCACCGAGATCTACACGTAACGCATCGAGCGGCTGTCTCCACAAGT
rpp30_F_2007_TCACTGACAG	AATGATACGGCGACCACCGAGATCTACACTCACTGACAGGAGCGGCTGTCTCCACAAGT
rpp30_F_2008_GAATCCAGAC	AATGATACGGCGACCACCGAGATCTACACGAATCCAGACGAGCGGCTGTCTCCACAAGT
rpp30_F_2009_GATCGACGAT	AATGATACGGCGACCACCGAGATCTACACGATCGACGATGAGCGGCTGTCTCCACAAGT
rpp30_F_2010_GTAACGCGAA	AATGATACGGCGACCACCGAGATCTACACGTAACGCGAAGAGCGGCTGTCTCCACAAGT
rpp30_F_2011_CAGGCTGGTA	AATGATACGGCGACCACCGAGATCTACACCAGGCTGGTAGAGCGGCTGTCTCCACAAGT
rpp30_F_2012_GAATATCGTG	AATGATACGGCGACCACCGAGATCTACACGAATATCGTGGAGCGGCTGTCTCCACAAGT
rpp30_F_2013_AGAGGAATAC	AATGATACGGCGACCACCGAGATCTACACAGAGGAATACGAGCGGCTGTCTCCACAAGT
rpp30_F_2014_CCAAGCATAT	AATGATACGGCGACCACCGAGATCTACACCCAAGCATATGAGCGGCTGTCTCCACAAGT
rpp30_F_2015_ATTATCTGCC	AATGATACGGCGACCACCGAGATCTACACATTATCTGCCGAGCGGCTGTCTCCACAAGT
rpp30_F_2016_TGGTGGACCT	AATGATACGGCGACCACCGAGATCTACACTGGTGGACCTGAGCGGCTGTCTCCACAAGT
rpp30_F_2017_TGAGGAGTCA	AATGATACGGCGACCACCGAGATCTACACTGAGGAGTCAGAGCGGCTGTCTCCACAAGT
rpp30_F_2018_CTACGCGAAC	AATGATACGGCGACCACCGAGATCTACACCTACGCGAACGAGCGGCTGTCTCCACAAGT
rpp30_F_2019_TGTCGCTTGT	AATGATACGGCGACCACCGAGATCTACACTGTCGCTTGTGAGCGGCTGTCTCCACAAGT
rpp30_F_2020_ATGTTGCCTC	AATGATACGGCGACCACCGAGATCTACACATGTTGCCTCGAGCGGCTGTCTCCACAAGT
rpp30_F_2021_TGCATTGGCC	AATGATACGGCGACCACCGAGATCTACACTGCATTGGCCGAGCGGCTGTCTCCACAAGT
rpp30_F_2022_TGTCTGACTC	AATGATACGGCGACCACCGAGATCTACACTGTCTGACTCGAGCGGCTGTCTCCACAAGT
rpp30_F_2023_GAATCGCACC	AATGATACGGCGACCACCGAGATCTACACGAATCGCACCGAGCGGCTGTCTCCACAAGT
