s2_F_1_ACGTTGAAGA	AATGATACGGCGACCACCGAGATCTACACACGTTGAAGAGCTGGTGCTGCAGCTTATTA
s2_F_2_TGTAATCGAG	AATGATACGGCGACCACCGAGATCTACACTGTAATCGAGGCTGGTGCTGCAGCTTATTA
s2_F_3_GTTGAGATGG	AATGATACGGCGACCACCGAGATCTACACGTTGAGATGGGCTGGTGCTGCAGCTTATTA
s2_F_4_AAGACCAACG	AATGATACGGCGACCACCGAGATCTACACAAGACCAACGGCTGGTGCTGCAGCTTATTA
s2_F_5_CGAACTTGCG	AATGATACGGCGACCACCGAGATCTACACCGAACTTGCGGCTGGTGCTGCAGCTTATTA
s2_F_6_CGATACAACG	AATGATACGGCGACCACCGAGATCTACACCGATACAACGGCTGGTGCTGCAGCTTATTA
s2_F_7_TAAGGTAACG	AATGATACGGCGACCACCGAGATCTACACTAAGGTAACGGCTGGTGCTGCAGCTTATTA
s2_F_8_TACACTCACG	AATGATACGGCGACCACCGAGATCTACACTACACTCACGGCTGGTGCTGCAGCTTATTA
s2_F_9_CTGGTAGTCA	AATGATACGGCGACCACCGAGATCTACACCTGGTAGTCAGCTGGTGCTGCAGCTTATTA
s2_F_10_AATTCCGTCG	AATGATACGGCGACCACCGAGATCTACACAATTCCGTCGGCTGGTGCTGCAGCTTATTA
s2_F_11_AGCGATCTAA	AATGATACGGCGACCACCGAGATCTACACAGCGATCTAAGCTGGTGCTGCAGCTTATTA
s2_F_12_GAGGCTATCT	AATGATACGGCGACCACCGAGATCTACACGAGGCTATCTGCTGGTGCTGCAGCTTATTA
s2_F_13_CCGATCAGTA	AATGATACGGCGACCACCGAGATCTACACCCGATCAGTAGCTGGTGCTGCAGCTTATTA
s2_F_14_CTCAAGTACG	AATGATACGGCGACCACCGAGATCTACACCTCAAGTACGGCTGGTGCTGCAGCTTATTA
s2_F_15_AGCGTTGTTG	AATGATACGGCGACCACCGAGATCTACACAGCGTTGTTGGCTGGTGCTGCAGCTTATTA
s2_F_16_ATTCTGTCCG	AATGATACGGCGACCACCGAGATCTACACATTCTGTCCGGCTGGTGCTGCAGCTTATTA
s2_F_17_TCTGGTCTAA	AATGATACGGCGACCACCGAGATCTACACTCTGGTCTAAGCTGGTGCTGCAGCTTATTA
s2_F_18_AGATTCTCTG	AATGATACGGCGACCACCGAGATCTACACAGATTCTCTGGCTGGTGCTGCAGCTTATTA
s2_F_19_GAATGTTACG	AATGATACGGCGACCACCGAGATCTACACGAATGTTACGGCTGGTGCTGCAGCTTATTA
s2_F_20_TAGTAGTCTG	AATGATACGGCGACCACCGAGATCTACACTAGTAGTCTGGCTGGTGCTGCAGCTTATTA
s2_F_21_ATCTGGAACG	AATGATACGGCGACCACCGAGATCTACACATCTGGAACGGCTGGTGCTGCAGCTTATTA
s2_F_22_ACTCATCTGG	AATGATACGGCGACCACCGAGATCTACACACTCATCTGGGCTGGTGCTGCAGCTTATTA
s2_F_23_TATCTTACGG	AATGATACGGCGACCACCGAGATCTACACTATCTTACGGGCTGGTGCTGCAGCTTATTA
s2_F_24_ATGTTGTTGG	AATGATACGGCGACCACCGAGATCTACACATGTTGTTGGGCTGGTGCTGCAGCTTATTA
s2_F_25_GATTGTCGTA	AATGATACGGCGACCACCGAGATCTACACGATTGTCGTAGCTGGTGCTGCAGCTTATTA
s2_F_26_GAGGTATGGA	AATGATACGGCGACCACCGAGATCTACACGAGGTATGGAGCTGGTGCTGCAGCTTATTA
s2_F_27_GTGGAATAGG	AATGATACGGCGACCACCGAGATCTACACGTGGAATAGGGCTGGTGCTGCAGCTTATTA
s2_F_28_TTCTAAGTCG	AATGATACGGCGACCACCGAGATCTACACTTCTAAGTCGGCTGGTGCTGCAGCTTATTA
s2_F_29_TTATCTTGCG	AATGATACGGCGACCACCGAGATCTACACTTATCTTGCGGCTGGTGCTGCAGCTTATTA
s2_F_30_AGACTGCGTG	AATGATACGGCGACCACCGAGATCTACACAGACTGCGTGGCTGGTGCTGCAGCTTATTA
s2_F_31_GTAGTGTGAA	AATGATACGGCGACCACCGAGATCTACACGTAGTGTGAAGCTGGTGCTGCAGCTTATTA
s2_F_32_TATTGTCACG	AATGATACGGCGACCACCGAGATCTACACTATTGTCACGGCTGGTGCTGCAGCTTATTA
s2_F_33_AATACGAGCG	AATGATACGGCGACCACCGAGATCTACACAATACGAGCGGCTGGTGCTGCAGCTTATTA
s2_F_34_GTCCTTAGCG	AATGATACGGCGACCACCGAGATCTACACGTCCTTAGCGGCTGGTGCTGCAGCTTATTA
s2_F_35_CTAGTATTCG	AATGATACGGCGACCACCGAGATCTACACCTAGTATTCGGCTGGTGCTGCAGCTTATTA
s2_F_36_ATGACAGTCG	AATGATACGGCGACCACCGAGATCTACACATGACAGTCGGCTGGTGCTGCAGCTTATTA
s2_F_37_CCTTGCTTCG	AATGATACGGCGACCACCGAGATCTACACCCTTGCTTCGGCTGGTGCTGCAGCTTATTA
s2_F_38_CAAGTGTCCG	AATGATACGGCGACCACCGAGATCTACACCAAGTGTCCGGCTGGTGCTGCAGCTTATTA
s2_F_39_CTACTTGTCG	AATGATACGGCGACCACCGAGATCTACACCTACTTGTCGGCTGGTGCTGCAGCTTATTA
s2_F_40_TGATAGGTCT	AATGATACGGCGACCACCGAGATCTACACTGATAGGTCTGCTGGTGCTGCAGCTTATTA
s2_F_41_CTGTACACCG	AATGATACGGCGACCACCGAGATCTACACCTGTACACCGGCTGGTGCTGCAGCTTATTA
s2_F_42_AGACACCGGA	AATGATACGGCGACCACCGAGATCTACACAGACACCGGAGCTGGTGCTGCAGCTTATTA
s2_F_43_ACCTTGGACG	AATGATACGGCGACCACCGAGATCTACACACCTTGGACGGCTGGTGCTGCAGCTTATTA
s2_F_44_CGTGTAATTG	AATGATACGGCGACCACCGAGATCTACACCGTGTAATTGGCTGGTGCTGCAGCTTATTA
s2_F_45_TTCATGCGGA	AATGATACGGCGACCACCGAGATCTACACTTCATGCGGAGCTGGTGCTGCAGCTTATTA
s2_F_46_AAGCTATCCG	AATGATACGGCGACCACCGAGATCTACACAAGCTATCCGGCTGGTGCTGCAGCTTATTA
s2_F_47_ACAGGTGTTA	AATGATACGGCGACCACCGAGATCTACACACAGGTGTTAGCTGGTGCTGCAGCTTATTA
s2_F_48_AACGTCAACG	AATGATACGGCGACCACCGAGATCTACACAACGTCAACGGCTGGTGCTGCAGCTTATTA
s2_F_49_AGGTAGGTAA	AATGATACGGCGACCACCGAGATCTACACAGGTAGGTAAGCTGGTGCTGCAGCTTATTA
s2_F_50_GACAACAACG	AATGATACGGCGACCACCGAGATCTACACGACAACAACGGCTGGTGCTGCAGCTTATTA
s2_F_51_GACTGCTTCG	AATGATACGGCGACCACCGAGATCTACACGACTGCTTCGGCTGGTGCTGCAGCTTATTA
s2_F_52_CCGTGGATCA	AATGATACGGCGACCACCGAGATCTACACCCGTGGATCAGCTGGTGCTGCAGCTTATTA
s2_F_53_TGAGTCAACG	AATGATACGGCGACCACCGAGATCTACACTGAGTCAACGGCTGGTGCTGCAGCTTATTA
s2_F_54_TTGGACAACG	AATGATACGGCGACCACCGAGATCTACACTTGGACAACGGCTGGTGCTGCAGCTTATTA
s2_F_55_CTGTGTTCAA	AATGATACGGCGACCACCGAGATCTACACCTGTGTTCAAGCTGGTGCTGCAGCTTATTA
s2_F_56_GTATCCTGTA	AATGATACGGCGACCACCGAGATCTACACGTATCCTGTAGCTGGTGCTGCAGCTTATTA
s2_F_57_CGCAATTGTA	AATGATACGGCGACCACCGAGATCTACACCGCAATTGTAGCTGGTGCTGCAGCTTATTA
s2_F_58_AACAGTGACG	AATGATACGGCGACCACCGAGATCTACACAACAGTGACGGCTGGTGCTGCAGCTTATTA
s2_F_59_GATGTATCCG	AATGATACGGCGACCACCGAGATCTACACGATGTATCCGGCTGGTGCTGCAGCTTATTA
s2_F_60_CATTGGCTTG	AATGATACGGCGACCACCGAGATCTACACCATTGGCTTGGCTGGTGCTGCAGCTTATTA
s2_F_61_GAGTATAGGT	AATGATACGGCGACCACCGAGATCTACACGAGTATAGGTGCTGGTGCTGCAGCTTATTA
s2_F_62_GACATAATCG	AATGATACGGCGACCACCGAGATCTACACGACATAATCGGCTGGTGCTGCAGCTTATTA
s2_F_63_ACTGTTCTTG	AATGATACGGCGACCACCGAGATCTACACACTGTTCTTGGCTGGTGCTGCAGCTTATTA
s2_F_64_CTGACTATCG	AATGATACGGCGACCACCGAGATCTACACCTGACTATCGGCTGGTGCTGCAGCTTATTA
s2_F_65_GCTTGTCATG	AATGATACGGCGACCACCGAGATCTACACGCTTGTCATGGCTGGTGCTGCAGCTTATTA
s2_F_66_AAGTTCTACG	AATGATACGGCGACCACCGAGATCTACACAAGTTCTACGGCTGGTGCTGCAGCTTATTA
s2_F_67_TAGTATACGG	AATGATACGGCGACCACCGAGATCTACACTAGTATACGGGCTGGTGCTGCAGCTTATTA
s2_F_68_TTGTGATCGG	AATGATACGGCGACCACCGAGATCTACACTTGTGATCGGGCTGGTGCTGCAGCTTATTA
s2_F_69_GAGCAATGCG	AATGATACGGCGACCACCGAGATCTACACGAGCAATGCGGCTGGTGCTGCAGCTTATTA
s2_F_70_CGTTCATAGA	AATGATACGGCGACCACCGAGATCTACACCGTTCATAGAGCTGGTGCTGCAGCTTATTA
s2_F_71_ACACAATTCG	AATGATACGGCGACCACCGAGATCTACACACACAATTCGGCTGGTGCTGCAGCTTATTA
s2_F_72_ACATTCACGG	AATGATACGGCGACCACCGAGATCTACACACATTCACGGGCTGGTGCTGCAGCTTATTA
s2_F_73_AGCATGGTAG	AATGATACGGCGACCACCGAGATCTACACAGCATGGTAGGCTGGTGCTGCAGCTTATTA
s2_F_74_CTTGGAGTGA	AATGATACGGCGACCACCGAGATCTACACCTTGGAGTGAGCTGGTGCTGCAGCTTATTA
s2_F_75_TGTTCGGCAA	AATGATACGGCGACCACCGAGATCTACACTGTTCGGCAAGCTGGTGCTGCAGCTTATTA
s2_F_76_GTCAGAATTG	AATGATACGGCGACCACCGAGATCTACACGTCAGAATTGGCTGGTGCTGCAGCTTATTA
s2_F_77_AAGACCTTGG	AATGATACGGCGACCACCGAGATCTACACAAGACCTTGGGCTGGTGCTGCAGCTTATTA
s2_F_78_AACGGATCTA	AATGATACGGCGACCACCGAGATCTACACAACGGATCTAGCTGGTGCTGCAGCTTATTA
s2_F_79_CTAATGAACG	AATGATACGGCGACCACCGAGATCTACACCTAATGAACGGCTGGTGCTGCAGCTTATTA
s2_F_80_CGTAAGCGTA	AATGATACGGCGACCACCGAGATCTACACCGTAAGCGTAGCTGGTGCTGCAGCTTATTA
s2_F_81_ATGCGATTCG	AATGATACGGCGACCACCGAGATCTACACATGCGATTCGGCTGGTGCTGCAGCTTATTA
s2_F_82_TCTTGTTCCG	AATGATACGGCGACCACCGAGATCTACACTCTTGTTCCGGCTGGTGCTGCAGCTTATTA
s2_F_83_ATGTCATACG	AATGATACGGCGACCACCGAGATCTACACATGTCATACGGCTGGTGCTGCAGCTTATTA
s2_F_84_CGTGTGTAAG	AATGATACGGCGACCACCGAGATCTACACCGTGTGTAAGGCTGGTGCTGCAGCTTATTA
s2_F_85_ATAGAAGACG	AATGATACGGCGACCACCGAGATCTACACATAGAAGACGGCTGGTGCTGCAGCTTATTA
s2_F_86_CACAGGATCG	AATGATACGGCGACCACCGAGATCTACACCACAGGATCGGCTGGTGCTGCAGCTTATTA
s2_F_87_TGAATGCGTC	AATGATACGGCGACCACCGAGATCTACACTGAATGCGTCGCTGGTGCTGCAGCTTATTA
s2_F_88_AAGTTGAGCG	AATGATACGGCGACCACCGAGATCTACACAAGTTGAGCGGCTGGTGCTGCAGCTTATTA
s2_F_89_TGCGTTCACG	AATGATACGGCGACCACCGAGATCTACACTGCGTTCACGGCTGGTGCTGCAGCTTATTA
s2_F_90_CTCAATTGGT	AATGATACGGCGACCACCGAGATCTACACCTCAATTGGTGCTGGTGCTGCAGCTTATTA
s2_F_91_CATATGATGG	AATGATACGGCGACCACCGAGATCTACACCATATGATGGGCTGGTGCTGCAGCTTATTA
s2_F_92_ATCGAGAAGA	AATGATACGGCGACCACCGAGATCTACACATCGAGAAGAGCTGGTGCTGCAGCTTATTA
s2_F_93_GATGAACACG	AATGATACGGCGACCACCGAGATCTACACGATGAACACGGCTGGTGCTGCAGCTTATTA
s2_F_94_ACATGTCAGA	AATGATACGGCGACCACCGAGATCTACACACATGTCAGAGCTGGTGCTGCAGCTTATTA
s2_F_95_AATGGTCTGA	AATGATACGGCGACCACCGAGATCTACACAATGGTCTGAGCTGGTGCTGCAGCTTATTA
s2_F_96_AGACTTACGG	AATGATACGGCGACCACCGAGATCTACACAGACTTACGGGCTGGTGCTGCAGCTTATTA
s2_F_97_GTCATGTGCG	AATGATACGGCGACCACCGAGATCTACACGTCATGTGCGGCTGGTGCTGCAGCTTATTA
s2_F_98_TTGTGTGCGT	AATGATACGGCGACCACCGAGATCTACACTTGTGTGCGTGCTGGTGCTGCAGCTTATTA
s2_F_99_GTAGTCTAGT	AATGATACGGCGACCACCGAGATCTACACGTAGTCTAGTGCTGGTGCTGCAGCTTATTA
s2_F_100_TGGTTGAGTA	AATGATACGGCGACCACCGAGATCTACACTGGTTGAGTAGCTGGTGCTGCAGCTTATTA
s2_F_101_AAGCTTAGGA	AATGATACGGCGACCACCGAGATCTACACAAGCTTAGGAGCTGGTGCTGCAGCTTATTA
s2_F_102_CATTAGGTCT	AATGATACGGCGACCACCGAGATCTACACCATTAGGTCTGCTGGTGCTGCAGCTTATTA
s2_F_103_GAAGTGTGTT	AATGATACGGCGACCACCGAGATCTACACGAAGTGTGTTGCTGGTGCTGCAGCTTATTA
s2_F_104_CTGCATTCGG	AATGATACGGCGACCACCGAGATCTACACCTGCATTCGGGCTGGTGCTGCAGCTTATTA
s2_F_105_ACCTGATTCG	AATGATACGGCGACCACCGAGATCTACACACCTGATTCGGCTGGTGCTGCAGCTTATTA
s2_F_106_CCGTGTTGTA	AATGATACGGCGACCACCGAGATCTACACCCGTGTTGTAGCTGGTGCTGCAGCTTATTA
s2_F_107_AACATGCGCG	AATGATACGGCGACCACCGAGATCTACACAACATGCGCGGCTGGTGCTGCAGCTTATTA
s2_F_108_ACTGATAACG	AATGATACGGCGACCACCGAGATCTACACACTGATAACGGCTGGTGCTGCAGCTTATTA
s2_F_109_TACGGATCAG	AATGATACGGCGACCACCGAGATCTACACTACGGATCAGGCTGGTGCTGCAGCTTATTA
s2_F_110_AATCAGAACG	AATGATACGGCGACCACCGAGATCTACACAATCAGAACGGCTGGTGCTGCAGCTTATTA
s2_F_111_GATACTATCG	AATGATACGGCGACCACCGAGATCTACACGATACTATCGGCTGGTGCTGCAGCTTATTA
s2_F_112_ATGAACGGAA	AATGATACGGCGACCACCGAGATCTACACATGAACGGAAGCTGGTGCTGCAGCTTATTA
s2_F_113_ACCGCATAGA	AATGATACGGCGACCACCGAGATCTACACACCGCATAGAGCTGGTGCTGCAGCTTATTA
s2_F_114_GTAAGGAGTA	AATGATACGGCGACCACCGAGATCTACACGTAAGGAGTAGCTGGTGCTGCAGCTTATTA
s2_F_115_CAAGAACTAG	AATGATACGGCGACCACCGAGATCTACACCAAGAACTAGGCTGGTGCTGCAGCTTATTA
s2_F_116_ATATGACGGA	AATGATACGGCGACCACCGAGATCTACACATATGACGGAGCTGGTGCTGCAGCTTATTA
s2_F_117_TGTTAGTACG	AATGATACGGCGACCACCGAGATCTACACTGTTAGTACGGCTGGTGCTGCAGCTTATTA
s2_F_118_GCGCAATTAA	AATGATACGGCGACCACCGAGATCTACACGCGCAATTAAGCTGGTGCTGCAGCTTATTA
s2_F_119_GTCATTCACG	AATGATACGGCGACCACCGAGATCTACACGTCATTCACGGCTGGTGCTGCAGCTTATTA
s2_F_120_GAGCACTCTT	AATGATACGGCGACCACCGAGATCTACACGAGCACTCTTGCTGGTGCTGCAGCTTATTA
s2_F_121_AACATTCGGA	AATGATACGGCGACCACCGAGATCTACACAACATTCGGAGCTGGTGCTGCAGCTTATTA
s2_F_122_GTATAGCTCT	AATGATACGGCGACCACCGAGATCTACACGTATAGCTCTGCTGGTGCTGCAGCTTATTA
s2_F_123_GAACCTGTCG	AATGATACGGCGACCACCGAGATCTACACGAACCTGTCGGCTGGTGCTGCAGCTTATTA
s2_F_124_CAACTGGTAA	AATGATACGGCGACCACCGAGATCTACACCAACTGGTAAGCTGGTGCTGCAGCTTATTA
s2_F_125_GGAATGATCT	AATGATACGGCGACCACCGAGATCTACACGGAATGATCTGCTGGTGCTGCAGCTTATTA
s2_F_126_ACGAGTTGCG	AATGATACGGCGACCACCGAGATCTACACACGAGTTGCGGCTGGTGCTGCAGCTTATTA
s2_F_127_CTGTTAAGCG	AATGATACGGCGACCACCGAGATCTACACCTGTTAAGCGGCTGGTGCTGCAGCTTATTA
s2_F_128_ACATGGTCTT	AATGATACGGCGACCACCGAGATCTACACACATGGTCTTGCTGGTGCTGCAGCTTATTA
s2_F_129_AGTGCCAACG	AATGATACGGCGACCACCGAGATCTACACAGTGCCAACGGCTGGTGCTGCAGCTTATTA
s2_F_130_CCGAGTGCAA	AATGATACGGCGACCACCGAGATCTACACCCGAGTGCAAGCTGGTGCTGCAGCTTATTA
s2_F_131_AATGGAACGG	AATGATACGGCGACCACCGAGATCTACACAATGGAACGGGCTGGTGCTGCAGCTTATTA
s2_F_132_TAGATCGCAA	AATGATACGGCGACCACCGAGATCTACACTAGATCGCAAGCTGGTGCTGCAGCTTATTA
s2_F_133_AACATAACGG	AATGATACGGCGACCACCGAGATCTACACAACATAACGGGCTGGTGCTGCAGCTTATTA
s2_F_134_GCTAATACCG	AATGATACGGCGACCACCGAGATCTACACGCTAATACCGGCTGGTGCTGCAGCTTATTA
s2_F_135_ATGTTCTGAG	AATGATACGGCGACCACCGAGATCTACACATGTTCTGAGGCTGGTGCTGCAGCTTATTA
s2_F_136_ACCATATCGA	AATGATACGGCGACCACCGAGATCTACACACCATATCGAGCTGGTGCTGCAGCTTATTA
s2_F_137_GAACTACACG	AATGATACGGCGACCACCGAGATCTACACGAACTACACGGCTGGTGCTGCAGCTTATTA
s2_F_138_AGTTAGATCG	AATGATACGGCGACCACCGAGATCTACACAGTTAGATCGGCTGGTGCTGCAGCTTATTA
s2_F_139_CCAACTAACG	AATGATACGGCGACCACCGAGATCTACACCCAACTAACGGCTGGTGCTGCAGCTTATTA
s2_F_140_AGTGTTCTCT	AATGATACGGCGACCACCGAGATCTACACAGTGTTCTCTGCTGGTGCTGCAGCTTATTA
s2_F_141_TCTAGTCGGA	AATGATACGGCGACCACCGAGATCTACACTCTAGTCGGAGCTGGTGCTGCAGCTTATTA
s2_F_142_ATCCTGATCT	AATGATACGGCGACCACCGAGATCTACACATCCTGATCTGCTGGTGCTGCAGCTTATTA
s2_F_143_CAGACTGAGA	AATGATACGGCGACCACCGAGATCTACACCAGACTGAGAGCTGGTGCTGCAGCTTATTA
s2_F_144_CCAGGAGTGT	AATGATACGGCGACCACCGAGATCTACACCCAGGAGTGTGCTGGTGCTGCAGCTTATTA
s2_F_145_ACTGGTTGTA	AATGATACGGCGACCACCGAGATCTACACACTGGTTGTAGCTGGTGCTGCAGCTTATTA
s2_F_146_GGATCATTGG	AATGATACGGCGACCACCGAGATCTACACGGATCATTGGGCTGGTGCTGCAGCTTATTA
s2_F_147_ACTGTGGCCT	AATGATACGGCGACCACCGAGATCTACACACTGTGGCCTGCTGGTGCTGCAGCTTATTA
s2_F_148_TTGGATTGGT	AATGATACGGCGACCACCGAGATCTACACTTGGATTGGTGCTGGTGCTGCAGCTTATTA
s2_F_149_GTGATCTGGA	AATGATACGGCGACCACCGAGATCTACACGTGATCTGGAGCTGGTGCTGCAGCTTATTA
s2_F_150_AGGAACATCG	AATGATACGGCGACCACCGAGATCTACACAGGAACATCGGCTGGTGCTGCAGCTTATTA
s2_F_151_GCTTCATGTA	AATGATACGGCGACCACCGAGATCTACACGCTTCATGTAGCTGGTGCTGCAGCTTATTA
s2_F_152_GCATAAGGTT	AATGATACGGCGACCACCGAGATCTACACGCATAAGGTTGCTGGTGCTGCAGCTTATTA
s2_F_153_ATCACTTGCG	AATGATACGGCGACCACCGAGATCTACACATCACTTGCGGCTGGTGCTGCAGCTTATTA
s2_F_154_CTCCTATACG	AATGATACGGCGACCACCGAGATCTACACCTCCTATACGGCTGGTGCTGCAGCTTATTA
s2_F_155_CTGGATCAGA	AATGATACGGCGACCACCGAGATCTACACCTGGATCAGAGCTGGTGCTGCAGCTTATTA
s2_F_156_CGGATCTTGC	AATGATACGGCGACCACCGAGATCTACACCGGATCTTGCGCTGGTGCTGCAGCTTATTA
s2_F_157_AACTGTCCGG	AATGATACGGCGACCACCGAGATCTACACAACTGTCCGGGCTGGTGCTGCAGCTTATTA
s2_F_158_ACTTAAGTCG	AATGATACGGCGACCACCGAGATCTACACACTTAAGTCGGCTGGTGCTGCAGCTTATTA
s2_F_159_ATGTTGCGGA	AATGATACGGCGACCACCGAGATCTACACATGTTGCGGAGCTGGTGCTGCAGCTTATTA
s2_F_160_ATGAGACTTG	AATGATACGGCGACCACCGAGATCTACACATGAGACTTGGCTGGTGCTGCAGCTTATTA
s2_F_161_TACCTGCGTG	AATGATACGGCGACCACCGAGATCTACACTACCTGCGTGGCTGGTGCTGCAGCTTATTA
s2_F_162_GGCTGTCATA	AATGATACGGCGACCACCGAGATCTACACGGCTGTCATAGCTGGTGCTGCAGCTTATTA
s2_F_163_CAGTGTATCT	AATGATACGGCGACCACCGAGATCTACACCAGTGTATCTGCTGGTGCTGCAGCTTATTA
s2_F_164_GTGCTATGTA	AATGATACGGCGACCACCGAGATCTACACGTGCTATGTAGCTGGTGCTGCAGCTTATTA
s2_F_165_GTATAGAGAG	AATGATACGGCGACCACCGAGATCTACACGTATAGAGAGGCTGGTGCTGCAGCTTATTA
s2_F_166_CACGGTATCA	AATGATACGGCGACCACCGAGATCTACACCACGGTATCAGCTGGTGCTGCAGCTTATTA
s2_F_167_CGGATAATGG	AATGATACGGCGACCACCGAGATCTACACCGGATAATGGGCTGGTGCTGCAGCTTATTA
s2_F_168_CAATACGGAA	AATGATACGGCGACCACCGAGATCTACACCAATACGGAAGCTGGTGCTGCAGCTTATTA
s2_F_169_TGCATGTAGG	AATGATACGGCGACCACCGAGATCTACACTGCATGTAGGGCTGGTGCTGCAGCTTATTA
s2_F_170_CGGACTAGAA	AATGATACGGCGACCACCGAGATCTACACCGGACTAGAAGCTGGTGCTGCAGCTTATTA
s2_F_171_AACCTTCACG	AATGATACGGCGACCACCGAGATCTACACAACCTTCACGGCTGGTGCTGCAGCTTATTA
s2_F_172_AGAGCGATCG	AATGATACGGCGACCACCGAGATCTACACAGAGCGATCGGCTGGTGCTGCAGCTTATTA
s2_F_173_GATAAGTGCG	AATGATACGGCGACCACCGAGATCTACACGATAAGTGCGGCTGGTGCTGCAGCTTATTA
s2_F_174_TCAAGCAACG	AATGATACGGCGACCACCGAGATCTACACTCAAGCAACGGCTGGTGCTGCAGCTTATTA
s2_F_175_ACTCTGTTGA	AATGATACGGCGACCACCGAGATCTACACACTCTGTTGAGCTGGTGCTGCAGCTTATTA
s2_F_176_CGGTACCACA	AATGATACGGCGACCACCGAGATCTACACCGGTACCACAGCTGGTGCTGCAGCTTATTA
s2_F_177_TGATGTCTGT	AATGATACGGCGACCACCGAGATCTACACTGATGTCTGTGCTGGTGCTGCAGCTTATTA
s2_F_178_GGATCATGCT	AATGATACGGCGACCACCGAGATCTACACGGATCATGCTGCTGGTGCTGCAGCTTATTA
s2_F_179_GTAGAGTAAG	AATGATACGGCGACCACCGAGATCTACACGTAGAGTAAGGCTGGTGCTGCAGCTTATTA
s2_F_180_AACGGCTTGG	AATGATACGGCGACCACCGAGATCTACACAACGGCTTGGGCTGGTGCTGCAGCTTATTA
s2_F_181_TAACTAGCGG	AATGATACGGCGACCACCGAGATCTACACTAACTAGCGGGCTGGTGCTGCAGCTTATTA
s2_F_182_ACGACACACG	AATGATACGGCGACCACCGAGATCTACACACGACACACGGCTGGTGCTGCAGCTTATTA
s2_F_183_ATATCACCGT	AATGATACGGCGACCACCGAGATCTACACATATCACCGTGCTGGTGCTGCAGCTTATTA
s2_F_184_ACGATCTAGC	AATGATACGGCGACCACCGAGATCTACACACGATCTAGCGCTGGTGCTGCAGCTTATTA
s2_F_185_CTGTGGCGAA	AATGATACGGCGACCACCGAGATCTACACCTGTGGCGAAGCTGGTGCTGCAGCTTATTA
s2_F_186_ATAGCTCTCT	AATGATACGGCGACCACCGAGATCTACACATAGCTCTCTGCTGGTGCTGCAGCTTATTA
s2_F_187_GAGTTGTGCC	AATGATACGGCGACCACCGAGATCTACACGAGTTGTGCCGCTGGTGCTGCAGCTTATTA
s2_F_188_GCGAAGACTT	AATGATACGGCGACCACCGAGATCTACACGCGAAGACTTGCTGGTGCTGCAGCTTATTA
s2_F_189_GAAGATGCGT	AATGATACGGCGACCACCGAGATCTACACGAAGATGCGTGCTGGTGCTGCAGCTTATTA
s2_F_190_CATGTTGTCG	AATGATACGGCGACCACCGAGATCTACACCATGTTGTCGGCTGGTGCTGCAGCTTATTA
s2_F_191_GCTTCGTTGA	AATGATACGGCGACCACCGAGATCTACACGCTTCGTTGAGCTGGTGCTGCAGCTTATTA
s2_F_192_CGAGGAGATT	AATGATACGGCGACCACCGAGATCTACACCGAGGAGATTGCTGGTGCTGCAGCTTATTA
s2_F_193_TGGTCTATCG	AATGATACGGCGACCACCGAGATCTACACTGGTCTATCGGCTGGTGCTGCAGCTTATTA
s2_F_194_TGCTGTCCGA	AATGATACGGCGACCACCGAGATCTACACTGCTGTCCGAGCTGGTGCTGCAGCTTATTA
s2_F_195_CCGTGTTACG	AATGATACGGCGACCACCGAGATCTACACCCGTGTTACGGCTGGTGCTGCAGCTTATTA
s2_F_196_TGCAAGATTG	AATGATACGGCGACCACCGAGATCTACACTGCAAGATTGGCTGGTGCTGCAGCTTATTA
s2_F_197_AGATCGGCCA	AATGATACGGCGACCACCGAGATCTACACAGATCGGCCAGCTGGTGCTGCAGCTTATTA
s2_F_198_GTAATGGCCA	AATGATACGGCGACCACCGAGATCTACACGTAATGGCCAGCTGGTGCTGCAGCTTATTA
s2_F_199_GTGGTTCATT	AATGATACGGCGACCACCGAGATCTACACGTGGTTCATTGCTGGTGCTGCAGCTTATTA
s2_F_200_TCTCATCACG	AATGATACGGCGACCACCGAGATCTACACTCTCATCACGGCTGGTGCTGCAGCTTATTA
s2_F_201_GAGACCTCTG	AATGATACGGCGACCACCGAGATCTACACGAGACCTCTGGCTGGTGCTGCAGCTTATTA
s2_F_202_ACACAGCGTA	AATGATACGGCGACCACCGAGATCTACACACACAGCGTAGCTGGTGCTGCAGCTTATTA
s2_F_203_GTGGCCTTAG	AATGATACGGCGACCACCGAGATCTACACGTGGCCTTAGGCTGGTGCTGCAGCTTATTA
s2_F_204_AGACGGATAG	AATGATACGGCGACCACCGAGATCTACACAGACGGATAGGCTGGTGCTGCAGCTTATTA
s2_F_205_GTGAGATTCA	AATGATACGGCGACCACCGAGATCTACACGTGAGATTCAGCTGGTGCTGCAGCTTATTA
s2_F_206_CTGGAACCAA	AATGATACGGCGACCACCGAGATCTACACCTGGAACCAAGCTGGTGCTGCAGCTTATTA
s2_F_207_AGGTACGTTG	AATGATACGGCGACCACCGAGATCTACACAGGTACGTTGGCTGGTGCTGCAGCTTATTA
s2_F_208_ACCAACGTCG	AATGATACGGCGACCACCGAGATCTACACACCAACGTCGGCTGGTGCTGCAGCTTATTA
s2_F_209_AGGCCACATC	AATGATACGGCGACCACCGAGATCTACACAGGCCACATCGCTGGTGCTGCAGCTTATTA
s2_F_210_ACATCATCCG	AATGATACGGCGACCACCGAGATCTACACACATCATCCGGCTGGTGCTGCAGCTTATTA
s2_F_211_TACCGTAGGA	AATGATACGGCGACCACCGAGATCTACACTACCGTAGGAGCTGGTGCTGCAGCTTATTA
s2_F_212_ACCAGGCTTA	AATGATACGGCGACCACCGAGATCTACACACCAGGCTTAGCTGGTGCTGCAGCTTATTA
s2_F_213_GGCATATAAG	AATGATACGGCGACCACCGAGATCTACACGGCATATAAGGCTGGTGCTGCAGCTTATTA
s2_F_214_GGCTACGAAG	AATGATACGGCGACCACCGAGATCTACACGGCTACGAAGGCTGGTGCTGCAGCTTATTA
s2_F_215_ACATTGTTCG	AATGATACGGCGACCACCGAGATCTACACACATTGTTCGGCTGGTGCTGCAGCTTATTA
s2_F_216_CTACTAACGG	AATGATACGGCGACCACCGAGATCTACACCTACTAACGGGCTGGTGCTGCAGCTTATTA
s2_F_217_TACATGGCGG	AATGATACGGCGACCACCGAGATCTACACTACATGGCGGGCTGGTGCTGCAGCTTATTA
s2_F_218_CAACACTTCG	AATGATACGGCGACCACCGAGATCTACACCAACACTTCGGCTGGTGCTGCAGCTTATTA
s2_F_219_ACTCACTACG	AATGATACGGCGACCACCGAGATCTACACACTCACTACGGCTGGTGCTGCAGCTTATTA
s2_F_220_GTGAGCACTG	AATGATACGGCGACCACCGAGATCTACACGTGAGCACTGGCTGGTGCTGCAGCTTATTA
s2_F_221_CAGATCACAG	AATGATACGGCGACCACCGAGATCTACACCAGATCACAGGCTGGTGCTGCAGCTTATTA
s2_F_222_AGACATTGGT	AATGATACGGCGACCACCGAGATCTACACAGACATTGGTGCTGGTGCTGCAGCTTATTA
s2_F_223_TTCCAGATCG	AATGATACGGCGACCACCGAGATCTACACTTCCAGATCGGCTGGTGCTGCAGCTTATTA
s2_F_224_GCGATCTCCA	AATGATACGGCGACCACCGAGATCTACACGCGATCTCCAGCTGGTGCTGCAGCTTATTA
s2_F_225_GGAACTCTGG	AATGATACGGCGACCACCGAGATCTACACGGAACTCTGGGCTGGTGCTGCAGCTTATTA
s2_F_226_GTACTGCGTA	AATGATACGGCGACCACCGAGATCTACACGTACTGCGTAGCTGGTGCTGCAGCTTATTA
s2_F_227_TCAAGCGGTA	AATGATACGGCGACCACCGAGATCTACACTCAAGCGGTAGCTGGTGCTGCAGCTTATTA
s2_F_228_TCTGATCCGG	AATGATACGGCGACCACCGAGATCTACACTCTGATCCGGGCTGGTGCTGCAGCTTATTA
s2_F_229_CAGTGAACGG	AATGATACGGCGACCACCGAGATCTACACCAGTGAACGGGCTGGTGCTGCAGCTTATTA
s2_F_230_TGCTAAGCGG	AATGATACGGCGACCACCGAGATCTACACTGCTAAGCGGGCTGGTGCTGCAGCTTATTA
s2_F_231_GTGCCTACCT	AATGATACGGCGACCACCGAGATCTACACGTGCCTACCTGCTGGTGCTGCAGCTTATTA
s2_F_232_CATGTCGTGA	AATGATACGGCGACCACCGAGATCTACACCATGTCGTGAGCTGGTGCTGCAGCTTATTA
s2_F_233_GGCACAACTA	AATGATACGGCGACCACCGAGATCTACACGGCACAACTAGCTGGTGCTGCAGCTTATTA
s2_F_234_TGGCCATATA	AATGATACGGCGACCACCGAGATCTACACTGGCCATATAGCTGGTGCTGCAGCTTATTA
s2_F_235_GAAGTGGCCT	AATGATACGGCGACCACCGAGATCTACACGAAGTGGCCTGCTGGTGCTGCAGCTTATTA
s2_F_236_AGCAGTAGAG	AATGATACGGCGACCACCGAGATCTACACAGCAGTAGAGGCTGGTGCTGCAGCTTATTA
s2_F_237_AACGGTCAAT	AATGATACGGCGACCACCGAGATCTACACAACGGTCAATGCTGGTGCTGCAGCTTATTA
s2_F_238_CACGCATACG	AATGATACGGCGACCACCGAGATCTACACCACGCATACGGCTGGTGCTGCAGCTTATTA
s2_F_239_GGCTAATCCT	AATGATACGGCGACCACCGAGATCTACACGGCTAATCCTGCTGGTGCTGCAGCTTATTA
s2_F_240_GACTTCGACG	AATGATACGGCGACCACCGAGATCTACACGACTTCGACGGCTGGTGCTGCAGCTTATTA
s2_F_241_CAGTAGAGTT	AATGATACGGCGACCACCGAGATCTACACCAGTAGAGTTGCTGGTGCTGCAGCTTATTA
s2_F_242_GAGAGTAGAA	AATGATACGGCGACCACCGAGATCTACACGAGAGTAGAAGCTGGTGCTGCAGCTTATTA
s2_F_243_GGACGAATTG	AATGATACGGCGACCACCGAGATCTACACGGACGAATTGGCTGGTGCTGCAGCTTATTA
s2_F_244_GGAGTAACTG	AATGATACGGCGACCACCGAGATCTACACGGAGTAACTGGCTGGTGCTGCAGCTTATTA
s2_F_245_GGATACCTTG	AATGATACGGCGACCACCGAGATCTACACGGATACCTTGGCTGGTGCTGCAGCTTATTA
s2_F_246_GGCTAGACTG	AATGATACGGCGACCACCGAGATCTACACGGCTAGACTGGCTGGTGCTGCAGCTTATTA
s2_F_247_GAGCAATAGA	AATGATACGGCGACCACCGAGATCTACACGAGCAATAGAGCTGGTGCTGCAGCTTATTA
s2_F_248_AGGAATTCGG	AATGATACGGCGACCACCGAGATCTACACAGGAATTCGGGCTGGTGCTGCAGCTTATTA
s2_F_249_AGACCGGAGT	AATGATACGGCGACCACCGAGATCTACACAGACCGGAGTGCTGGTGCTGCAGCTTATTA
s2_F_250_CTTGTCTACG	AATGATACGGCGACCACCGAGATCTACACCTTGTCTACGGCTGGTGCTGCAGCTTATTA
s2_F_251_TGAGCTTCCG	AATGATACGGCGACCACCGAGATCTACACTGAGCTTCCGGCTGGTGCTGCAGCTTATTA
s2_F_252_GGATAGAGCT	AATGATACGGCGACCACCGAGATCTACACGGATAGAGCTGCTGGTGCTGCAGCTTATTA
s2_F_253_TCATCTACCG	AATGATACGGCGACCACCGAGATCTACACTCATCTACCGGCTGGTGCTGCAGCTTATTA
s2_F_254_TGCGAATCGA	AATGATACGGCGACCACCGAGATCTACACTGCGAATCGAGCTGGTGCTGCAGCTTATTA
s2_F_255_GTACAAGGTA	AATGATACGGCGACCACCGAGATCTACACGTACAAGGTAGCTGGTGCTGCAGCTTATTA
s2_F_256_CCAGTATGTA	AATGATACGGCGACCACCGAGATCTACACCCAGTATGTAGCTGGTGCTGCAGCTTATTA
s2_F_257_AGTCGTTACG	AATGATACGGCGACCACCGAGATCTACACAGTCGTTACGGCTGGTGCTGCAGCTTATTA
s2_F_258_AATGCAATCG	AATGATACGGCGACCACCGAGATCTACACAATGCAATCGGCTGGTGCTGCAGCTTATTA
s2_F_259_CTTAAGAGCG	AATGATACGGCGACCACCGAGATCTACACCTTAAGAGCGGCTGGTGCTGCAGCTTATTA
s2_F_260_ACGTTCATCG	AATGATACGGCGACCACCGAGATCTACACACGTTCATCGGCTGGTGCTGCAGCTTATTA
s2_F_261_CCATCGGATT	AATGATACGGCGACCACCGAGATCTACACCCATCGGATTGCTGGTGCTGCAGCTTATTA
s2_F_262_CGATAGATAG	AATGATACGGCGACCACCGAGATCTACACCGATAGATAGGCTGGTGCTGCAGCTTATTA
s2_F_263_ACATACCACG	AATGATACGGCGACCACCGAGATCTACACACATACCACGGCTGGTGCTGCAGCTTATTA
s2_F_264_GGTCTGAGAT	AATGATACGGCGACCACCGAGATCTACACGGTCTGAGATGCTGGTGCTGCAGCTTATTA
s2_F_265_GAACGAGAGA	AATGATACGGCGACCACCGAGATCTACACGAACGAGAGAGCTGGTGCTGCAGCTTATTA
s2_F_266_CATCGATCAA	AATGATACGGCGACCACCGAGATCTACACCATCGATCAAGCTGGTGCTGCAGCTTATTA
s2_F_267_TCATTGAGGA	AATGATACGGCGACCACCGAGATCTACACTCATTGAGGAGCTGGTGCTGCAGCTTATTA
s2_F_268_GCTTCGAGAA	AATGATACGGCGACCACCGAGATCTACACGCTTCGAGAAGCTGGTGCTGCAGCTTATTA
s2_F_269_ATTGAATCGG	AATGATACGGCGACCACCGAGATCTACACATTGAATCGGGCTGGTGCTGCAGCTTATTA
s2_F_270_CAATCATCGG	AATGATACGGCGACCACCGAGATCTACACCAATCATCGGGCTGGTGCTGCAGCTTATTA
s2_F_271_GACCTATCGG	AATGATACGGCGACCACCGAGATCTACACGACCTATCGGGCTGGTGCTGCAGCTTATTA
s2_F_272_GAATCGGCAA	AATGATACGGCGACCACCGAGATCTACACGAATCGGCAAGCTGGTGCTGCAGCTTATTA
s2_F_273_AGGTGAGGAT	AATGATACGGCGACCACCGAGATCTACACAGGTGAGGATGCTGGTGCTGCAGCTTATTA
s2_F_274_CTGGTCTCTA	AATGATACGGCGACCACCGAGATCTACACCTGGTCTCTAGCTGGTGCTGCAGCTTATTA
s2_F_275_CGGAGAAGGT	AATGATACGGCGACCACCGAGATCTACACCGGAGAAGGTGCTGGTGCTGCAGCTTATTA
s2_F_276_AAGGTGACGT	AATGATACGGCGACCACCGAGATCTACACAAGGTGACGTGCTGGTGCTGCAGCTTATTA
s2_F_277_GACGCACAGA	AATGATACGGCGACCACCGAGATCTACACGACGCACAGAGCTGGTGCTGCAGCTTATTA
s2_F_278_AAGGCCTCTA	AATGATACGGCGACCACCGAGATCTACACAAGGCCTCTAGCTGGTGCTGCAGCTTATTA
s2_F_279_TGCCACCGTA	AATGATACGGCGACCACCGAGATCTACACTGCCACCGTAGCTGGTGCTGCAGCTTATTA
s2_F_280_AACGGCAAGA	AATGATACGGCGACCACCGAGATCTACACAACGGCAAGAGCTGGTGCTGCAGCTTATTA
s2_F_281_ATGGACTCCG	AATGATACGGCGACCACCGAGATCTACACATGGACTCCGGCTGGTGCTGCAGCTTATTA
s2_F_282_AAGCTTGCGT	AATGATACGGCGACCACCGAGATCTACACAAGCTTGCGTGCTGGTGCTGCAGCTTATTA
s2_F_283_CACGTATCGT	AATGATACGGCGACCACCGAGATCTACACCACGTATCGTGCTGGTGCTGCAGCTTATTA
s2_F_284_ATCGGACAAG	AATGATACGGCGACCACCGAGATCTACACATCGGACAAGGCTGGTGCTGCAGCTTATTA
s2_F_285_GTGACGTACC	AATGATACGGCGACCACCGAGATCTACACGTGACGTACCGCTGGTGCTGCAGCTTATTA
s2_F_286_ACAGTATCGG	AATGATACGGCGACCACCGAGATCTACACACAGTATCGGGCTGGTGCTGCAGCTTATTA
s2_F_287_CATTGAAGCG	AATGATACGGCGACCACCGAGATCTACACCATTGAAGCGGCTGGTGCTGCAGCTTATTA
s2_F_288_GGCAACCTGT	AATGATACGGCGACCACCGAGATCTACACGGCAACCTGTGCTGGTGCTGCAGCTTATTA
s2_F_289_ACTTCGTGCG	AATGATACGGCGACCACCGAGATCTACACACTTCGTGCGGCTGGTGCTGCAGCTTATTA
s2_F_290_CAAGTCCGTG	AATGATACGGCGACCACCGAGATCTACACCAAGTCCGTGGCTGGTGCTGCAGCTTATTA
s2_F_291_TACGGTTACT	AATGATACGGCGACCACCGAGATCTACACTACGGTTACTGCTGGTGCTGCAGCTTATTA
s2_F_292_AGGAAGCGGA	AATGATACGGCGACCACCGAGATCTACACAGGAAGCGGAGCTGGTGCTGCAGCTTATTA
s2_F_293_TAACCGTTCG	AATGATACGGCGACCACCGAGATCTACACTAACCGTTCGGCTGGTGCTGCAGCTTATTA
s2_F_294_TTCTCTCGTA	AATGATACGGCGACCACCGAGATCTACACTTCTCTCGTAGCTGGTGCTGCAGCTTATTA
s2_F_295_GATGAAGCGG	AATGATACGGCGACCACCGAGATCTACACGATGAAGCGGGCTGGTGCTGCAGCTTATTA
s2_F_296_GTGTTAGAGT	AATGATACGGCGACCACCGAGATCTACACGTGTTAGAGTGCTGGTGCTGCAGCTTATTA
s2_F_297_ATCAAGCGTC	AATGATACGGCGACCACCGAGATCTACACATCAAGCGTCGCTGGTGCTGCAGCTTATTA
s2_F_298_TGTATCGACC	AATGATACGGCGACCACCGAGATCTACACTGTATCGACCGCTGGTGCTGCAGCTTATTA
s2_F_299_ATCACGACCG	AATGATACGGCGACCACCGAGATCTACACATCACGACCGGCTGGTGCTGCAGCTTATTA
s2_F_300_TGGCGTTCGT	AATGATACGGCGACCACCGAGATCTACACTGGCGTTCGTGCTGGTGCTGCAGCTTATTA
s2_F_301_CGTAACGTGG	AATGATACGGCGACCACCGAGATCTACACCGTAACGTGGGCTGGTGCTGCAGCTTATTA
s2_F_302_AATATGGCCA	AATGATACGGCGACCACCGAGATCTACACAATATGGCCAGCTGGTGCTGCAGCTTATTA
s2_F_303_CCTGCTTAAG	AATGATACGGCGACCACCGAGATCTACACCCTGCTTAAGGCTGGTGCTGCAGCTTATTA
s2_F_304_CCTCTGAACG	AATGATACGGCGACCACCGAGATCTACACCCTCTGAACGGCTGGTGCTGCAGCTTATTA
s2_F_305_GCCAGATATG	AATGATACGGCGACCACCGAGATCTACACGCCAGATATGGCTGGTGCTGCAGCTTATTA
s2_F_306_AGTTACCGTA	AATGATACGGCGACCACCGAGATCTACACAGTTACCGTAGCTGGTGCTGCAGCTTATTA
s2_F_307_GCATGAACGT	AATGATACGGCGACCACCGAGATCTACACGCATGAACGTGCTGGTGCTGCAGCTTATTA
s2_F_308_AGTGTCTATG	AATGATACGGCGACCACCGAGATCTACACAGTGTCTATGGCTGGTGCTGCAGCTTATTA
s2_F_309_TTAAGTCACG	AATGATACGGCGACCACCGAGATCTACACTTAAGTCACGGCTGGTGCTGCAGCTTATTA
s2_F_310_TTACCTATCG	AATGATACGGCGACCACCGAGATCTACACTTACCTATCGGCTGGTGCTGCAGCTTATTA
s2_F_311_AACTTAGGCG	AATGATACGGCGACCACCGAGATCTACACAACTTAGGCGGCTGGTGCTGCAGCTTATTA
s2_F_312_CGGTTCAAGG	AATGATACGGCGACCACCGAGATCTACACCGGTTCAAGGGCTGGTGCTGCAGCTTATTA
s2_F_313_CATTGAGTAG	AATGATACGGCGACCACCGAGATCTACACCATTGAGTAGGCTGGTGCTGCAGCTTATTA
s2_F_314_GTAGAGAGGA	AATGATACGGCGACCACCGAGATCTACACGTAGAGAGGAGCTGGTGCTGCAGCTTATTA
s2_F_315_TGGAGGATCG	AATGATACGGCGACCACCGAGATCTACACTGGAGGATCGGCTGGTGCTGCAGCTTATTA
s2_F_316_AACCACGACG	AATGATACGGCGACCACCGAGATCTACACAACCACGACGGCTGGTGCTGCAGCTTATTA
s2_F_317_AAGCGGATTG	AATGATACGGCGACCACCGAGATCTACACAAGCGGATTGGCTGGTGCTGCAGCTTATTA
s2_F_318_CACGGCTATG	AATGATACGGCGACCACCGAGATCTACACCACGGCTATGGCTGGTGCTGCAGCTTATTA
s2_F_319_ATGGCTGTGT	AATGATACGGCGACCACCGAGATCTACACATGGCTGTGTGCTGGTGCTGCAGCTTATTA
s2_F_320_AGGCGGAGAT	AATGATACGGCGACCACCGAGATCTACACAGGCGGAGATGCTGGTGCTGCAGCTTATTA
s2_F_321_ATACGGACAT	AATGATACGGCGACCACCGAGATCTACACATACGGACATGCTGGTGCTGCAGCTTATTA
s2_F_322_CTGCAACAGG	AATGATACGGCGACCACCGAGATCTACACCTGCAACAGGGCTGGTGCTGCAGCTTATTA
s2_F_323_GTACATGACG	AATGATACGGCGACCACCGAGATCTACACGTACATGACGGCTGGTGCTGCAGCTTATTA
s2_F_324_CAACCGGACT	AATGATACGGCGACCACCGAGATCTACACCAACCGGACTGCTGGTGCTGCAGCTTATTA
s2_F_325_GGTAATGATG	AATGATACGGCGACCACCGAGATCTACACGGTAATGATGGCTGGTGCTGCAGCTTATTA
s2_F_326_CTGATGCAAG	AATGATACGGCGACCACCGAGATCTACACCTGATGCAAGGCTGGTGCTGCAGCTTATTA
s2_F_327_CATGTCTCTG	AATGATACGGCGACCACCGAGATCTACACCATGTCTCTGGCTGGTGCTGCAGCTTATTA
s2_F_328_TAGAGAGTAG	AATGATACGGCGACCACCGAGATCTACACTAGAGAGTAGGCTGGTGCTGCAGCTTATTA
s2_F_329_ATCACCGTAA	AATGATACGGCGACCACCGAGATCTACACATCACCGTAAGCTGGTGCTGCAGCTTATTA
s2_F_330_GGTAATGCGT	AATGATACGGCGACCACCGAGATCTACACGGTAATGCGTGCTGGTGCTGCAGCTTATTA
s2_F_331_GGTACATCCA	AATGATACGGCGACCACCGAGATCTACACGGTACATCCAGCTGGTGCTGCAGCTTATTA
s2_F_332_ATGTCGAGAG	AATGATACGGCGACCACCGAGATCTACACATGTCGAGAGGCTGGTGCTGCAGCTTATTA
s2_F_333_TAATCCAACG	AATGATACGGCGACCACCGAGATCTACACTAATCCAACGGCTGGTGCTGCAGCTTATTA
s2_F_334_CTGATCATTG	AATGATACGGCGACCACCGAGATCTACACCTGATCATTGGCTGGTGCTGCAGCTTATTA
s2_F_335_CAAGCTTCCT	AATGATACGGCGACCACCGAGATCTACACCAAGCTTCCTGCTGGTGCTGCAGCTTATTA
s2_F_336_GACTCAACCG	AATGATACGGCGACCACCGAGATCTACACGACTCAACCGGCTGGTGCTGCAGCTTATTA
s2_F_337_TGTGGTTCTG	AATGATACGGCGACCACCGAGATCTACACTGTGGTTCTGGCTGGTGCTGCAGCTTATTA
s2_F_338_ATTACCGTGG	AATGATACGGCGACCACCGAGATCTACACATTACCGTGGGCTGGTGCTGCAGCTTATTA
s2_F_339_GGCAATACGG	AATGATACGGCGACCACCGAGATCTACACGGCAATACGGGCTGGTGCTGCAGCTTATTA
s2_F_340_AATCCGATGG	AATGATACGGCGACCACCGAGATCTACACAATCCGATGGGCTGGTGCTGCAGCTTATTA
s2_F_341_GCCTTCATCA	AATGATACGGCGACCACCGAGATCTACACGCCTTCATCAGCTGGTGCTGCAGCTTATTA
s2_F_342_CCTGCATCGA	AATGATACGGCGACCACCGAGATCTACACCCTGCATCGAGCTGGTGCTGCAGCTTATTA
s2_F_343_AGGTAGGACG	AATGATACGGCGACCACCGAGATCTACACAGGTAGGACGGCTGGTGCTGCAGCTTATTA
s2_F_344_GTGCTACTAT	AATGATACGGCGACCACCGAGATCTACACGTGCTACTATGCTGGTGCTGCAGCTTATTA
s2_F_345_CAGGTGCTCT	AATGATACGGCGACCACCGAGATCTACACCAGGTGCTCTGCTGGTGCTGCAGCTTATTA
s2_F_346_GCGTTGCGAA	AATGATACGGCGACCACCGAGATCTACACGCGTTGCGAAGCTGGTGCTGCAGCTTATTA
s2_F_347_CACTCCGTTG	AATGATACGGCGACCACCGAGATCTACACCACTCCGTTGGCTGGTGCTGCAGCTTATTA
s2_F_348_CTGGAGTATG	AATGATACGGCGACCACCGAGATCTACACCTGGAGTATGGCTGGTGCTGCAGCTTATTA
s2_F_349_AAGCAGTGTT	AATGATACGGCGACCACCGAGATCTACACAAGCAGTGTTGCTGGTGCTGCAGCTTATTA
s2_F_350_ACGGTACATG	AATGATACGGCGACCACCGAGATCTACACACGGTACATGGCTGGTGCTGCAGCTTATTA
s2_F_351_ACGGTCCTAT	AATGATACGGCGACCACCGAGATCTACACACGGTCCTATGCTGGTGCTGCAGCTTATTA
s2_F_352_TCTTCTAGAG	AATGATACGGCGACCACCGAGATCTACACTCTTCTAGAGGCTGGTGCTGCAGCTTATTA
s2_F_353_TAAGAATCGG	AATGATACGGCGACCACCGAGATCTACACTAAGAATCGGGCTGGTGCTGCAGCTTATTA
s2_F_354_CTACGAGGTT	AATGATACGGCGACCACCGAGATCTACACCTACGAGGTTGCTGGTGCTGCAGCTTATTA
s2_F_355_AATCGTGAGA	AATGATACGGCGACCACCGAGATCTACACAATCGTGAGAGCTGGTGCTGCAGCTTATTA
s2_F_356_ATCTATACCG	AATGATACGGCGACCACCGAGATCTACACATCTATACCGGCTGGTGCTGCAGCTTATTA
s2_F_357_ACACGGTTAA	AATGATACGGCGACCACCGAGATCTACACACACGGTTAAGCTGGTGCTGCAGCTTATTA
s2_F_358_AGAGCTCAGA	AATGATACGGCGACCACCGAGATCTACACAGAGCTCAGAGCTGGTGCTGCAGCTTATTA
s2_F_359_TAGAATAGCG	AATGATACGGCGACCACCGAGATCTACACTAGAATAGCGGCTGGTGCTGCAGCTTATTA
s2_F_360_TGGCCTGTTG	AATGATACGGCGACCACCGAGATCTACACTGGCCTGTTGGCTGGTGCTGCAGCTTATTA
s2_F_361_AGGAAGGCCT	AATGATACGGCGACCACCGAGATCTACACAGGAAGGCCTGCTGGTGCTGCAGCTTATTA
s2_F_362_ACACTGTGGT	AATGATACGGCGACCACCGAGATCTACACACACTGTGGTGCTGGTGCTGCAGCTTATTA
s2_F_363_ACAGATTCCG	AATGATACGGCGACCACCGAGATCTACACACAGATTCCGGCTGGTGCTGCAGCTTATTA
s2_F_364_GGCAACAGTA	AATGATACGGCGACCACCGAGATCTACACGGCAACAGTAGCTGGTGCTGCAGCTTATTA
s2_F_365_TTAGCAGTGT	AATGATACGGCGACCACCGAGATCTACACTTAGCAGTGTGCTGGTGCTGCAGCTTATTA
s2_F_366_GGACGTAGGA	AATGATACGGCGACCACCGAGATCTACACGGACGTAGGAGCTGGTGCTGCAGCTTATTA
s2_F_367_CTATGTACCG	AATGATACGGCGACCACCGAGATCTACACCTATGTACCGGCTGGTGCTGCAGCTTATTA
s2_F_368_CAGATCTACC	AATGATACGGCGACCACCGAGATCTACACCAGATCTACCGCTGGTGCTGCAGCTTATTA
s2_F_369_TACGAGGTAA	AATGATACGGCGACCACCGAGATCTACACTACGAGGTAAGCTGGTGCTGCAGCTTATTA
s2_F_370_GAGGTAACGG	AATGATACGGCGACCACCGAGATCTACACGAGGTAACGGGCTGGTGCTGCAGCTTATTA
s2_F_371_GCTTATACGT	AATGATACGGCGACCACCGAGATCTACACGCTTATACGTGCTGGTGCTGCAGCTTATTA
s2_F_372_CACATGGTCA	AATGATACGGCGACCACCGAGATCTACACCACATGGTCAGCTGGTGCTGCAGCTTATTA
s2_F_373_ACAGACATCG	AATGATACGGCGACCACCGAGATCTACACACAGACATCGGCTGGTGCTGCAGCTTATTA
s2_F_374_CGATCTACGG	AATGATACGGCGACCACCGAGATCTACACCGATCTACGGGCTGGTGCTGCAGCTTATTA
s2_F_375_GTATCCGCCA	AATGATACGGCGACCACCGAGATCTACACGTATCCGCCAGCTGGTGCTGCAGCTTATTA
s2_F_376_AGAAGGTCTG	AATGATACGGCGACCACCGAGATCTACACAGAAGGTCTGGCTGGTGCTGCAGCTTATTA
s2_F_377_GTCTTAACGG	AATGATACGGCGACCACCGAGATCTACACGTCTTAACGGGCTGGTGCTGCAGCTTATTA
s2_F_378_CCGGTAGATA	AATGATACGGCGACCACCGAGATCTACACCCGGTAGATAGCTGGTGCTGCAGCTTATTA
s2_F_379_AACTTGCTGG	AATGATACGGCGACCACCGAGATCTACACAACTTGCTGGGCTGGTGCTGCAGCTTATTA
s2_F_380_AAGGTTACCG	AATGATACGGCGACCACCGAGATCTACACAAGGTTACCGGCTGGTGCTGCAGCTTATTA
s2_F_381_CGTGACTATA	AATGATACGGCGACCACCGAGATCTACACCGTGACTATAGCTGGTGCTGCAGCTTATTA
s2_F_382_ATGCTTATCG	AATGATACGGCGACCACCGAGATCTACACATGCTTATCGGCTGGTGCTGCAGCTTATTA
s2_F_383_TAATGATGCG	AATGATACGGCGACCACCGAGATCTACACTAATGATGCGGCTGGTGCTGCAGCTTATTA
s2_F_384_CACTTGTGTT	AATGATACGGCGACCACCGAGATCTACACCACTTGTGTTGCTGGTGCTGCAGCTTATTA
s2_F_385_CTGTAGATGG	AATGATACGGCGACCACCGAGATCTACACCTGTAGATGGGCTGGTGCTGCAGCTTATTA
s2_F_386_GTATCACTGC	AATGATACGGCGACCACCGAGATCTACACGTATCACTGCGCTGGTGCTGCAGCTTATTA
s2_F_387_TTCCTGTAGT	AATGATACGGCGACCACCGAGATCTACACTTCCTGTAGTGCTGGTGCTGCAGCTTATTA
s2_F_388_GGTACACAAG	AATGATACGGCGACCACCGAGATCTACACGGTACACAAGGCTGGTGCTGCAGCTTATTA
s2_F_389_TTCAACCGTG	AATGATACGGCGACCACCGAGATCTACACTTCAACCGTGGCTGGTGCTGCAGCTTATTA
s2_F_390_ACCACTGTGA	AATGATACGGCGACCACCGAGATCTACACACCACTGTGAGCTGGTGCTGCAGCTTATTA
s2_F_391_CTCTGGCATG	AATGATACGGCGACCACCGAGATCTACACCTCTGGCATGGCTGGTGCTGCAGCTTATTA
s2_F_392_GTGATCTTAC	AATGATACGGCGACCACCGAGATCTACACGTGATCTTACGCTGGTGCTGCAGCTTATTA
s2_F_393_AGGATCCGAA	AATGATACGGCGACCACCGAGATCTACACAGGATCCGAAGCTGGTGCTGCAGCTTATTA
s2_F_394_GGCCTACACA	AATGATACGGCGACCACCGAGATCTACACGGCCTACACAGCTGGTGCTGCAGCTTATTA
s2_F_395_TGCGGACATT	AATGATACGGCGACCACCGAGATCTACACTGCGGACATTGCTGGTGCTGCAGCTTATTA
s2_F_396_ACTACTTCCG	AATGATACGGCGACCACCGAGATCTACACACTACTTCCGGCTGGTGCTGCAGCTTATTA
s2_F_397_ACGAAGAACG	AATGATACGGCGACCACCGAGATCTACACACGAAGAACGGCTGGTGCTGCAGCTTATTA
s2_F_398_ATCGACTGTT	AATGATACGGCGACCACCGAGATCTACACATCGACTGTTGCTGGTGCTGCAGCTTATTA
s2_F_399_CCATATATCG	AATGATACGGCGACCACCGAGATCTACACCCATATATCGGCTGGTGCTGCAGCTTATTA
s2_F_400_ACCGGATGAA	AATGATACGGCGACCACCGAGATCTACACACCGGATGAAGCTGGTGCTGCAGCTTATTA
s2_F_401_CGTTGTCGAG	AATGATACGGCGACCACCGAGATCTACACCGTTGTCGAGGCTGGTGCTGCAGCTTATTA
s2_F_402_GCGCCTGTTA	AATGATACGGCGACCACCGAGATCTACACGCGCCTGTTAGCTGGTGCTGCAGCTTATTA
s2_F_403_ACTATTAGCG	AATGATACGGCGACCACCGAGATCTACACACTATTAGCGGCTGGTGCTGCAGCTTATTA
s2_F_404_GACTGTAGCG	AATGATACGGCGACCACCGAGATCTACACGACTGTAGCGGCTGGTGCTGCAGCTTATTA
s2_F_405_GATATGAACG	AATGATACGGCGACCACCGAGATCTACACGATATGAACGGCTGGTGCTGCAGCTTATTA
s2_F_406_GCAATCATAC	AATGATACGGCGACCACCGAGATCTACACGCAATCATACGCTGGTGCTGCAGCTTATTA
s2_F_407_ACTATCTCTG	AATGATACGGCGACCACCGAGATCTACACACTATCTCTGGCTGGTGCTGCAGCTTATTA
s2_F_408_GTTCTGGATG	AATGATACGGCGACCACCGAGATCTACACGTTCTGGATGGCTGGTGCTGCAGCTTATTA
s2_F_409_TCCGGCAATG	AATGATACGGCGACCACCGAGATCTACACTCCGGCAATGGCTGGTGCTGCAGCTTATTA
s2_F_410_TGAGCGTGTT	AATGATACGGCGACCACCGAGATCTACACTGAGCGTGTTGCTGGTGCTGCAGCTTATTA
s2_F_411_GGTAGTATTG	AATGATACGGCGACCACCGAGATCTACACGGTAGTATTGGCTGGTGCTGCAGCTTATTA
s2_F_412_CGAGAACGTG	AATGATACGGCGACCACCGAGATCTACACCGAGAACGTGGCTGGTGCTGCAGCTTATTA
s2_F_413_ATGGTGTCGA	AATGATACGGCGACCACCGAGATCTACACATGGTGTCGAGCTGGTGCTGCAGCTTATTA
s2_F_414_CTGGTCAACT	AATGATACGGCGACCACCGAGATCTACACCTGGTCAACTGCTGGTGCTGCAGCTTATTA
s2_F_415_CAGAACCACG	AATGATACGGCGACCACCGAGATCTACACCAGAACCACGGCTGGTGCTGCAGCTTATTA
s2_F_416_CCATGGTGAA	AATGATACGGCGACCACCGAGATCTACACCCATGGTGAAGCTGGTGCTGCAGCTTATTA
s2_F_417_TGAGGATAGA	AATGATACGGCGACCACCGAGATCTACACTGAGGATAGAGCTGGTGCTGCAGCTTATTA
s2_F_418_GCAGTGATGA	AATGATACGGCGACCACCGAGATCTACACGCAGTGATGAGCTGGTGCTGCAGCTTATTA
s2_F_419_TGTCACTCCG	AATGATACGGCGACCACCGAGATCTACACTGTCACTCCGGCTGGTGCTGCAGCTTATTA
s2_F_420_CGTGAGATAA	AATGATACGGCGACCACCGAGATCTACACCGTGAGATAAGCTGGTGCTGCAGCTTATTA
s2_F_421_AGTGAGAGAG	AATGATACGGCGACCACCGAGATCTACACAGTGAGAGAGGCTGGTGCTGCAGCTTATTA
s2_F_422_AACGGACGGA	AATGATACGGCGACCACCGAGATCTACACAACGGACGGAGCTGGTGCTGCAGCTTATTA
s2_F_423_TCACCGATGG	AATGATACGGCGACCACCGAGATCTACACTCACCGATGGGCTGGTGCTGCAGCTTATTA
s2_F_424_GCATATTCGG	AATGATACGGCGACCACCGAGATCTACACGCATATTCGGGCTGGTGCTGCAGCTTATTA
s2_F_425_TTGGCGTTGG	AATGATACGGCGACCACCGAGATCTACACTTGGCGTTGGGCTGGTGCTGCAGCTTATTA
s2_F_426_ACGGCTATAA	AATGATACGGCGACCACCGAGATCTACACACGGCTATAAGCTGGTGCTGCAGCTTATTA
s2_F_427_GTTGGAGTAG	AATGATACGGCGACCACCGAGATCTACACGTTGGAGTAGGCTGGTGCTGCAGCTTATTA
s2_F_428_GCGGCATGAA	AATGATACGGCGACCACCGAGATCTACACGCGGCATGAAGCTGGTGCTGCAGCTTATTA
s2_F_429_CAATGAGATG	AATGATACGGCGACCACCGAGATCTACACCAATGAGATGGCTGGTGCTGCAGCTTATTA
s2_F_430_AGATCAGAGG	AATGATACGGCGACCACCGAGATCTACACAGATCAGAGGGCTGGTGCTGCAGCTTATTA
s2_F_431_CAACTCGTGC	AATGATACGGCGACCACCGAGATCTACACCAACTCGTGCGCTGGTGCTGCAGCTTATTA
s2_F_432_GTATTCCGGA	AATGATACGGCGACCACCGAGATCTACACGTATTCCGGAGCTGGTGCTGCAGCTTATTA
s2_F_433_TCTCAGCGTG	AATGATACGGCGACCACCGAGATCTACACTCTCAGCGTGGCTGGTGCTGCAGCTTATTA
s2_F_434_CCTAGCGTGA	AATGATACGGCGACCACCGAGATCTACACCCTAGCGTGAGCTGGTGCTGCAGCTTATTA
s2_F_435_GCGCCATCTT	AATGATACGGCGACCACCGAGATCTACACGCGCCATCTTGCTGGTGCTGCAGCTTATTA
s2_F_436_GTTACGATCT	AATGATACGGCGACCACCGAGATCTACACGTTACGATCTGCTGGTGCTGCAGCTTATTA
s2_F_437_ATGGTAGTGG	AATGATACGGCGACCACCGAGATCTACACATGGTAGTGGGCTGGTGCTGCAGCTTATTA
s2_F_438_TTCTCATGGT	AATGATACGGCGACCACCGAGATCTACACTTCTCATGGTGCTGGTGCTGCAGCTTATTA
s2_F_439_GTTCTCATCG	AATGATACGGCGACCACCGAGATCTACACGTTCTCATCGGCTGGTGCTGCAGCTTATTA
s2_F_440_GGATCGAGTA	AATGATACGGCGACCACCGAGATCTACACGGATCGAGTAGCTGGTGCTGCAGCTTATTA
s2_F_441_GCCTAATGCG	AATGATACGGCGACCACCGAGATCTACACGCCTAATGCGGCTGGTGCTGCAGCTTATTA
s2_F_442_GCGTTATCAG	AATGATACGGCGACCACCGAGATCTACACGCGTTATCAGGCTGGTGCTGCAGCTTATTA
s2_F_443_TCGATCCAGT	AATGATACGGCGACCACCGAGATCTACACTCGATCCAGTGCTGGTGCTGCAGCTTATTA
s2_F_444_GTTAGAGGTA	AATGATACGGCGACCACCGAGATCTACACGTTAGAGGTAGCTGGTGCTGCAGCTTATTA
s2_F_445_AAGCGTACGG	AATGATACGGCGACCACCGAGATCTACACAAGCGTACGGGCTGGTGCTGCAGCTTATTA
s2_F_446_GGTTCTGTCA	AATGATACGGCGACCACCGAGATCTACACGGTTCTGTCAGCTGGTGCTGCAGCTTATTA
s2_F_447_TCTATGCGCG	AATGATACGGCGACCACCGAGATCTACACTCTATGCGCGGCTGGTGCTGCAGCTTATTA
s2_F_448_TCTCACGAGT	AATGATACGGCGACCACCGAGATCTACACTCTCACGAGTGCTGGTGCTGCAGCTTATTA
s2_F_449_GAAGATCAGA	AATGATACGGCGACCACCGAGATCTACACGAAGATCAGAGCTGGTGCTGCAGCTTATTA
s2_F_450_GAGGTCAATG	AATGATACGGCGACCACCGAGATCTACACGAGGTCAATGGCTGGTGCTGCAGCTTATTA
s2_F_451_GCGCAACCTA	AATGATACGGCGACCACCGAGATCTACACGCGCAACCTAGCTGGTGCTGCAGCTTATTA
s2_F_452_CTAGGTTCAT	AATGATACGGCGACCACCGAGATCTACACCTAGGTTCATGCTGGTGCTGCAGCTTATTA
s2_F_453_GGTAAGTGAA	AATGATACGGCGACCACCGAGATCTACACGGTAAGTGAAGCTGGTGCTGCAGCTTATTA
s2_F_454_AAGATGTGAG	AATGATACGGCGACCACCGAGATCTACACAAGATGTGAGGCTGGTGCTGCAGCTTATTA
s2_F_455_CCGTGGTAGA	AATGATACGGCGACCACCGAGATCTACACCCGTGGTAGAGCTGGTGCTGCAGCTTATTA
s2_F_456_GGCATAGTTG	AATGATACGGCGACCACCGAGATCTACACGGCATAGTTGGCTGGTGCTGCAGCTTATTA
s2_F_457_ACTAGGTCTA	AATGATACGGCGACCACCGAGATCTACACACTAGGTCTAGCTGGTGCTGCAGCTTATTA
s2_F_458_AGATGATCGG	AATGATACGGCGACCACCGAGATCTACACAGATGATCGGGCTGGTGCTGCAGCTTATTA
s2_F_459_GTACGAGGAC	AATGATACGGCGACCACCGAGATCTACACGTACGAGGACGCTGGTGCTGCAGCTTATTA
s2_F_460_TCGACGGAAG	AATGATACGGCGACCACCGAGATCTACACTCGACGGAAGGCTGGTGCTGCAGCTTATTA
s2_F_461_CAAGTCGAGT	AATGATACGGCGACCACCGAGATCTACACCAAGTCGAGTGCTGGTGCTGCAGCTTATTA
s2_F_462_CACTTAGCGG	AATGATACGGCGACCACCGAGATCTACACCACTTAGCGGGCTGGTGCTGCAGCTTATTA
s2_F_463_TGGCGACACT	AATGATACGGCGACCACCGAGATCTACACTGGCGACACTGCTGGTGCTGCAGCTTATTA
s2_F_464_ACGGATTGGA	AATGATACGGCGACCACCGAGATCTACACACGGATTGGAGCTGGTGCTGCAGCTTATTA
s2_F_465_AATCTCCGAG	AATGATACGGCGACCACCGAGATCTACACAATCTCCGAGGCTGGTGCTGCAGCTTATTA
s2_F_466_CTCATGCTAT	AATGATACGGCGACCACCGAGATCTACACCTCATGCTATGCTGGTGCTGCAGCTTATTA
s2_F_467_ACGGAACTAG	AATGATACGGCGACCACCGAGATCTACACACGGAACTAGGCTGGTGCTGCAGCTTATTA
s2_F_468_ACGGATAGAT	AATGATACGGCGACCACCGAGATCTACACACGGATAGATGCTGGTGCTGCAGCTTATTA
s2_F_469_CCGGAATCAT	AATGATACGGCGACCACCGAGATCTACACCCGGAATCATGCTGGTGCTGCAGCTTATTA
s2_F_470_CCGGACCAAT	AATGATACGGCGACCACCGAGATCTACACCCGGACCAATGCTGGTGCTGCAGCTTATTA
s2_F_471_CCGGATTCTA	AATGATACGGCGACCACCGAGATCTACACCCGGATTCTAGCTGGTGCTGCAGCTTATTA
s2_F_472_GCGGAACAGT	AATGATACGGCGACCACCGAGATCTACACGCGGAACAGTGCTGGTGCTGCAGCTTATTA
s2_F_473_ATGGACCATA	AATGATACGGCGACCACCGAGATCTACACATGGACCATAGCTGGTGCTGCAGCTTATTA
s2_F_474_GACGGAGTGA	AATGATACGGCGACCACCGAGATCTACACGACGGAGTGAGCTGGTGCTGCAGCTTATTA
s2_F_475_GGAACACTCT	AATGATACGGCGACCACCGAGATCTACACGGAACACTCTGCTGGTGCTGCAGCTTATTA
s2_F_476_GGAAGCCTTA	AATGATACGGCGACCACCGAGATCTACACGGAAGCCTTAGCTGGTGCTGCAGCTTATTA
s2_F_477_GGAAGCTACT	AATGATACGGCGACCACCGAGATCTACACGGAAGCTACTGCTGGTGCTGCAGCTTATTA
s2_F_478_GGAATGCAAG	AATGATACGGCGACCACCGAGATCTACACGGAATGCAAGGCTGGTGCTGCAGCTTATTA
s2_F_479_GGACACCATT	AATGATACGGCGACCACCGAGATCTACACGGACACCATTGCTGGTGCTGCAGCTTATTA
s2_F_480_GGACCATACA	AATGATACGGCGACCACCGAGATCTACACGGACCATACAGCTGGTGCTGCAGCTTATTA
s2_F_481_GGACCTTGAA	AATGATACGGCGACCACCGAGATCTACACGGACCTTGAAGCTGGTGCTGCAGCTTATTA
s2_F_482_GGAGAGTTAT	AATGATACGGCGACCACCGAGATCTACACGGAGAGTTATGCTGGTGCTGCAGCTTATTA
s2_F_483_GGAGCTATTA	AATGATACGGCGACCACCGAGATCTACACGGAGCTATTAGCTGGTGCTGCAGCTTATTA
s2_F_484_GGAGTTCTCA	AATGATACGGCGACCACCGAGATCTACACGGAGTTCTCAGCTGGTGCTGCAGCTTATTA
s2_F_485_GGATACCAGA	AATGATACGGCGACCACCGAGATCTACACGGATACCAGAGCTGGTGCTGCAGCTTATTA
s2_F_486_GGATCAGCGA	AATGATACGGCGACCACCGAGATCTACACGGATCAGCGAGCTGGTGCTGCAGCTTATTA
s2_F_487_ATGGATGCCT	AATGATACGGCGACCACCGAGATCTACACATGGATGCCTGCTGGTGCTGCAGCTTATTA
s2_F_488_CGGAACTTAA	AATGATACGGCGACCACCGAGATCTACACCGGAACTTAAGCTGGTGCTGCAGCTTATTA
s2_F_489_CGGAAGTGAG	AATGATACGGCGACCACCGAGATCTACACCGGAAGTGAGGCTGGTGCTGCAGCTTATTA
s2_F_490_CGGATACTCA	AATGATACGGCGACCACCGAGATCTACACCGGATACTCAGCTGGTGCTGCAGCTTATTA
s2_F_491_TTCGGTACAT	AATGATACGGCGACCACCGAGATCTACACTTCGGTACATGCTGGTGCTGCAGCTTATTA
s2_F_492_GGTTGTTACT	AATGATACGGCGACCACCGAGATCTACACGGTTGTTACTGCTGGTGCTGCAGCTTATTA
s2_F_493_CTGCCTATAA	AATGATACGGCGACCACCGAGATCTACACCTGCCTATAAGCTGGTGCTGCAGCTTATTA
s2_F_494_AGGAATGTGA	AATGATACGGCGACCACCGAGATCTACACAGGAATGTGAGCTGGTGCTGCAGCTTATTA
s2_F_495_AGGTGTCCAG	AATGATACGGCGACCACCGAGATCTACACAGGTGTCCAGGCTGGTGCTGCAGCTTATTA
s2_F_496_ACGGAGTATT	AATGATACGGCGACCACCGAGATCTACACACGGAGTATTGCTGGTGCTGCAGCTTATTA
s2_F_497_TTGTGTGTTG	AATGATACGGCGACCACCGAGATCTACACTTGTGTGTTGGCTGGTGCTGCAGCTTATTA
s2_F_498_GCGAGTCACT	AATGATACGGCGACCACCGAGATCTACACGCGAGTCACTGCTGGTGCTGCAGCTTATTA
s2_F_499_ATTAGTACGG	AATGATACGGCGACCACCGAGATCTACACATTAGTACGGGCTGGTGCTGCAGCTTATTA
s2_F_500_CGGTTCCTAA	AATGATACGGCGACCACCGAGATCTACACCGGTTCCTAAGCTGGTGCTGCAGCTTATTA
s2_F_501_CTGTGTCTTC	AATGATACGGCGACCACCGAGATCTACACCTGTGTCTTCGCTGGTGCTGCAGCTTATTA
s2_F_502_AATAGCTACG	AATGATACGGCGACCACCGAGATCTACACAATAGCTACGGCTGGTGCTGCAGCTTATTA
s2_F_503_CGACATACCG	AATGATACGGCGACCACCGAGATCTACACCGACATACCGGCTGGTGCTGCAGCTTATTA
s2_F_504_GGCATGATTA	AATGATACGGCGACCACCGAGATCTACACGGCATGATTAGCTGGTGCTGCAGCTTATTA
s2_F_505_GTGTCATGAG	AATGATACGGCGACCACCGAGATCTACACGTGTCATGAGGCTGGTGCTGCAGCTTATTA
s2_F_506_GGACTGACGT	AATGATACGGCGACCACCGAGATCTACACGGACTGACGTGCTGGTGCTGCAGCTTATTA
s2_F_507_CCATCAGCTG	AATGATACGGCGACCACCGAGATCTACACCCATCAGCTGGCTGGTGCTGCAGCTTATTA
s2_F_508_TATGGCCACA	AATGATACGGCGACCACCGAGATCTACACTATGGCCACAGCTGGTGCTGCAGCTTATTA
s2_F_509_GTATCGCTTG	AATGATACGGCGACCACCGAGATCTACACGTATCGCTTGGCTGGTGCTGCAGCTTATTA
s2_F_510_AATGTTCGTC	AATGATACGGCGACCACCGAGATCTACACAATGTTCGTCGCTGGTGCTGCAGCTTATTA
s2_F_511_CGATTAACGT	AATGATACGGCGACCACCGAGATCTACACCGATTAACGTGCTGGTGCTGCAGCTTATTA
s2_F_512_ACATGGAGTA	AATGATACGGCGACCACCGAGATCTACACACATGGAGTAGCTGGTGCTGCAGCTTATTA
s2_F_513_GGAACAACGG	AATGATACGGCGACCACCGAGATCTACACGGAACAACGGGCTGGTGCTGCAGCTTATTA
s2_F_514_TCTCAGAGAA	AATGATACGGCGACCACCGAGATCTACACTCTCAGAGAAGCTGGTGCTGCAGCTTATTA
s2_F_515_TGAAGAGCTT	AATGATACGGCGACCACCGAGATCTACACTGAAGAGCTTGCTGGTGCTGCAGCTTATTA
s2_F_516_GGCTCCATTA	AATGATACGGCGACCACCGAGATCTACACGGCTCCATTAGCTGGTGCTGCAGCTTATTA
s2_F_517_AGAATTGACG	AATGATACGGCGACCACCGAGATCTACACAGAATTGACGGCTGGTGCTGCAGCTTATTA
s2_F_518_CTACGACTTG	AATGATACGGCGACCACCGAGATCTACACCTACGACTTGGCTGGTGCTGCAGCTTATTA
s2_F_519_GGAACAGATT	AATGATACGGCGACCACCGAGATCTACACGGAACAGATTGCTGGTGCTGCAGCTTATTA
s2_F_520_GGTATTCACT	AATGATACGGCGACCACCGAGATCTACACGGTATTCACTGCTGGTGCTGCAGCTTATTA
s2_F_521_GTCAATGGTT	AATGATACGGCGACCACCGAGATCTACACGTCAATGGTTGCTGGTGCTGCAGCTTATTA
s2_F_522_CGGAGCGATT	AATGATACGGCGACCACCGAGATCTACACCGGAGCGATTGCTGGTGCTGCAGCTTATTA
s2_F_523_GACGCGACAT	AATGATACGGCGACCACCGAGATCTACACGACGCGACATGCTGGTGCTGCAGCTTATTA
s2_F_524_CTATCCTTCG	AATGATACGGCGACCACCGAGATCTACACCTATCCTTCGGCTGGTGCTGCAGCTTATTA
s2_F_525_GTCGTTCTAC	AATGATACGGCGACCACCGAGATCTACACGTCGTTCTACGCTGGTGCTGCAGCTTATTA
s2_F_526_TATGAGATCG	AATGATACGGCGACCACCGAGATCTACACTATGAGATCGGCTGGTGCTGCAGCTTATTA
s2_F_527_GGAGCTCAAG	AATGATACGGCGACCACCGAGATCTACACGGAGCTCAAGGCTGGTGCTGCAGCTTATTA
s2_F_528_GGAGTGCCTA	AATGATACGGCGACCACCGAGATCTACACGGAGTGCCTAGCTGGTGCTGCAGCTTATTA
s2_F_529_CTTGGAACCG	AATGATACGGCGACCACCGAGATCTACACCTTGGAACCGGCTGGTGCTGCAGCTTATTA
s2_F_530_AGTGTCGACT	AATGATACGGCGACCACCGAGATCTACACAGTGTCGACTGCTGGTGCTGCAGCTTATTA
s2_F_531_GAAGTTGATG	AATGATACGGCGACCACCGAGATCTACACGAAGTTGATGGCTGGTGCTGCAGCTTATTA
s2_F_532_TGAACAATCG	AATGATACGGCGACCACCGAGATCTACACTGAACAATCGGCTGGTGCTGCAGCTTATTA
s2_F_533_CGATGAGGTA	AATGATACGGCGACCACCGAGATCTACACCGATGAGGTAGCTGGTGCTGCAGCTTATTA
s2_F_534_AGTGGCGAAG	AATGATACGGCGACCACCGAGATCTACACAGTGGCGAAGGCTGGTGCTGCAGCTTATTA
s2_F_535_GATCAACGTA	AATGATACGGCGACCACCGAGATCTACACGATCAACGTAGCTGGTGCTGCAGCTTATTA
s2_F_536_GGTTAGGAAT	AATGATACGGCGACCACCGAGATCTACACGGTTAGGAATGCTGGTGCTGCAGCTTATTA
s2_F_537_GAAGCTTGTA	AATGATACGGCGACCACCGAGATCTACACGAAGCTTGTAGCTGGTGCTGCAGCTTATTA
s2_F_538_CACGGTCTGT	AATGATACGGCGACCACCGAGATCTACACCACGGTCTGTGCTGGTGCTGCAGCTTATTA
s2_F_539_CGTCAGTGGT	AATGATACGGCGACCACCGAGATCTACACCGTCAGTGGTGCTGGTGCTGCAGCTTATTA
s2_F_540_GATAACCGGA	AATGATACGGCGACCACCGAGATCTACACGATAACCGGAGCTGGTGCTGCAGCTTATTA
s2_F_541_GCGATAACCG	AATGATACGGCGACCACCGAGATCTACACGCGATAACCGGCTGGTGCTGCAGCTTATTA
s2_F_542_AGCGTCCAAG	AATGATACGGCGACCACCGAGATCTACACAGCGTCCAAGGCTGGTGCTGCAGCTTATTA
s2_F_543_GCCATCTACG	AATGATACGGCGACCACCGAGATCTACACGCCATCTACGGCTGGTGCTGCAGCTTATTA
s2_F_544_GTCAGTTGGA	AATGATACGGCGACCACCGAGATCTACACGTCAGTTGGAGCTGGTGCTGCAGCTTATTA
s2_F_545_GTATGATCAG	AATGATACGGCGACCACCGAGATCTACACGTATGATCAGGCTGGTGCTGCAGCTTATTA
s2_F_546_CCAACTGGTT	AATGATACGGCGACCACCGAGATCTACACCCAACTGGTTGCTGGTGCTGCAGCTTATTA
s2_F_547_GTTGTTCAGA	AATGATACGGCGACCACCGAGATCTACACGTTGTTCAGAGCTGGTGCTGCAGCTTATTA
s2_F_548_CCACTATTGG	AATGATACGGCGACCACCGAGATCTACACCCACTATTGGGCTGGTGCTGCAGCTTATTA
s2_F_549_GATTATGTCG	AATGATACGGCGACCACCGAGATCTACACGATTATGTCGGCTGGTGCTGCAGCTTATTA
s2_F_550_CGTAACAGTT	AATGATACGGCGACCACCGAGATCTACACCGTAACAGTTGCTGGTGCTGCAGCTTATTA
s2_F_551_ATCGGCTACT	AATGATACGGCGACCACCGAGATCTACACATCGGCTACTGCTGGTGCTGCAGCTTATTA
s2_F_552_ATCTCTAGGT	AATGATACGGCGACCACCGAGATCTACACATCTCTAGGTGCTGGTGCTGCAGCTTATTA
s2_F_553_ACTCGAGGTA	AATGATACGGCGACCACCGAGATCTACACACTCGAGGTAGCTGGTGCTGCAGCTTATTA
s2_F_554_GGACACTGAT	AATGATACGGCGACCACCGAGATCTACACGGACACTGATGCTGGTGCTGCAGCTTATTA
s2_F_555_CTGGTCCGAA	AATGATACGGCGACCACCGAGATCTACACCTGGTCCGAAGCTGGTGCTGCAGCTTATTA
s2_F_556_CCTGCGCATT	AATGATACGGCGACCACCGAGATCTACACCCTGCGCATTGCTGGTGCTGCAGCTTATTA
s2_F_557_AAGCTGTCTA	AATGATACGGCGACCACCGAGATCTACACAAGCTGTCTAGCTGGTGCTGCAGCTTATTA
s2_F_558_GTCATACGTC	AATGATACGGCGACCACCGAGATCTACACGTCATACGTCGCTGGTGCTGCAGCTTATTA
s2_F_559_CAACCTCAGT	AATGATACGGCGACCACCGAGATCTACACCAACCTCAGTGCTGGTGCTGCAGCTTATTA
s2_F_560_ACGTTCGGAA	AATGATACGGCGACCACCGAGATCTACACACGTTCGGAAGCTGGTGCTGCAGCTTATTA
s2_F_561_GATGTAGCTT	AATGATACGGCGACCACCGAGATCTACACGATGTAGCTTGCTGGTGCTGCAGCTTATTA
s2_F_562_GACCGTTAGG	AATGATACGGCGACCACCGAGATCTACACGACCGTTAGGGCTGGTGCTGCAGCTTATTA
s2_F_563_TACCGGCTAC	AATGATACGGCGACCACCGAGATCTACACTACCGGCTACGCTGGTGCTGCAGCTTATTA
s2_F_564_AGCTAATGGA	AATGATACGGCGACCACCGAGATCTACACAGCTAATGGAGCTGGTGCTGCAGCTTATTA
s2_F_565_GCGGTAATCA	AATGATACGGCGACCACCGAGATCTACACGCGGTAATCAGCTGGTGCTGCAGCTTATTA
s2_F_566_AGGAGAGGTA	AATGATACGGCGACCACCGAGATCTACACAGGAGAGGTAGCTGGTGCTGCAGCTTATTA
s2_F_567_ACCGATACGG	AATGATACGGCGACCACCGAGATCTACACACCGATACGGGCTGGTGCTGCAGCTTATTA
s2_F_568_ACATGGCCAA	AATGATACGGCGACCACCGAGATCTACACACATGGCCAAGCTGGTGCTGCAGCTTATTA
s2_F_569_GGTATTGTGA	AATGATACGGCGACCACCGAGATCTACACGGTATTGTGAGCTGGTGCTGCAGCTTATTA
s2_F_570_GTATGTGTCA	AATGATACGGCGACCACCGAGATCTACACGTATGTGTCAGCTGGTGCTGCAGCTTATTA
s2_F_571_CCGAGTCGAT	AATGATACGGCGACCACCGAGATCTACACCCGAGTCGATGCTGGTGCTGCAGCTTATTA
s2_F_572_GGAAGAATGA	AATGATACGGCGACCACCGAGATCTACACGGAAGAATGAGCTGGTGCTGCAGCTTATTA
s2_F_573_AAGACTTGTC	AATGATACGGCGACCACCGAGATCTACACAAGACTTGTCGCTGGTGCTGCAGCTTATTA
s2_F_574_AACGAAGTCG	AATGATACGGCGACCACCGAGATCTACACAACGAAGTCGGCTGGTGCTGCAGCTTATTA
s2_F_575_TGAACGTTGG	AATGATACGGCGACCACCGAGATCTACACTGAACGTTGGGCTGGTGCTGCAGCTTATTA
s2_F_576_TGGACGATAA	AATGATACGGCGACCACCGAGATCTACACTGGACGATAAGCTGGTGCTGCAGCTTATTA
s2_F_577_GGCTTCCTAT	AATGATACGGCGACCACCGAGATCTACACGGCTTCCTATGCTGGTGCTGCAGCTTATTA
s2_F_578_GACGGAAGAA	AATGATACGGCGACCACCGAGATCTACACGACGGAAGAAGCTGGTGCTGCAGCTTATTA
s2_F_579_TCGAATAGGA	AATGATACGGCGACCACCGAGATCTACACTCGAATAGGAGCTGGTGCTGCAGCTTATTA
s2_F_580_TGACGGTATA	AATGATACGGCGACCACCGAGATCTACACTGACGGTATAGCTGGTGCTGCAGCTTATTA
s2_F_581_GAGGCGGTAA	AATGATACGGCGACCACCGAGATCTACACGAGGCGGTAAGCTGGTGCTGCAGCTTATTA
s2_F_582_CGTGAGAACG	AATGATACGGCGACCACCGAGATCTACACCGTGAGAACGGCTGGTGCTGCAGCTTATTA
s2_F_583_CAATGGAAGC	AATGATACGGCGACCACCGAGATCTACACCAATGGAAGCGCTGGTGCTGCAGCTTATTA
s2_F_584_CGAGGTAGAG	AATGATACGGCGACCACCGAGATCTACACCGAGGTAGAGGCTGGTGCTGCAGCTTATTA
s2_F_585_CGTCGTACAT	AATGATACGGCGACCACCGAGATCTACACCGTCGTACATGCTGGTGCTGCAGCTTATTA
s2_F_586_AGGATCGATG	AATGATACGGCGACCACCGAGATCTACACAGGATCGATGGCTGGTGCTGCAGCTTATTA
s2_F_587_ATGCATCGGA	AATGATACGGCGACCACCGAGATCTACACATGCATCGGAGCTGGTGCTGCAGCTTATTA
s2_F_588_CGTTGGATAT	AATGATACGGCGACCACCGAGATCTACACCGTTGGATATGCTGGTGCTGCAGCTTATTA
s2_F_589_AGTTGTACCG	AATGATACGGCGACCACCGAGATCTACACAGTTGTACCGGCTGGTGCTGCAGCTTATTA
s2_F_590_CTAGGCGAGA	AATGATACGGCGACCACCGAGATCTACACCTAGGCGAGAGCTGGTGCTGCAGCTTATTA
s2_F_591_ACTTCGGCAT	AATGATACGGCGACCACCGAGATCTACACACTTCGGCATGCTGGTGCTGCAGCTTATTA
s2_F_592_GGACACACAA	AATGATACGGCGACCACCGAGATCTACACGGACACACAAGCTGGTGCTGCAGCTTATTA
s2_F_593_TGTGGAATGA	AATGATACGGCGACCACCGAGATCTACACTGTGGAATGAGCTGGTGCTGCAGCTTATTA
s2_F_594_GTACACTGGA	AATGATACGGCGACCACCGAGATCTACACGTACACTGGAGCTGGTGCTGCAGCTTATTA
s2_F_595_CAGACATCCT	AATGATACGGCGACCACCGAGATCTACACCAGACATCCTGCTGGTGCTGCAGCTTATTA
s2_F_596_GGATGTGATT	AATGATACGGCGACCACCGAGATCTACACGGATGTGATTGCTGGTGCTGCAGCTTATTA
s2_F_597_AGACTATGCG	AATGATACGGCGACCACCGAGATCTACACAGACTATGCGGCTGGTGCTGCAGCTTATTA
s2_F_598_ATGGCCTGTC	AATGATACGGCGACCACCGAGATCTACACATGGCCTGTCGCTGGTGCTGCAGCTTATTA
s2_F_599_CACCTTATCG	AATGATACGGCGACCACCGAGATCTACACCACCTTATCGGCTGGTGCTGCAGCTTATTA
s2_F_600_CAGAGTAACG	AATGATACGGCGACCACCGAGATCTACACCAGAGTAACGGCTGGTGCTGCAGCTTATTA
s2_F_601_AGTAGCCTAT	AATGATACGGCGACCACCGAGATCTACACAGTAGCCTATGCTGGTGCTGCAGCTTATTA
s2_F_602_ATGTGCTAGG	AATGATACGGCGACCACCGAGATCTACACATGTGCTAGGGCTGGTGCTGCAGCTTATTA
s2_F_603_AGGATGATCC	AATGATACGGCGACCACCGAGATCTACACAGGATGATCCGCTGGTGCTGCAGCTTATTA
s2_F_604_CCGACTAGGT	AATGATACGGCGACCACCGAGATCTACACCCGACTAGGTGCTGGTGCTGCAGCTTATTA
s2_F_605_GCGTCACGTT	AATGATACGGCGACCACCGAGATCTACACGCGTCACGTTGCTGGTGCTGCAGCTTATTA
s2_F_606_AGCGCTTCTT	AATGATACGGCGACCACCGAGATCTACACAGCGCTTCTTGCTGGTGCTGCAGCTTATTA
s2_F_607_ACAGCGTGAA	AATGATACGGCGACCACCGAGATCTACACACAGCGTGAAGCTGGTGCTGCAGCTTATTA
s2_F_608_GACGTGATCA	AATGATACGGCGACCACCGAGATCTACACGACGTGATCAGCTGGTGCTGCAGCTTATTA
s2_F_609_CACGACTGTA	AATGATACGGCGACCACCGAGATCTACACCACGACTGTAGCTGGTGCTGCAGCTTATTA
s2_F_610_CCGTGATCTT	AATGATACGGCGACCACCGAGATCTACACCCGTGATCTTGCTGGTGCTGCAGCTTATTA
s2_F_611_AGCAACCTTA	AATGATACGGCGACCACCGAGATCTACACAGCAACCTTAGCTGGTGCTGCAGCTTATTA
s2_F_612_CAGTGGTTGT	AATGATACGGCGACCACCGAGATCTACACCAGTGGTTGTGCTGGTGCTGCAGCTTATTA
s2_F_613_GTGCGTATTC	AATGATACGGCGACCACCGAGATCTACACGTGCGTATTCGCTGGTGCTGCAGCTTATTA
s2_F_614_AAGAGAATCG	AATGATACGGCGACCACCGAGATCTACACAAGAGAATCGGCTGGTGCTGCAGCTTATTA
s2_F_615_AATAAGGTGG	AATGATACGGCGACCACCGAGATCTACACAATAAGGTGGGCTGGTGCTGCAGCTTATTA
s2_F_616_GGCAATCTTG	AATGATACGGCGACCACCGAGATCTACACGGCAATCTTGGCTGGTGCTGCAGCTTATTA
s2_F_617_TCCTCAGTCT	AATGATACGGCGACCACCGAGATCTACACTCCTCAGTCTGCTGGTGCTGCAGCTTATTA
s2_F_618_GACGTTGTAA	AATGATACGGCGACCACCGAGATCTACACGACGTTGTAAGCTGGTGCTGCAGCTTATTA
s2_F_619_TCCGCAACCA	AATGATACGGCGACCACCGAGATCTACACTCCGCAACCAGCTGGTGCTGCAGCTTATTA
s2_F_620_GGCAATAACT	AATGATACGGCGACCACCGAGATCTACACGGCAATAACTGCTGGTGCTGCAGCTTATTA
s2_F_621_TCTAAGGACG	AATGATACGGCGACCACCGAGATCTACACTCTAAGGACGGCTGGTGCTGCAGCTTATTA
s2_F_622_TCTCCAGTGT	AATGATACGGCGACCACCGAGATCTACACTCTCCAGTGTGCTGGTGCTGCAGCTTATTA
s2_F_623_TCTTAAGCGT	AATGATACGGCGACCACCGAGATCTACACTCTTAAGCGTGCTGGTGCTGCAGCTTATTA
s2_F_624_TCTGAGGCCA	AATGATACGGCGACCACCGAGATCTACACTCTGAGGCCAGCTGGTGCTGCAGCTTATTA
s2_F_625_GCGAAGAGAG	AATGATACGGCGACCACCGAGATCTACACGCGAAGAGAGGCTGGTGCTGCAGCTTATTA
s2_F_626_GGAATATCCG	AATGATACGGCGACCACCGAGATCTACACGGAATATCCGGCTGGTGCTGCAGCTTATTA
s2_F_627_GGACACTACG	AATGATACGGCGACCACCGAGATCTACACGGACACTACGGCTGGTGCTGCAGCTTATTA
s2_F_628_GCGGACTAAG	AATGATACGGCGACCACCGAGATCTACACGCGGACTAAGGCTGGTGCTGCAGCTTATTA
s2_F_629_ACGGCCACTT	AATGATACGGCGACCACCGAGATCTACACACGGCCACTTGCTGGTGCTGCAGCTTATTA
s2_F_630_GCGGTTAGTA	AATGATACGGCGACCACCGAGATCTACACGCGGTTAGTAGCTGGTGCTGCAGCTTATTA
s2_F_631_TAGAACTCGT	AATGATACGGCGACCACCGAGATCTACACTAGAACTCGTGCTGGTGCTGCAGCTTATTA
s2_F_632_AACATCGGTT	AATGATACGGCGACCACCGAGATCTACACAACATCGGTTGCTGGTGCTGCAGCTTATTA
s2_F_633_AACGGAGAGG	AATGATACGGCGACCACCGAGATCTACACAACGGAGAGGGCTGGTGCTGCAGCTTATTA
s2_F_634_AAGGAGATCA	AATGATACGGCGACCACCGAGATCTACACAAGGAGATCAGCTGGTGCTGCAGCTTATTA
s2_F_635_AATCCTACCG	AATGATACGGCGACCACCGAGATCTACACAATCCTACCGGCTGGTGCTGCAGCTTATTA
s2_F_636_AATCGCGTAA	AATGATACGGCGACCACCGAGATCTACACAATCGCGTAAGCTGGTGCTGCAGCTTATTA
s2_F_637_AATGCGGCTA	AATGATACGGCGACCACCGAGATCTACACAATGCGGCTAGCTGGTGCTGCAGCTTATTA
s2_F_638_AATGTCTGGC	AATGATACGGCGACCACCGAGATCTACACAATGTCTGGCGCTGGTGCTGCAGCTTATTA
s2_F_639_ACAGACCGTG	AATGATACGGCGACCACCGAGATCTACACACAGACCGTGGCTGGTGCTGCAGCTTATTA
s2_F_640_ACATCACGTC	AATGATACGGCGACCACCGAGATCTACACACATCACGTCGCTGGTGCTGCAGCTTATTA
s2_F_641_ACATGAGTGG	AATGATACGGCGACCACCGAGATCTACACACATGAGTGGGCTGGTGCTGCAGCTTATTA
s2_F_642_ACCAAGCTGG	AATGATACGGCGACCACCGAGATCTACACACCAAGCTGGGCTGGTGCTGCAGCTTATTA
s2_F_643_ACCTAACCGG	AATGATACGGCGACCACCGAGATCTACACACCTAACCGGGCTGGTGCTGCAGCTTATTA
s2_F_644_ACGAGGTTGA	AATGATACGGCGACCACCGAGATCTACACACGAGGTTGAGCTGGTGCTGCAGCTTATTA
s2_F_645_ACGATTCGAC	AATGATACGGCGACCACCGAGATCTACACACGATTCGACGCTGGTGCTGCAGCTTATTA
s2_F_646_ACGCGCATCA	AATGATACGGCGACCACCGAGATCTACACACGCGCATCAGCTGGTGCTGCAGCTTATTA
s2_F_647_ACGTCCTAGA	AATGATACGGCGACCACCGAGATCTACACACGTCCTAGAGCTGGTGCTGCAGCTTATTA
s2_F_648_ACTTAGCGTC	AATGATACGGCGACCACCGAGATCTACACACTTAGCGTCGCTGGTGCTGCAGCTTATTA
s2_F_649_AGCTATATCC	AATGATACGGCGACCACCGAGATCTACACAGCTATATCCGCTGGTGCTGCAGCTTATTA
s2_F_650_AGGCCATGAC	AATGATACGGCGACCACCGAGATCTACACAGGCCATGACGCTGGTGCTGCAGCTTATTA
s2_F_651_AGTACTACGA	AATGATACGGCGACCACCGAGATCTACACAGTACTACGAGCTGGTGCTGCAGCTTATTA
s2_F_652_ATAGAGTGGC	AATGATACGGCGACCACCGAGATCTACACATAGAGTGGCGCTGGTGCTGCAGCTTATTA
s2_F_653_ATATAGGCCT	AATGATACGGCGACCACCGAGATCTACACATATAGGCCTGCTGGTGCTGCAGCTTATTA
s2_F_654_ATCCAAGGCG	AATGATACGGCGACCACCGAGATCTACACATCCAAGGCGGCTGGTGCTGCAGCTTATTA
s2_F_655_ATCGCGTACG	AATGATACGGCGACCACCGAGATCTACACATCGCGTACGGCTGGTGCTGCAGCTTATTA
s2_F_656_ATGTATGTCC	AATGATACGGCGACCACCGAGATCTACACATGTATGTCCGCTGGTGCTGCAGCTTATTA
s2_F_657_ATTGGCCATC	AATGATACGGCGACCACCGAGATCTACACATTGGCCATCGCTGGTGCTGCAGCTTATTA
s2_F_658_CACGACATGC	AATGATACGGCGACCACCGAGATCTACACCACGACATGCGCTGGTGCTGCAGCTTATTA
s2_F_659_CACGCGGATT	AATGATACGGCGACCACCGAGATCTACACCACGCGGATTGCTGGTGCTGCAGCTTATTA
s2_F_660_CAGATACTTG	AATGATACGGCGACCACCGAGATCTACACCAGATACTTGGCTGGTGCTGCAGCTTATTA
s2_F_661_CAGTTCAGGT	AATGATACGGCGACCACCGAGATCTACACCAGTTCAGGTGCTGGTGCTGCAGCTTATTA
s2_F_662_CCGGTAACAA	AATGATACGGCGACCACCGAGATCTACACCCGGTAACAAGCTGGTGCTGCAGCTTATTA
s2_F_663_CGACGTCAAT	AATGATACGGCGACCACCGAGATCTACACCGACGTCAATGCTGGTGCTGCAGCTTATTA
s2_F_664_CGATTCCGTA	AATGATACGGCGACCACCGAGATCTACACCGATTCCGTAGCTGGTGCTGCAGCTTATTA
s2_F_665_CGCAGTCAGT	AATGATACGGCGACCACCGAGATCTACACCGCAGTCAGTGCTGGTGCTGCAGCTTATTA
s2_F_666_CGGACCATGT	AATGATACGGCGACCACCGAGATCTACACCGGACCATGTGCTGGTGCTGCAGCTTATTA
s2_F_667_CGGAGTGTGT	AATGATACGGCGACCACCGAGATCTACACCGGAGTGTGTGCTGGTGCTGCAGCTTATTA
s2_F_668_CGGTAGACAT	AATGATACGGCGACCACCGAGATCTACACCGGTAGACATGCTGGTGCTGCAGCTTATTA
s2_F_669_CGTATAGCGG	AATGATACGGCGACCACCGAGATCTACACCGTATAGCGGGCTGGTGCTGCAGCTTATTA
s2_F_670_CGTCAATGCG	AATGATACGGCGACCACCGAGATCTACACCGTCAATGCGGCTGGTGCTGCAGCTTATTA
s2_F_671_CGTGGTAATA	AATGATACGGCGACCACCGAGATCTACACCGTGGTAATAGCTGGTGCTGCAGCTTATTA
s2_F_672_CTGCAGAGAT	AATGATACGGCGACCACCGAGATCTACACCTGCAGAGATGCTGGTGCTGCAGCTTATTA
s2_F_673_CTGGAATGTA	AATGATACGGCGACCACCGAGATCTACACCTGGAATGTAGCTGGTGCTGCAGCTTATTA
s2_F_674_CTTACTGGCG	AATGATACGGCGACCACCGAGATCTACACCTTACTGGCGGCTGGTGCTGCAGCTTATTA
s2_F_675_GAACGTACGT	AATGATACGGCGACCACCGAGATCTACACGAACGTACGTGCTGGTGCTGCAGCTTATTA
s2_F_676_GACATTGTGG	AATGATACGGCGACCACCGAGATCTACACGACATTGTGGGCTGGTGCTGCAGCTTATTA
s2_F_677_GAGACGATCA	AATGATACGGCGACCACCGAGATCTACACGAGACGATCAGCTGGTGCTGCAGCTTATTA
s2_F_678_GCAAGACGGA	AATGATACGGCGACCACCGAGATCTACACGCAAGACGGAGCTGGTGCTGCAGCTTATTA
s2_F_679_GCAGAGTGGT	AATGATACGGCGACCACCGAGATCTACACGCAGAGTGGTGCTGGTGCTGCAGCTTATTA
s2_F_680_GCGGTTAACT	AATGATACGGCGACCACCGAGATCTACACGCGGTTAACTGCTGGTGCTGCAGCTTATTA
s2_F_681_GGAACTTCCT	AATGATACGGCGACCACCGAGATCTACACGGAACTTCCTGCTGGTGCTGCAGCTTATTA
s2_F_682_GGAATCGTAA	AATGATACGGCGACCACCGAGATCTACACGGAATCGTAAGCTGGTGCTGCAGCTTATTA
s2_F_683_GGCACTCCAT	AATGATACGGCGACCACCGAGATCTACACGGCACTCCATGCTGGTGCTGCAGCTTATTA
s2_F_684_GGCCATAGAT	AATGATACGGCGACCACCGAGATCTACACGGCCATAGATGCTGGTGCTGCAGCTTATTA
s2_F_685_GGTACTTCAG	AATGATACGGCGACCACCGAGATCTACACGGTACTTCAGGCTGGTGCTGCAGCTTATTA
s2_F_686_GTACCAAGTC	AATGATACGGCGACCACCGAGATCTACACGTACCAAGTCGCTGGTGCTGCAGCTTATTA
s2_F_687_GTAGGATGGT	AATGATACGGCGACCACCGAGATCTACACGTAGGATGGTGCTGGTGCTGCAGCTTATTA
s2_F_688_GTCACAAGCG	AATGATACGGCGACCACCGAGATCTACACGTCACAAGCGGCTGGTGCTGCAGCTTATTA
s2_F_689_GTCATCTCTT	AATGATACGGCGACCACCGAGATCTACACGTCATCTCTTGCTGGTGCTGCAGCTTATTA
s2_F_690_GTCTGTAGAA	AATGATACGGCGACCACCGAGATCTACACGTCTGTAGAAGCTGGTGCTGCAGCTTATTA
s2_F_691_GTTAGCTTCG	AATGATACGGCGACCACCGAGATCTACACGTTAGCTTCGGCTGGTGCTGCAGCTTATTA
s2_F_692_GTTGATGTTG	AATGATACGGCGACCACCGAGATCTACACGTTGATGTTGGCTGGTGCTGCAGCTTATTA
s2_F_693_TAGAGACACG	AATGATACGGCGACCACCGAGATCTACACTAGAGACACGGCTGGTGCTGCAGCTTATTA
s2_F_694_TAGGATTACG	AATGATACGGCGACCACCGAGATCTACACTAGGATTACGGCTGGTGCTGCAGCTTATTA
s2_F_695_TCCATTAACG	AATGATACGGCGACCACCGAGATCTACACTCCATTAACGGCTGGTGCTGCAGCTTATTA
s2_F_696_TCGCGATCCT	AATGATACGGCGACCACCGAGATCTACACTCGCGATCCTGCTGGTGCTGCAGCTTATTA
s2_F_697_TCTAGTGCAT	AATGATACGGCGACCACCGAGATCTACACTCTAGTGCATGCTGGTGCTGCAGCTTATTA
s2_F_698_TGAGTAGAGG	AATGATACGGCGACCACCGAGATCTACACTGAGTAGAGGGCTGGTGCTGCAGCTTATTA
s2_F_699_TGATTGAGCG	AATGATACGGCGACCACCGAGATCTACACTGATTGAGCGGCTGGTGCTGCAGCTTATTA
s2_F_700_TGCACTCGAA	AATGATACGGCGACCACCGAGATCTACACTGCACTCGAAGCTGGTGCTGCAGCTTATTA
s2_F_701_TGTGAGAGGT	AATGATACGGCGACCACCGAGATCTACACTGTGAGAGGTGCTGGTGCTGCAGCTTATTA
s2_F_702_TTCGGAACTG	AATGATACGGCGACCACCGAGATCTACACTTCGGAACTGGCTGGTGCTGCAGCTTATTA
s2_F_703_TTGAGCTGGT	AATGATACGGCGACCACCGAGATCTACACTTGAGCTGGTGCTGGTGCTGCAGCTTATTA
s2_F_704_GATAGGCCTA	AATGATACGGCGACCACCGAGATCTACACGATAGGCCTAGCTGGTGCTGCAGCTTATTA
s2_F_705_CTCACATAGT	AATGATACGGCGACCACCGAGATCTACACCTCACATAGTGCTGGTGCTGCAGCTTATTA
s2_F_706_AACACTCGAT	AATGATACGGCGACCACCGAGATCTACACAACACTCGATGCTGGTGCTGCAGCTTATTA
s2_F_707_TCTTCGGAGG	AATGATACGGCGACCACCGAGATCTACACTCTTCGGAGGGCTGGTGCTGCAGCTTATTA
s2_F_708_TCACTCCGTC	AATGATACGGCGACCACCGAGATCTACACTCACTCCGTCGCTGGTGCTGCAGCTTATTA
s2_F_709_GTCGATTAGA	AATGATACGGCGACCACCGAGATCTACACGTCGATTAGAGCTGGTGCTGCAGCTTATTA
s2_F_710_CCTTGACAAG	AATGATACGGCGACCACCGAGATCTACACCCTTGACAAGGCTGGTGCTGCAGCTTATTA
s2_F_711_CTTAGGTCAA	AATGATACGGCGACCACCGAGATCTACACCTTAGGTCAAGCTGGTGCTGCAGCTTATTA
s2_F_712_GTACCTTAGA	AATGATACGGCGACCACCGAGATCTACACGTACCTTAGAGCTGGTGCTGCAGCTTATTA
s2_F_713_GGCTCTAAGT	AATGATACGGCGACCACCGAGATCTACACGGCTCTAAGTGCTGGTGCTGCAGCTTATTA
s2_F_714_GAGTGTACTG	AATGATACGGCGACCACCGAGATCTACACGAGTGTACTGGCTGGTGCTGCAGCTTATTA
s2_F_715_ATGCTGACTT	AATGATACGGCGACCACCGAGATCTACACATGCTGACTTGCTGGTGCTGCAGCTTATTA
s2_F_716_GTACAGACTT	AATGATACGGCGACCACCGAGATCTACACGTACAGACTTGCTGGTGCTGCAGCTTATTA
s2_F_717_TCCGAGACTT	AATGATACGGCGACCACCGAGATCTACACTCCGAGACTTGCTGGTGCTGCAGCTTATTA
s2_F_718_CGTAGCATCG	AATGATACGGCGACCACCGAGATCTACACCGTAGCATCGGCTGGTGCTGCAGCTTATTA
s2_F_719_GACGCATCTG	AATGATACGGCGACCACCGAGATCTACACGACGCATCTGGCTGGTGCTGCAGCTTATTA
s2_F_720_ACGCATGGAA	AATGATACGGCGACCACCGAGATCTACACACGCATGGAAGCTGGTGCTGCAGCTTATTA
s2_F_721_AGCGCAGATA	AATGATACGGCGACCACCGAGATCTACACAGCGCAGATAGCTGGTGCTGCAGCTTATTA
s2_F_722_AGCTATGTGG	AATGATACGGCGACCACCGAGATCTACACAGCTATGTGGGCTGGTGCTGCAGCTTATTA
s2_F_723_CGTAGAACTT	AATGATACGGCGACCACCGAGATCTACACCGTAGAACTTGCTGGTGCTGCAGCTTATTA
s2_F_724_CTCTGCGACA	AATGATACGGCGACCACCGAGATCTACACCTCTGCGACAGCTGGTGCTGCAGCTTATTA
s2_F_725_AAGCCTTGAA	AATGATACGGCGACCACCGAGATCTACACAAGCCTTGAAGCTGGTGCTGCAGCTTATTA
s2_F_726_ACGCACTCAT	AATGATACGGCGACCACCGAGATCTACACACGCACTCATGCTGGTGCTGCAGCTTATTA
s2_F_727_GACACGGTAT	AATGATACGGCGACCACCGAGATCTACACGACACGGTATGCTGGTGCTGCAGCTTATTA
s2_F_728_GTAGCACACG	AATGATACGGCGACCACCGAGATCTACACGTAGCACACGGCTGGTGCTGCAGCTTATTA
s2_F_729_ACTGATCTCC	AATGATACGGCGACCACCGAGATCTACACACTGATCTCCGCTGGTGCTGCAGCTTATTA
s2_F_730_TTAGGATCCA	AATGATACGGCGACCACCGAGATCTACACTTAGGATCCAGCTGGTGCTGCAGCTTATTA
s2_F_731_ATTAGCGGTT	AATGATACGGCGACCACCGAGATCTACACATTAGCGGTTGCTGGTGCTGCAGCTTATTA
s2_F_732_ACAATCGGAG	AATGATACGGCGACCACCGAGATCTACACACAATCGGAGGCTGGTGCTGCAGCTTATTA
s2_F_733_GAGCTCCTCA	AATGATACGGCGACCACCGAGATCTACACGAGCTCCTCAGCTGGTGCTGCAGCTTATTA
s2_F_734_TCTAACCGTC	AATGATACGGCGACCACCGAGATCTACACTCTAACCGTCGCTGGTGCTGCAGCTTATTA
s2_F_735_GCAAGCTGTT	AATGATACGGCGACCACCGAGATCTACACGCAAGCTGTTGCTGGTGCTGCAGCTTATTA
s2_F_736_GGCCTGCATT	AATGATACGGCGACCACCGAGATCTACACGGCCTGCATTGCTGGTGCTGCAGCTTATTA
s2_F_737_GGAATTGTCC	AATGATACGGCGACCACCGAGATCTACACGGAATTGTCCGCTGGTGCTGCAGCTTATTA
s2_F_738_CAACTTGGAC	AATGATACGGCGACCACCGAGATCTACACCAACTTGGACGCTGGTGCTGCAGCTTATTA
s2_F_739_TCCAGGAGTA	AATGATACGGCGACCACCGAGATCTACACTCCAGGAGTAGCTGGTGCTGCAGCTTATTA
s2_F_740_GTAGACCATG	AATGATACGGCGACCACCGAGATCTACACGTAGACCATGGCTGGTGCTGCAGCTTATTA
s2_F_741_CGTTATGGTT	AATGATACGGCGACCACCGAGATCTACACCGTTATGGTTGCTGGTGCTGCAGCTTATTA
s2_F_742_AGCGAACGTA	AATGATACGGCGACCACCGAGATCTACACAGCGAACGTAGCTGGTGCTGCAGCTTATTA
s2_F_743_CGGAATCCGT	AATGATACGGCGACCACCGAGATCTACACCGGAATCCGTGCTGGTGCTGCAGCTTATTA
s2_F_744_ACCTAGATCA	AATGATACGGCGACCACCGAGATCTACACACCTAGATCAGCTGGTGCTGCAGCTTATTA
s2_F_745_TATACAACCG	AATGATACGGCGACCACCGAGATCTACACTATACAACCGGCTGGTGCTGCAGCTTATTA
s2_F_746_GTAGGTTCGG	AATGATACGGCGACCACCGAGATCTACACGTAGGTTCGGGCTGGTGCTGCAGCTTATTA
s2_F_747_TTAATGGAGG	AATGATACGGCGACCACCGAGATCTACACTTAATGGAGGGCTGGTGCTGCAGCTTATTA
s2_F_748_TCGCATTCGA	AATGATACGGCGACCACCGAGATCTACACTCGCATTCGAGCTGGTGCTGCAGCTTATTA
s2_F_749_CCAGCTGTAT	AATGATACGGCGACCACCGAGATCTACACCCAGCTGTATGCTGGTGCTGCAGCTTATTA
s2_F_750_GAACCTTGGC	AATGATACGGCGACCACCGAGATCTACACGAACCTTGGCGCTGGTGCTGCAGCTTATTA
s2_F_751_TTGATCAGCG	AATGATACGGCGACCACCGAGATCTACACTTGATCAGCGGCTGGTGCTGCAGCTTATTA
s2_F_752_CTGTCAAGGT	AATGATACGGCGACCACCGAGATCTACACCTGTCAAGGTGCTGGTGCTGCAGCTTATTA
s2_F_753_CTAGCTACTT	AATGATACGGCGACCACCGAGATCTACACCTAGCTACTTGCTGGTGCTGCAGCTTATTA
s2_F_754_GTGTTGTGTT	AATGATACGGCGACCACCGAGATCTACACGTGTTGTGTTGCTGGTGCTGCAGCTTATTA
s2_F_755_GGCAATTCCA	AATGATACGGCGACCACCGAGATCTACACGGCAATTCCAGCTGGTGCTGCAGCTTATTA
s2_F_756_CGCATTACCT	AATGATACGGCGACCACCGAGATCTACACCGCATTACCTGCTGGTGCTGCAGCTTATTA
s2_F_757_AAGTAGTTCG	AATGATACGGCGACCACCGAGATCTACACAAGTAGTTCGGCTGGTGCTGCAGCTTATTA
s2_F_758_CTTATGCATC	AATGATACGGCGACCACCGAGATCTACACCTTATGCATCGCTGGTGCTGCAGCTTATTA
s2_F_759_CGTTGGTAGG	AATGATACGGCGACCACCGAGATCTACACCGTTGGTAGGGCTGGTGCTGCAGCTTATTA
s2_F_760_GTCGACTCAA	AATGATACGGCGACCACCGAGATCTACACGTCGACTCAAGCTGGTGCTGCAGCTTATTA
s2_F_761_ACAGTCGAGG	AATGATACGGCGACCACCGAGATCTACACACAGTCGAGGGCTGGTGCTGCAGCTTATTA
s2_F_762_CGCAACTACT	AATGATACGGCGACCACCGAGATCTACACCGCAACTACTGCTGGTGCTGCAGCTTATTA
s2_F_763_GGTCATGGAA	AATGATACGGCGACCACCGAGATCTACACGGTCATGGAAGCTGGTGCTGCAGCTTATTA
s2_F_764_GTTGGTAACG	AATGATACGGCGACCACCGAGATCTACACGTTGGTAACGGCTGGTGCTGCAGCTTATTA
s2_F_765_ATCATGACGT	AATGATACGGCGACCACCGAGATCTACACATCATGACGTGCTGGTGCTGCAGCTTATTA
s2_F_766_GACGATGGAT	AATGATACGGCGACCACCGAGATCTACACGACGATGGATGCTGGTGCTGCAGCTTATTA
s2_F_767_GATGGTGCTA	AATGATACGGCGACCACCGAGATCTACACGATGGTGCTAGCTGGTGCTGCAGCTTATTA
s2_F_768_ACAGGAAGCG	AATGATACGGCGACCACCGAGATCTACACACAGGAAGCGGCTGGTGCTGCAGCTTATTA
s2_F_769_GTGGTAAGAA	AATGATACGGCGACCACCGAGATCTACACGTGGTAAGAAGCTGGTGCTGCAGCTTATTA
s2_F_770_TAGACGTGGT	AATGATACGGCGACCACCGAGATCTACACTAGACGTGGTGCTGGTGCTGCAGCTTATTA
s2_F_771_CGACTCCAGA	AATGATACGGCGACCACCGAGATCTACACCGACTCCAGAGCTGGTGCTGCAGCTTATTA
s2_F_772_GCATGGTTAT	AATGATACGGCGACCACCGAGATCTACACGCATGGTTATGCTGGTGCTGCAGCTTATTA
s2_F_773_TCGAGTTAAC	AATGATACGGCGACCACCGAGATCTACACTCGAGTTAACGCTGGTGCTGCAGCTTATTA
s2_F_774_GTCAATTGCC	AATGATACGGCGACCACCGAGATCTACACGTCAATTGCCGCTGGTGCTGCAGCTTATTA
s2_F_775_AAGCGCTAAT	AATGATACGGCGACCACCGAGATCTACACAAGCGCTAATGCTGGTGCTGCAGCTTATTA
s2_F_776_AAGCTACAGT	AATGATACGGCGACCACCGAGATCTACACAAGCTACAGTGCTGGTGCTGCAGCTTATTA
s2_F_777_CGTGAGGTTC	AATGATACGGCGACCACCGAGATCTACACCGTGAGGTTCGCTGGTGCTGCAGCTTATTA
s2_F_778_AGACAGAACT	AATGATACGGCGACCACCGAGATCTACACAGACAGAACTGCTGGTGCTGCAGCTTATTA
s2_F_779_AAGTGAGTGA	AATGATACGGCGACCACCGAGATCTACACAAGTGAGTGAGCTGGTGCTGCAGCTTATTA
s2_F_780_GGTCAACATG	AATGATACGGCGACCACCGAGATCTACACGGTCAACATGGCTGGTGCTGCAGCTTATTA
s2_F_781_GCTGCTGGAT	AATGATACGGCGACCACCGAGATCTACACGCTGCTGGATGCTGGTGCTGCAGCTTATTA
s2_F_782_GAACCACGCT	AATGATACGGCGACCACCGAGATCTACACGAACCACGCTGCTGGTGCTGCAGCTTATTA
s2_F_783_GGAGAGCGTT	AATGATACGGCGACCACCGAGATCTACACGGAGAGCGTTGCTGGTGCTGCAGCTTATTA
s2_F_784_ACCGCGAAGT	AATGATACGGCGACCACCGAGATCTACACACCGCGAAGTGCTGGTGCTGCAGCTTATTA
s2_F_785_GGCTTCTTGG	AATGATACGGCGACCACCGAGATCTACACGGCTTCTTGGGCTGGTGCTGCAGCTTATTA
s2_F_786_TGGAACGGAG	AATGATACGGCGACCACCGAGATCTACACTGGAACGGAGGCTGGTGCTGCAGCTTATTA
s2_F_787_CGTACGCAGA	AATGATACGGCGACCACCGAGATCTACACCGTACGCAGAGCTGGTGCTGCAGCTTATTA
s2_F_788_CCGAGAGTAC	AATGATACGGCGACCACCGAGATCTACACCCGAGAGTACGCTGGTGCTGCAGCTTATTA
s2_F_789_TAGTAAGCCA	AATGATACGGCGACCACCGAGATCTACACTAGTAAGCCAGCTGGTGCTGCAGCTTATTA
s2_F_790_TACGCTGCCT	AATGATACGGCGACCACCGAGATCTACACTACGCTGCCTGCTGGTGCTGCAGCTTATTA
s2_F_791_TGCCTTGCAT	AATGATACGGCGACCACCGAGATCTACACTGCCTTGCATGCTGGTGCTGCAGCTTATTA
s2_F_792_CGCATCGTCT	AATGATACGGCGACCACCGAGATCTACACCGCATCGTCTGCTGGTGCTGCAGCTTATTA
s2_F_793_TTGCAACTGT	AATGATACGGCGACCACCGAGATCTACACTTGCAACTGTGCTGGTGCTGCAGCTTATTA
s2_F_794_CTACCGGATG	AATGATACGGCGACCACCGAGATCTACACCTACCGGATGGCTGGTGCTGCAGCTTATTA
s2_F_795_CTAACATACG	AATGATACGGCGACCACCGAGATCTACACCTAACATACGGCTGGTGCTGCAGCTTATTA
s2_F_796_CTTACGCACG	AATGATACGGCGACCACCGAGATCTACACCTTACGCACGGCTGGTGCTGCAGCTTATTA
s2_F_797_TCCTTCCACG	AATGATACGGCGACCACCGAGATCTACACTCCTTCCACGGCTGGTGCTGCAGCTTATTA
s2_F_798_AAGCCTACTT	AATGATACGGCGACCACCGAGATCTACACAAGCCTACTTGCTGGTGCTGCAGCTTATTA
s2_F_799_ACCGGTTCAT	AATGATACGGCGACCACCGAGATCTACACACCGGTTCATGCTGGTGCTGCAGCTTATTA
s2_F_800_GAGCTCACAA	AATGATACGGCGACCACCGAGATCTACACGAGCTCACAAGCTGGTGCTGCAGCTTATTA
s2_F_801_CACTAGGATA	AATGATACGGCGACCACCGAGATCTACACCACTAGGATAGCTGGTGCTGCAGCTTATTA
s2_F_802_CGGTATGGAG	AATGATACGGCGACCACCGAGATCTACACCGGTATGGAGGCTGGTGCTGCAGCTTATTA
s2_F_803_GAAGACGTCT	AATGATACGGCGACCACCGAGATCTACACGAAGACGTCTGCTGGTGCTGCAGCTTATTA
s2_F_804_GACTACCGTC	AATGATACGGCGACCACCGAGATCTACACGACTACCGTCGCTGGTGCTGCAGCTTATTA
s2_F_805_GGTTGACTAA	AATGATACGGCGACCACCGAGATCTACACGGTTGACTAAGCTGGTGCTGCAGCTTATTA
s2_F_806_GAGTCTGAGC	AATGATACGGCGACCACCGAGATCTACACGAGTCTGAGCGCTGGTGCTGCAGCTTATTA
s2_F_807_TTCACCAACG	AATGATACGGCGACCACCGAGATCTACACTTCACCAACGGCTGGTGCTGCAGCTTATTA
s2_F_808_TTGACTTACG	AATGATACGGCGACCACCGAGATCTACACTTGACTTACGGCTGGTGCTGCAGCTTATTA
s2_F_809_TGGAGTACGG	AATGATACGGCGACCACCGAGATCTACACTGGAGTACGGGCTGGTGCTGCAGCTTATTA
s2_F_810_CATGGTCTAG	AATGATACGGCGACCACCGAGATCTACACCATGGTCTAGGCTGGTGCTGCAGCTTATTA
s2_F_811_CACCTACGTC	AATGATACGGCGACCACCGAGATCTACACCACCTACGTCGCTGGTGCTGCAGCTTATTA
s2_F_812_CAAGCGCGAT	AATGATACGGCGACCACCGAGATCTACACCAAGCGCGATGCTGGTGCTGCAGCTTATTA
s2_F_813_TGCGTACGTG	AATGATACGGCGACCACCGAGATCTACACTGCGTACGTGGCTGGTGCTGCAGCTTATTA
s2_F_814_ATCGTGATTC	AATGATACGGCGACCACCGAGATCTACACATCGTGATTCGCTGGTGCTGCAGCTTATTA
s2_F_815_GAGAATGGCT	AATGATACGGCGACCACCGAGATCTACACGAGAATGGCTGCTGGTGCTGCAGCTTATTA
s2_F_816_GGCCACACTT	AATGATACGGCGACCACCGAGATCTACACGGCCACACTTGCTGGTGCTGCAGCTTATTA
s2_F_817_GCGTCCATTG	AATGATACGGCGACCACCGAGATCTACACGCGTCCATTGGCTGGTGCTGCAGCTTATTA
s2_F_818_GTGAACATTC	AATGATACGGCGACCACCGAGATCTACACGTGAACATTCGCTGGTGCTGCAGCTTATTA
s2_F_819_ACCGAGCTTC	AATGATACGGCGACCACCGAGATCTACACACCGAGCTTCGCTGGTGCTGCAGCTTATTA
s2_F_820_ATGATTCGCG	AATGATACGGCGACCACCGAGATCTACACATGATTCGCGGCTGGTGCTGCAGCTTATTA
s2_F_821_AGCAGATCTT	AATGATACGGCGACCACCGAGATCTACACAGCAGATCTTGCTGGTGCTGCAGCTTATTA
s2_F_822_GAAGATATCC	AATGATACGGCGACCACCGAGATCTACACGAAGATATCCGCTGGTGCTGCAGCTTATTA
s2_F_823_GCCTAGTGTC	AATGATACGGCGACCACCGAGATCTACACGCCTAGTGTCGCTGGTGCTGCAGCTTATTA
s2_F_824_TCTTCCGGAC	AATGATACGGCGACCACCGAGATCTACACTCTTCCGGACGCTGGTGCTGCAGCTTATTA
s2_F_825_GAACAAGTGG	AATGATACGGCGACCACCGAGATCTACACGAACAAGTGGGCTGGTGCTGCAGCTTATTA
s2_F_826_GCTAGATCGA	AATGATACGGCGACCACCGAGATCTACACGCTAGATCGAGCTGGTGCTGCAGCTTATTA
s2_F_827_CGCATGATGT	AATGATACGGCGACCACCGAGATCTACACCGCATGATGTGCTGGTGCTGCAGCTTATTA
s2_F_828_GTTGCCAAGC	AATGATACGGCGACCACCGAGATCTACACGTTGCCAAGCGCTGGTGCTGCAGCTTATTA
s2_F_829_TCAGACGGAT	AATGATACGGCGACCACCGAGATCTACACTCAGACGGATGCTGGTGCTGCAGCTTATTA
s2_F_830_GTTGGCATTC	AATGATACGGCGACCACCGAGATCTACACGTTGGCATTCGCTGGTGCTGCAGCTTATTA
s2_F_831_ACCAACGCAT	AATGATACGGCGACCACCGAGATCTACACACCAACGCATGCTGGTGCTGCAGCTTATTA
s2_F_832_ATAGTGCGTC	AATGATACGGCGACCACCGAGATCTACACATAGTGCGTCGCTGGTGCTGCAGCTTATTA
s2_F_833_GCGATTGCTG	AATGATACGGCGACCACCGAGATCTACACGCGATTGCTGGCTGGTGCTGCAGCTTATTA
s2_F_834_TCGAGCCTGA	AATGATACGGCGACCACCGAGATCTACACTCGAGCCTGAGCTGGTGCTGCAGCTTATTA
s2_F_835_CGTATACTGT	AATGATACGGCGACCACCGAGATCTACACCGTATACTGTGCTGGTGCTGCAGCTTATTA
s2_F_836_TAGGCGTACA	AATGATACGGCGACCACCGAGATCTACACTAGGCGTACAGCTGGTGCTGCAGCTTATTA
s2_F_837_GATAACGCCA	AATGATACGGCGACCACCGAGATCTACACGATAACGCCAGCTGGTGCTGCAGCTTATTA
s2_F_838_GAGTTCTATC	AATGATACGGCGACCACCGAGATCTACACGAGTTCTATCGCTGGTGCTGCAGCTTATTA
s2_F_839_TTATGGAACC	AATGATACGGCGACCACCGAGATCTACACTTATGGAACCGCTGGTGCTGCAGCTTATTA
s2_F_840_GTCTACGGAT	AATGATACGGCGACCACCGAGATCTACACGTCTACGGATGCTGGTGCTGCAGCTTATTA
s2_F_841_GCGTAGGTTG	AATGATACGGCGACCACCGAGATCTACACGCGTAGGTTGGCTGGTGCTGCAGCTTATTA
s2_F_842_TAGGAAGGCG	AATGATACGGCGACCACCGAGATCTACACTAGGAAGGCGGCTGGTGCTGCAGCTTATTA
s2_F_843_GCGGAAGTAT	AATGATACGGCGACCACCGAGATCTACACGCGGAAGTATGCTGGTGCTGCAGCTTATTA
s2_F_844_GAATTAGCCG	AATGATACGGCGACCACCGAGATCTACACGAATTAGCCGGCTGGTGCTGCAGCTTATTA
s2_F_845_CACGGTAATT	AATGATACGGCGACCACCGAGATCTACACCACGGTAATTGCTGGTGCTGCAGCTTATTA
s2_F_846_CAATATCGAC	AATGATACGGCGACCACCGAGATCTACACCAATATCGACGCTGGTGCTGCAGCTTATTA
s2_F_847_ACCAATGGTA	AATGATACGGCGACCACCGAGATCTACACACCAATGGTAGCTGGTGCTGCAGCTTATTA
s2_F_848_AACGTTGTCT	AATGATACGGCGACCACCGAGATCTACACAACGTTGTCTGCTGGTGCTGCAGCTTATTA
s2_F_849_CCGGTGTGAT	AATGATACGGCGACCACCGAGATCTACACCCGGTGTGATGCTGGTGCTGCAGCTTATTA
s2_F_850_CGTCCTGAAG	AATGATACGGCGACCACCGAGATCTACACCGTCCTGAAGGCTGGTGCTGCAGCTTATTA
s2_F_851_CACTCTGCCA	AATGATACGGCGACCACCGAGATCTACACCACTCTGCCAGCTGGTGCTGCAGCTTATTA
s2_F_852_TATCGTCATC	AATGATACGGCGACCACCGAGATCTACACTATCGTCATCGCTGGTGCTGCAGCTTATTA
s2_F_853_GTACGTCCAT	AATGATACGGCGACCACCGAGATCTACACGTACGTCCATGCTGGTGCTGCAGCTTATTA
s2_F_854_AATTGCGGAT	AATGATACGGCGACCACCGAGATCTACACAATTGCGGATGCTGGTGCTGCAGCTTATTA
s2_F_855_GCGAACAATG	AATGATACGGCGACCACCGAGATCTACACGCGAACAATGGCTGGTGCTGCAGCTTATTA
s2_F_856_GAATGGACTT	AATGATACGGCGACCACCGAGATCTACACGAATGGACTTGCTGGTGCTGCAGCTTATTA
s2_F_857_AGGAAGTATC	AATGATACGGCGACCACCGAGATCTACACAGGAAGTATCGCTGGTGCTGCAGCTTATTA
s2_F_858_GCTAGCCTCT	AATGATACGGCGACCACCGAGATCTACACGCTAGCCTCTGCTGGTGCTGCAGCTTATTA
s2_F_859_CGCTGATGAC	AATGATACGGCGACCACCGAGATCTACACCGCTGATGACGCTGGTGCTGCAGCTTATTA
s2_F_860_GCGTAACTGA	AATGATACGGCGACCACCGAGATCTACACGCGTAACTGAGCTGGTGCTGCAGCTTATTA
s2_F_861_CAGGCCATCA	AATGATACGGCGACCACCGAGATCTACACCAGGCCATCAGCTGGTGCTGCAGCTTATTA
s2_F_862_TACACGGAGC	AATGATACGGCGACCACCGAGATCTACACTACACGGAGCGCTGGTGCTGCAGCTTATTA
s2_F_863_ACACACGTGG	AATGATACGGCGACCACCGAGATCTACACACACACGTGGGCTGGTGCTGCAGCTTATTA
s2_F_864_AGACTGGTTA	AATGATACGGCGACCACCGAGATCTACACAGACTGGTTAGCTGGTGCTGCAGCTTATTA
s2_F_865_CTCAGCTTCT	AATGATACGGCGACCACCGAGATCTACACCTCAGCTTCTGCTGGTGCTGCAGCTTATTA
s2_F_866_GGCTTAGGTA	AATGATACGGCGACCACCGAGATCTACACGGCTTAGGTAGCTGGTGCTGCAGCTTATTA
s2_F_867_AGACGTTAGA	AATGATACGGCGACCACCGAGATCTACACAGACGTTAGAGCTGGTGCTGCAGCTTATTA
s2_F_868_TGTAGCTATC	AATGATACGGCGACCACCGAGATCTACACTGTAGCTATCGCTGGTGCTGCAGCTTATTA
s2_F_869_AATTCGGAGC	AATGATACGGCGACCACCGAGATCTACACAATTCGGAGCGCTGGTGCTGCAGCTTATTA
s2_F_870_CGTACTCGAC	AATGATACGGCGACCACCGAGATCTACACCGTACTCGACGCTGGTGCTGCAGCTTATTA
s2_F_871_AGCTGTTCAA	AATGATACGGCGACCACCGAGATCTACACAGCTGTTCAAGCTGGTGCTGCAGCTTATTA
s2_F_872_ACAGACTCAC	AATGATACGGCGACCACCGAGATCTACACACAGACTCACGCTGGTGCTGCAGCTTATTA
s2_F_873_CGGAGGAGTA	AATGATACGGCGACCACCGAGATCTACACCGGAGGAGTAGCTGGTGCTGCAGCTTATTA
s2_F_874_GGTTAGCGAG	AATGATACGGCGACCACCGAGATCTACACGGTTAGCGAGGCTGGTGCTGCAGCTTATTA
s2_F_875_GGCCTTCAAC	AATGATACGGCGACCACCGAGATCTACACGGCCTTCAACGCTGGTGCTGCAGCTTATTA
s2_F_876_GGCTATCTAC	AATGATACGGCGACCACCGAGATCTACACGGCTATCTACGCTGGTGCTGCAGCTTATTA
s2_F_877_GGCTAGCTTA	AATGATACGGCGACCACCGAGATCTACACGGCTAGCTTAGCTGGTGCTGCAGCTTATTA
s2_F_878_GGTCATTAGT	AATGATACGGCGACCACCGAGATCTACACGGTCATTAGTGCTGGTGCTGCAGCTTATTA
s2_F_879_CACGCAACTT	AATGATACGGCGACCACCGAGATCTACACCACGCAACTTGCTGGTGCTGCAGCTTATTA
s2_F_880_AGCCTCAGTT	AATGATACGGCGACCACCGAGATCTACACAGCCTCAGTTGCTGGTGCTGCAGCTTATTA
s2_F_881_GGACCTCGTT	AATGATACGGCGACCACCGAGATCTACACGGACCTCGTTGCTGGTGCTGCAGCTTATTA
s2_F_882_AAGGACCGTC	AATGATACGGCGACCACCGAGATCTACACAAGGACCGTCGCTGGTGCTGCAGCTTATTA
s2_F_883_AGCCTCCTAA	AATGATACGGCGACCACCGAGATCTACACAGCCTCCTAAGCTGGTGCTGCAGCTTATTA
s2_F_884_GGCTAGAACA	AATGATACGGCGACCACCGAGATCTACACGGCTAGAACAGCTGGTGCTGCAGCTTATTA
s2_F_885_GACTAGTCTT	AATGATACGGCGACCACCGAGATCTACACGACTAGTCTTGCTGGTGCTGCAGCTTATTA
s2_F_886_TCCTGATAAG	AATGATACGGCGACCACCGAGATCTACACTCCTGATAAGGCTGGTGCTGCAGCTTATTA
s2_F_887_CCATAAGCCA	AATGATACGGCGACCACCGAGATCTACACCCATAAGCCAGCTGGTGCTGCAGCTTATTA
s2_F_888_TGGAACTACA	AATGATACGGCGACCACCGAGATCTACACTGGAACTACAGCTGGTGCTGCAGCTTATTA
s2_F_889_GGTTCCTACG	AATGATACGGCGACCACCGAGATCTACACGGTTCCTACGGCTGGTGCTGCAGCTTATTA
s2_F_890_GCATTGGTGT	AATGATACGGCGACCACCGAGATCTACACGCATTGGTGTGCTGGTGCTGCAGCTTATTA
s2_F_891_GTCGATACCT	AATGATACGGCGACCACCGAGATCTACACGTCGATACCTGCTGGTGCTGCAGCTTATTA
s2_F_892_GCGATACTTA	AATGATACGGCGACCACCGAGATCTACACGCGATACTTAGCTGGTGCTGCAGCTTATTA
s2_F_893_AGGCACGAGT	AATGATACGGCGACCACCGAGATCTACACAGGCACGAGTGCTGGTGCTGCAGCTTATTA
s2_F_894_ATACATCGCT	AATGATACGGCGACCACCGAGATCTACACATACATCGCTGCTGGTGCTGCAGCTTATTA
s2_F_895_TAAGATCGCT	AATGATACGGCGACCACCGAGATCTACACTAAGATCGCTGCTGGTGCTGCAGCTTATTA
s2_F_896_CGTTACGCCT	AATGATACGGCGACCACCGAGATCTACACCGTTACGCCTGCTGGTGCTGCAGCTTATTA
s2_F_897_ATGCGGAACA	AATGATACGGCGACCACCGAGATCTACACATGCGGAACAGCTGGTGCTGCAGCTTATTA
s2_F_898_GACAGGTCAA	AATGATACGGCGACCACCGAGATCTACACGACAGGTCAAGCTGGTGCTGCAGCTTATTA
s2_F_899_ATTCGAACGT	AATGATACGGCGACCACCGAGATCTACACATTCGAACGTGCTGGTGCTGCAGCTTATTA
s2_F_900_CGCAGAGGTT	AATGATACGGCGACCACCGAGATCTACACCGCAGAGGTTGCTGGTGCTGCAGCTTATTA
s2_F_901_GTTCTCAGTT	AATGATACGGCGACCACCGAGATCTACACGTTCTCAGTTGCTGGTGCTGCAGCTTATTA
s2_F_902_GCTGAGCAGA	AATGATACGGCGACCACCGAGATCTACACGCTGAGCAGAGCTGGTGCTGCAGCTTATTA
s2_F_903_GGAGTTAGTT	AATGATACGGCGACCACCGAGATCTACACGGAGTTAGTTGCTGGTGCTGCAGCTTATTA
s2_F_904_GGATGAAGTT	AATGATACGGCGACCACCGAGATCTACACGGATGAAGTTGCTGGTGCTGCAGCTTATTA
s2_F_905_ACCACTCGTC	AATGATACGGCGACCACCGAGATCTACACACCACTCGTCGCTGGTGCTGCAGCTTATTA
s2_F_906_CTCAGACAGA	AATGATACGGCGACCACCGAGATCTACACCTCAGACAGAGCTGGTGCTGCAGCTTATTA
s2_F_907_GAATGCGGAG	AATGATACGGCGACCACCGAGATCTACACGAATGCGGAGGCTGGTGCTGCAGCTTATTA
s2_F_908_GACGAATAAG	AATGATACGGCGACCACCGAGATCTACACGACGAATAAGGCTGGTGCTGCAGCTTATTA
s2_F_909_GACGAGCCAA	AATGATACGGCGACCACCGAGATCTACACGACGAGCCAAGCTGGTGCTGCAGCTTATTA
s2_F_910_GACGAGTTCT	AATGATACGGCGACCACCGAGATCTACACGACGAGTTCTGCTGGTGCTGCAGCTTATTA
s2_F_911_TTGGCTCCAA	AATGATACGGCGACCACCGAGATCTACACTTGGCTCCAAGCTGGTGCTGCAGCTTATTA
s2_F_912_ACGTGAATGT	AATGATACGGCGACCACCGAGATCTACACACGTGAATGTGCTGGTGCTGCAGCTTATTA
s2_F_913_AGAGACTGTA	AATGATACGGCGACCACCGAGATCTACACAGAGACTGTAGCTGGTGCTGCAGCTTATTA
s2_F_914_GACGAGCAGT	AATGATACGGCGACCACCGAGATCTACACGACGAGCAGTGCTGGTGCTGCAGCTTATTA
s2_F_915_CTCTGGTGAT	AATGATACGGCGACCACCGAGATCTACACCTCTGGTGATGCTGGTGCTGCAGCTTATTA
s2_F_916_AGAACGCACA	AATGATACGGCGACCACCGAGATCTACACAGAACGCACAGCTGGTGCTGCAGCTTATTA
s2_F_917_CGTGGACGTA	AATGATACGGCGACCACCGAGATCTACACCGTGGACGTAGCTGGTGCTGCAGCTTATTA
s2_F_918_TTGACGGTTG	AATGATACGGCGACCACCGAGATCTACACTTGACGGTTGGCTGGTGCTGCAGCTTATTA
s2_F_919_GGTCCTATAT	AATGATACGGCGACCACCGAGATCTACACGGTCCTATATGCTGGTGCTGCAGCTTATTA
s2_F_920_CGAACGTCGA	AATGATACGGCGACCACCGAGATCTACACCGAACGTCGAGCTGGTGCTGCAGCTTATTA
s2_F_921_ACTGTGACGG	AATGATACGGCGACCACCGAGATCTACACACTGTGACGGGCTGGTGCTGCAGCTTATTA
s2_F_922_CTTGTCCGCT	AATGATACGGCGACCACCGAGATCTACACCTTGTCCGCTGCTGGTGCTGCAGCTTATTA
s2_F_923_GACGTACTCT	AATGATACGGCGACCACCGAGATCTACACGACGTACTCTGCTGGTGCTGCAGCTTATTA
s2_F_924_TACGTGCTCG	AATGATACGGCGACCACCGAGATCTACACTACGTGCTCGGCTGGTGCTGCAGCTTATTA
s2_F_925_GTGGTGATTG	AATGATACGGCGACCACCGAGATCTACACGTGGTGATTGGCTGGTGCTGCAGCTTATTA
s2_F_926_TGATCCGGAG	AATGATACGGCGACCACCGAGATCTACACTGATCCGGAGGCTGGTGCTGCAGCTTATTA
s2_F_927_TGCAATGCTG	AATGATACGGCGACCACCGAGATCTACACTGCAATGCTGGCTGGTGCTGCAGCTTATTA
s2_F_928_GAACAGTATC	AATGATACGGCGACCACCGAGATCTACACGAACAGTATCGCTGGTGCTGCAGCTTATTA
s2_F_929_AGTGGACATG	AATGATACGGCGACCACCGAGATCTACACAGTGGACATGGCTGGTGCTGCAGCTTATTA
s2_F_930_AGTGGATTGG	AATGATACGGCGACCACCGAGATCTACACAGTGGATTGGGCTGGTGCTGCAGCTTATTA
s2_F_931_AGTCGTGTCA	AATGATACGGCGACCACCGAGATCTACACAGTCGTGTCAGCTGGTGCTGCAGCTTATTA
s2_F_932_GAGGAGTGTC	AATGATACGGCGACCACCGAGATCTACACGAGGAGTGTCGCTGGTGCTGCAGCTTATTA
s2_F_933_AGGACTCGCT	AATGATACGGCGACCACCGAGATCTACACAGGACTCGCTGCTGGTGCTGCAGCTTATTA
s2_F_934_CGTCACTAGG	AATGATACGGCGACCACCGAGATCTACACCGTCACTAGGGCTGGTGCTGCAGCTTATTA
s2_F_935_ACGTGGTGAT	AATGATACGGCGACCACCGAGATCTACACACGTGGTGATGCTGGTGCTGCAGCTTATTA
s2_F_936_TTCGATGACG	AATGATACGGCGACCACCGAGATCTACACTTCGATGACGGCTGGTGCTGCAGCTTATTA
s2_F_937_TAATACCGGA	AATGATACGGCGACCACCGAGATCTACACTAATACCGGAGCTGGTGCTGCAGCTTATTA
s2_F_938_TGATGGTTAC	AATGATACGGCGACCACCGAGATCTACACTGATGGTTACGCTGGTGCTGCAGCTTATTA
s2_F_939_ACAATCTGTC	AATGATACGGCGACCACCGAGATCTACACACAATCTGTCGCTGGTGCTGCAGCTTATTA
s2_F_940_GCTGAAGATG	AATGATACGGCGACCACCGAGATCTACACGCTGAAGATGGCTGGTGCTGCAGCTTATTA
s2_F_941_GGTATGGCTG	AATGATACGGCGACCACCGAGATCTACACGGTATGGCTGGCTGGTGCTGCAGCTTATTA
s2_F_942_CAATGGCGAG	AATGATACGGCGACCACCGAGATCTACACCAATGGCGAGGCTGGTGCTGCAGCTTATTA
s2_F_943_TCCGATTCTC	AATGATACGGCGACCACCGAGATCTACACTCCGATTCTCGCTGGTGCTGCAGCTTATTA
s2_F_944_TGCCTTCTCC	AATGATACGGCGACCACCGAGATCTACACTGCCTTCTCCGCTGGTGCTGCAGCTTATTA
s2_F_945_ACTCGTATCG	AATGATACGGCGACCACCGAGATCTACACACTCGTATCGGCTGGTGCTGCAGCTTATTA
s2_F_946_GCCTACAGGA	AATGATACGGCGACCACCGAGATCTACACGCCTACAGGAGCTGGTGCTGCAGCTTATTA
s2_F_947_GCCTACCACT	AATGATACGGCGACCACCGAGATCTACACGCCTACCACTGCTGGTGCTGCAGCTTATTA
s2_F_948_GCCTATGCTA	AATGATACGGCGACCACCGAGATCTACACGCCTATGCTAGCTGGTGCTGCAGCTTATTA
s2_F_949_GCCTCCACAA	AATGATACGGCGACCACCGAGATCTACACGCCTCCACAAGCTGGTGCTGCAGCTTATTA
s2_F_950_GCCTCTACTT	AATGATACGGCGACCACCGAGATCTACACGCCTCTACTTGCTGGTGCTGCAGCTTATTA
s2_F_951_GCCTCTGATG	AATGATACGGCGACCACCGAGATCTACACGCCTCTGATGGCTGGTGCTGCAGCTTATTA
s2_F_952_GCCTGATGAT	AATGATACGGCGACCACCGAGATCTACACGCCTGATGATGCTGGTGCTGCAGCTTATTA
s2_F_953_GCCTTGGAAT	AATGATACGGCGACCACCGAGATCTACACGCCTTGGAATGCTGGTGCTGCAGCTTATTA
s2_F_954_GCCTTGTTAA	AATGATACGGCGACCACCGAGATCTACACGCCTTGTTAAGCTGGTGCTGCAGCTTATTA
s2_F_955_CCATGGTACC	AATGATACGGCGACCACCGAGATCTACACCCATGGTACCGCTGGTGCTGCAGCTTATTA
s2_F_956_TGTGTTAGCG	AATGATACGGCGACCACCGAGATCTACACTGTGTTAGCGGCTGGTGCTGCAGCTTATTA
s2_F_957_GCGACCAGTT	AATGATACGGCGACCACCGAGATCTACACGCGACCAGTTGCTGGTGCTGCAGCTTATTA
s2_F_958_ATGAGCTCTA	AATGATACGGCGACCACCGAGATCTACACATGAGCTCTAGCTGGTGCTGCAGCTTATTA
s2_F_959_GATTCGCAAG	AATGATACGGCGACCACCGAGATCTACACGATTCGCAAGGCTGGTGCTGCAGCTTATTA
s2_F_960_TCCTGGATCG	AATGATACGGCGACCACCGAGATCTACACTCCTGGATCGGCTGGTGCTGCAGCTTATTA
s2_F_961_ACATCGCACT	AATGATACGGCGACCACCGAGATCTACACACATCGCACTGCTGGTGCTGCAGCTTATTA
s2_F_962_AATCCTGGAC	AATGATACGGCGACCACCGAGATCTACACAATCCTGGACGCTGGTGCTGCAGCTTATTA
s2_F_963_AATTGGATCC	AATGATACGGCGACCACCGAGATCTACACAATTGGATCCGCTGGTGCTGCAGCTTATTA
s2_F_964_GCCTTCGGTT	AATGATACGGCGACCACCGAGATCTACACGCCTTCGGTTGCTGGTGCTGCAGCTTATTA
s2_F_965_TCGACTAACC	AATGATACGGCGACCACCGAGATCTACACTCGACTAACCGCTGGTGCTGCAGCTTATTA
s2_F_966_ACGTCGTCCT	AATGATACGGCGACCACCGAGATCTACACACGTCGTCCTGCTGGTGCTGCAGCTTATTA
s2_F_967_TTGATGCACA	AATGATACGGCGACCACCGAGATCTACACTTGATGCACAGCTGGTGCTGCAGCTTATTA
s2_F_968_GTCGTGCGAT	AATGATACGGCGACCACCGAGATCTACACGTCGTGCGATGCTGGTGCTGCAGCTTATTA
s2_F_969_GGTCTCGTTA	AATGATACGGCGACCACCGAGATCTACACGGTCTCGTTAGCTGGTGCTGCAGCTTATTA
s2_F_970_GAACTCGAGG	AATGATACGGCGACCACCGAGATCTACACGAACTCGAGGGCTGGTGCTGCAGCTTATTA
s2_F_971_ACTTCAGCGA	AATGATACGGCGACCACCGAGATCTACACACTTCAGCGAGCTGGTGCTGCAGCTTATTA
s2_F_972_ATAGATCTGC	AATGATACGGCGACCACCGAGATCTACACATAGATCTGCGCTGGTGCTGCAGCTTATTA
s2_F_973_ACCGCACGAT	AATGATACGGCGACCACCGAGATCTACACACCGCACGATGCTGGTGCTGCAGCTTATTA
s2_F_974_ACTCTTGCTG	AATGATACGGCGACCACCGAGATCTACACACTCTTGCTGGCTGGTGCTGCAGCTTATTA
s2_F_975_CTGGAGACCT	AATGATACGGCGACCACCGAGATCTACACCTGGAGACCTGCTGGTGCTGCAGCTTATTA
s2_F_976_CTAGCTGTTA	AATGATACGGCGACCACCGAGATCTACACCTAGCTGTTAGCTGGTGCTGCAGCTTATTA
s2_F_977_AGCTATGCCA	AATGATACGGCGACCACCGAGATCTACACAGCTATGCCAGCTGGTGCTGCAGCTTATTA
s2_F_978_CCGCACAATA	AATGATACGGCGACCACCGAGATCTACACCCGCACAATAGCTGGTGCTGCAGCTTATTA
s2_F_979_GACTCATCGT	AATGATACGGCGACCACCGAGATCTACACGACTCATCGTGCTGGTGCTGCAGCTTATTA
s2_F_980_TCACGGTAGG	AATGATACGGCGACCACCGAGATCTACACTCACGGTAGGGCTGGTGCTGCAGCTTATTA
s2_F_981_CACGCCTTAT	AATGATACGGCGACCACCGAGATCTACACCACGCCTTATGCTGGTGCTGCAGCTTATTA
s2_F_982_TCAACGACTT	AATGATACGGCGACCACCGAGATCTACACTCAACGACTTGCTGGTGCTGCAGCTTATTA
s2_F_983_ACCGTTGCTA	AATGATACGGCGACCACCGAGATCTACACACCGTTGCTAGCTGGTGCTGCAGCTTATTA
s2_F_984_AAGTCGAACT	AATGATACGGCGACCACCGAGATCTACACAAGTCGAACTGCTGGTGCTGCAGCTTATTA
s2_F_985_TAGTCGAAGG	AATGATACGGCGACCACCGAGATCTACACTAGTCGAAGGGCTGGTGCTGCAGCTTATTA
s2_F_986_GAATATTGCC	AATGATACGGCGACCACCGAGATCTACACGAATATTGCCGCTGGTGCTGCAGCTTATTA
s2_F_987_TGTGAACCTT	AATGATACGGCGACCACCGAGATCTACACTGTGAACCTTGCTGGTGCTGCAGCTTATTA
s2_F_988_TTGTCTCACA	AATGATACGGCGACCACCGAGATCTACACTTGTCTCACAGCTGGTGCTGCAGCTTATTA
s2_F_989_GTATTCGTTC	AATGATACGGCGACCACCGAGATCTACACGTATTCGTTCGCTGGTGCTGCAGCTTATTA
s2_F_990_ATGGCAAGAT	AATGATACGGCGACCACCGAGATCTACACATGGCAAGATGCTGGTGCTGCAGCTTATTA
s2_F_991_ACTCTAGAGG	AATGATACGGCGACCACCGAGATCTACACACTCTAGAGGGCTGGTGCTGCAGCTTATTA
s2_F_992_TCCGGTCCTT	AATGATACGGCGACCACCGAGATCTACACTCCGGTCCTTGCTGGTGCTGCAGCTTATTA
s2_F_993_GTGTCCTAGC	AATGATACGGCGACCACCGAGATCTACACGTGTCCTAGCGCTGGTGCTGCAGCTTATTA
s2_F_994_ACCATGCATC	AATGATACGGCGACCACCGAGATCTACACACCATGCATCGCTGGTGCTGCAGCTTATTA
s2_F_995_CCATCGCTAA	AATGATACGGCGACCACCGAGATCTACACCCATCGCTAAGCTGGTGCTGCAGCTTATTA
s2_F_996_CTGTACGTAG	AATGATACGGCGACCACCGAGATCTACACCTGTACGTAGGCTGGTGCTGCAGCTTATTA
s2_F_997_CGCCAACTAA	AATGATACGGCGACCACCGAGATCTACACCGCCAACTAAGCTGGTGCTGCAGCTTATTA
s2_F_998_TCAGAGCTGT	AATGATACGGCGACCACCGAGATCTACACTCAGAGCTGTGCTGGTGCTGCAGCTTATTA
s2_F_999_AGTGTGCATT	AATGATACGGCGACCACCGAGATCTACACAGTGTGCATTGCTGGTGCTGCAGCTTATTA
s2_F_1000_GTAATCGCGG	AATGATACGGCGACCACCGAGATCTACACGTAATCGCGGGCTGGTGCTGCAGCTTATTA
s2_F_1001_CGAGACATTG	AATGATACGGCGACCACCGAGATCTACACCGAGACATTGGCTGGTGCTGCAGCTTATTA
s2_F_1002_CGTTATCCGG	AATGATACGGCGACCACCGAGATCTACACCGTTATCCGGGCTGGTGCTGCAGCTTATTA
s2_F_1003_GCTGGACACT	AATGATACGGCGACCACCGAGATCTACACGCTGGACACTGCTGGTGCTGCAGCTTATTA
s2_F_1004_AACTACGGTA	AATGATACGGCGACCACCGAGATCTACACAACTACGGTAGCTGGTGCTGCAGCTTATTA
s2_F_1005_AGGTGTCACC	AATGATACGGCGACCACCGAGATCTACACAGGTGTCACCGCTGGTGCTGCAGCTTATTA
s2_F_1006_GGAGTAGTCG	AATGATACGGCGACCACCGAGATCTACACGGAGTAGTCGGCTGGTGCTGCAGCTTATTA
s2_F_1007_GTATCGTGAC	AATGATACGGCGACCACCGAGATCTACACGTATCGTGACGCTGGTGCTGCAGCTTATTA
s2_F_1008_GGCTGGTGAA	AATGATACGGCGACCACCGAGATCTACACGGCTGGTGAAGCTGGTGCTGCAGCTTATTA
s2_F_1009_GTCACGGCTT	AATGATACGGCGACCACCGAGATCTACACGTCACGGCTTGCTGGTGCTGCAGCTTATTA
s2_F_1010_AACATGTGTC	AATGATACGGCGACCACCGAGATCTACACAACATGTGTCGCTGGTGCTGCAGCTTATTA
s2_F_1011_CCACGCATGA	AATGATACGGCGACCACCGAGATCTACACCCACGCATGAGCTGGTGCTGCAGCTTATTA
s2_F_1012_ATCGTACGCT	AATGATACGGCGACCACCGAGATCTACACATCGTACGCTGCTGGTGCTGCAGCTTATTA
s2_F_1013_AGTGTCCTTC	AATGATACGGCGACCACCGAGATCTACACAGTGTCCTTCGCTGGTGCTGCAGCTTATTA
s2_F_1014_ACCTTCTCCG	AATGATACGGCGACCACCGAGATCTACACACCTTCTCCGGCTGGTGCTGCAGCTTATTA
s2_F_1015_CTATCTCAGC	AATGATACGGCGACCACCGAGATCTACACCTATCTCAGCGCTGGTGCTGCAGCTTATTA
s2_F_1016_TAGACTCAGC	AATGATACGGCGACCACCGAGATCTACACTAGACTCAGCGCTGGTGCTGCAGCTTATTA
s2_F_1017_GCTTACCGTG	AATGATACGGCGACCACCGAGATCTACACGCTTACCGTGGCTGGTGCTGCAGCTTATTA
s2_F_1018_GCATAGATCC	AATGATACGGCGACCACCGAGATCTACACGCATAGATCCGCTGGTGCTGCAGCTTATTA
s2_F_1019_AGCCACACGA	AATGATACGGCGACCACCGAGATCTACACAGCCACACGAGCTGGTGCTGCAGCTTATTA
s2_F_1020_CGACACAAGT	AATGATACGGCGACCACCGAGATCTACACCGACACAAGTGCTGGTGCTGCAGCTTATTA
s2_F_1021_AAGGCGTGAT	AATGATACGGCGACCACCGAGATCTACACAAGGCGTGATGCTGGTGCTGCAGCTTATTA
s2_F_1022_GTGTCTGCTT	AATGATACGGCGACCACCGAGATCTACACGTGTCTGCTTGCTGGTGCTGCAGCTTATTA
s2_F_1023_GTGATAGACG	AATGATACGGCGACCACCGAGATCTACACGTGATAGACGGCTGGTGCTGCAGCTTATTA
s2_F_1024_CTAGACAAGC	AATGATACGGCGACCACCGAGATCTACACCTAGACAAGCGCTGGTGCTGCAGCTTATTA
s2_F_1025_GAAGCGCCTT	AATGATACGGCGACCACCGAGATCTACACGAAGCGCCTTGCTGGTGCTGCAGCTTATTA
s2_F_1026_GTGACAGTAA	AATGATACGGCGACCACCGAGATCTACACGTGACAGTAAGCTGGTGCTGCAGCTTATTA
s2_F_1027_GTTAAGACGT	AATGATACGGCGACCACCGAGATCTACACGTTAAGACGTGCTGGTGCTGCAGCTTATTA
s2_F_1028_GAGCTTAACA	AATGATACGGCGACCACCGAGATCTACACGAGCTTAACAGCTGGTGCTGCAGCTTATTA
s2_F_1029_AACAAGGCGT	AATGATACGGCGACCACCGAGATCTACACAACAAGGCGTGCTGGTGCTGCAGCTTATTA
s2_F_1030_GAGATCCGTC	AATGATACGGCGACCACCGAGATCTACACGAGATCCGTCGCTGGTGCTGCAGCTTATTA
s2_F_1031_TGAACTGTGA	AATGATACGGCGACCACCGAGATCTACACTGAACTGTGAGCTGGTGCTGCAGCTTATTA
s2_F_1032_GCAAGCGATG	AATGATACGGCGACCACCGAGATCTACACGCAAGCGATGGCTGGTGCTGCAGCTTATTA
s2_F_1033_ACTCGTACTT	AATGATACGGCGACCACCGAGATCTACACACTCGTACTTGCTGGTGCTGCAGCTTATTA
s2_F_1034_ACCGCATCCT	AATGATACGGCGACCACCGAGATCTACACACCGCATCCTGCTGGTGCTGCAGCTTATTA
s2_F_1035_AAGTACCTAG	AATGATACGGCGACCACCGAGATCTACACAAGTACCTAGGCTGGTGCTGCAGCTTATTA
s2_F_1036_CCGTATCTAA	AATGATACGGCGACCACCGAGATCTACACCCGTATCTAAGCTGGTGCTGCAGCTTATTA
s2_F_1037_AACTCACGGC	AATGATACGGCGACCACCGAGATCTACACAACTCACGGCGCTGGTGCTGCAGCTTATTA
s2_F_1038_CGAGCATCAT	AATGATACGGCGACCACCGAGATCTACACCGAGCATCATGCTGGTGCTGCAGCTTATTA
s2_F_1039_GGAACCTAGC	AATGATACGGCGACCACCGAGATCTACACGGAACCTAGCGCTGGTGCTGCAGCTTATTA
s2_F_1040_TCGTTGCCTG	AATGATACGGCGACCACCGAGATCTACACTCGTTGCCTGGCTGGTGCTGCAGCTTATTA
s2_F_1041_TTGAAGCTGA	AATGATACGGCGACCACCGAGATCTACACTTGAAGCTGAGCTGGTGCTGCAGCTTATTA
s2_F_1042_GTGTCTCTGA	AATGATACGGCGACCACCGAGATCTACACGTGTCTCTGAGCTGGTGCTGCAGCTTATTA
s2_F_1043_GAACGGACAC	AATGATACGGCGACCACCGAGATCTACACGAACGGACACGCTGGTGCTGCAGCTTATTA
s2_F_1044_TCGAGGCTAT	AATGATACGGCGACCACCGAGATCTACACTCGAGGCTATGCTGGTGCTGCAGCTTATTA
s2_F_1045_GACAAGGTTC	AATGATACGGCGACCACCGAGATCTACACGACAAGGTTCGCTGGTGCTGCAGCTTATTA
s2_F_1046_CGGCATGATC	AATGATACGGCGACCACCGAGATCTACACCGGCATGATCGCTGGTGCTGCAGCTTATTA
s2_F_1047_CAACGTCTAA	AATGATACGGCGACCACCGAGATCTACACCAACGTCTAAGCTGGTGCTGCAGCTTATTA
s2_F_1048_GATCGCTATA	AATGATACGGCGACCACCGAGATCTACACGATCGCTATAGCTGGTGCTGCAGCTTATTA
s2_F_1049_GCTGTTGTTA	AATGATACGGCGACCACCGAGATCTACACGCTGTTGTTAGCTGGTGCTGCAGCTTATTA
s2_F_1050_TTCGAGTCAG	AATGATACGGCGACCACCGAGATCTACACTTCGAGTCAGGCTGGTGCTGCAGCTTATTA
s2_F_1051_TGGCTGTTCA	AATGATACGGCGACCACCGAGATCTACACTGGCTGTTCAGCTGGTGCTGCAGCTTATTA
s2_F_1052_TTAAGGTCGG	AATGATACGGCGACCACCGAGATCTACACTTAAGGTCGGGCTGGTGCTGCAGCTTATTA
s2_F_1053_ATGAGGCGAG	AATGATACGGCGACCACCGAGATCTACACATGAGGCGAGGCTGGTGCTGCAGCTTATTA
s2_F_1054_CGCGTAGTAA	AATGATACGGCGACCACCGAGATCTACACCGCGTAGTAAGCTGGTGCTGCAGCTTATTA
s2_F_1055_TTAGCAGATC	AATGATACGGCGACCACCGAGATCTACACTTAGCAGATCGCTGGTGCTGCAGCTTATTA
s2_F_1056_ATGGCTTCAG	AATGATACGGCGACCACCGAGATCTACACATGGCTTCAGGCTGGTGCTGCAGCTTATTA
s2_F_1057_TCTTGTCAGC	AATGATACGGCGACCACCGAGATCTACACTCTTGTCAGCGCTGGTGCTGCAGCTTATTA
s2_F_1058_TCTAGACTGG	AATGATACGGCGACCACCGAGATCTACACTCTAGACTGGGCTGGTGCTGCAGCTTATTA
s2_F_1059_CCGCTGGAAT	AATGATACGGCGACCACCGAGATCTACACCCGCTGGAATGCTGGTGCTGCAGCTTATTA
s2_F_1060_CGTCGAATAC	AATGATACGGCGACCACCGAGATCTACACCGTCGAATACGCTGGTGCTGCAGCTTATTA
s2_F_1061_AACCTCGGAA	AATGATACGGCGACCACCGAGATCTACACAACCTCGGAAGCTGGTGCTGCAGCTTATTA
s2_F_1062_TGCCTATCCG	AATGATACGGCGACCACCGAGATCTACACTGCCTATCCGGCTGGTGCTGCAGCTTATTA
s2_F_1063_GGTATACCTA	AATGATACGGCGACCACCGAGATCTACACGGTATACCTAGCTGGTGCTGCAGCTTATTA
s2_F_1064_ATGTAACGGC	AATGATACGGCGACCACCGAGATCTACACATGTAACGGCGCTGGTGCTGCAGCTTATTA
s2_F_1065_CTTGTACAAC	AATGATACGGCGACCACCGAGATCTACACCTTGTACAACGCTGGTGCTGCAGCTTATTA
s2_F_1066_AATCACGCCT	AATGATACGGCGACCACCGAGATCTACACAATCACGCCTGCTGGTGCTGCAGCTTATTA
s2_F_1067_ACACATAGCG	AATGATACGGCGACCACCGAGATCTACACACACATAGCGGCTGGTGCTGCAGCTTATTA
s2_F_1068_ACATCGATGC	AATGATACGGCGACCACCGAGATCTACACACATCGATGCGCTGGTGCTGCAGCTTATTA
s2_F_1069_AGAGATGTTC	AATGATACGGCGACCACCGAGATCTACACAGAGATGTTCGCTGGTGCTGCAGCTTATTA
s2_F_1070_AGATAGTCCG	AATGATACGGCGACCACCGAGATCTACACAGATAGTCCGGCTGGTGCTGCAGCTTATTA
s2_F_1071_AGGACTACAC	AATGATACGGCGACCACCGAGATCTACACAGGACTACACGCTGGTGCTGCAGCTTATTA
s2_F_1072_AGGTTCTAAC	AATGATACGGCGACCACCGAGATCTACACAGGTTCTAACGCTGGTGCTGCAGCTTATTA
s2_F_1073_AGTGATTCAC	AATGATACGGCGACCACCGAGATCTACACAGTGATTCACGCTGGTGCTGCAGCTTATTA
s2_F_1074_ATAGATGCGG	AATGATACGGCGACCACCGAGATCTACACATAGATGCGGGCTGGTGCTGCAGCTTATTA
s2_F_1075_ATCCAGCTAA	AATGATACGGCGACCACCGAGATCTACACATCCAGCTAAGCTGGTGCTGCAGCTTATTA
s2_F_1076_CACACCTGGA	AATGATACGGCGACCACCGAGATCTACACCACACCTGGAGCTGGTGCTGCAGCTTATTA
s2_F_1077_CCGCGACTAA	AATGATACGGCGACCACCGAGATCTACACCCGCGACTAAGCTGGTGCTGCAGCTTATTA
s2_F_1078_CCTACGAGTC	AATGATACGGCGACCACCGAGATCTACACCCTACGAGTCGCTGGTGCTGCAGCTTATTA
s2_F_1079_CGTTCCAGAG	AATGATACGGCGACCACCGAGATCTACACCGTTCCAGAGGCTGGTGCTGCAGCTTATTA
s2_F_1080_CTGGAGGCTA	AATGATACGGCGACCACCGAGATCTACACCTGGAGGCTAGCTGGTGCTGCAGCTTATTA
s2_F_1081_GCAAGGTAAC	AATGATACGGCGACCACCGAGATCTACACGCAAGGTAACGCTGGTGCTGCAGCTTATTA
s2_F_1082_GCCTAGAATT	AATGATACGGCGACCACCGAGATCTACACGCCTAGAATTGCTGGTGCTGCAGCTTATTA
s2_F_1083_GCCTGTTATT	AATGATACGGCGACCACCGAGATCTACACGCCTGTTATTGCTGGTGCTGCAGCTTATTA
s2_F_1084_GCGGACGATA	AATGATACGGCGACCACCGAGATCTACACGCGGACGATAGCTGGTGCTGCAGCTTATTA
s2_F_1085_GCGTCACCAA	AATGATACGGCGACCACCGAGATCTACACGCGTCACCAAGCTGGTGCTGCAGCTTATTA
s2_F_1086_GCTGAATGCT	AATGATACGGCGACCACCGAGATCTACACGCTGAATGCTGCTGGTGCTGCAGCTTATTA
s2_F_1087_GGAAGTACAA	AATGATACGGCGACCACCGAGATCTACACGGAAGTACAAGCTGGTGCTGCAGCTTATTA
s2_F_1088_GGACTTGCGA	AATGATACGGCGACCACCGAGATCTACACGGACTTGCGAGCTGGTGCTGCAGCTTATTA
s2_F_1089_GTCGAGGATG	AATGATACGGCGACCACCGAGATCTACACGTCGAGGATGGCTGGTGCTGCAGCTTATTA
s2_F_1090_GTCGGACCTA	AATGATACGGCGACCACCGAGATCTACACGTCGGACCTAGCTGGTGCTGCAGCTTATTA
s2_F_1091_TAGAGGTCTA	AATGATACGGCGACCACCGAGATCTACACTAGAGGTCTAGCTGGTGCTGCAGCTTATTA
s2_F_1092_TAGTGAGACC	AATGATACGGCGACCACCGAGATCTACACTAGTGAGACCGCTGGTGCTGCAGCTTATTA
s2_F_1093_TATAGGCGAA	AATGATACGGCGACCACCGAGATCTACACTATAGGCGAAGCTGGTGCTGCAGCTTATTA
s2_F_1094_TCAATTGGCG	AATGATACGGCGACCACCGAGATCTACACTCAATTGGCGGCTGGTGCTGCAGCTTATTA
s2_F_1095_TCCAGCTAGG	AATGATACGGCGACCACCGAGATCTACACTCCAGCTAGGGCTGGTGCTGCAGCTTATTA
s2_F_1096_TGTTGCCAGA	AATGATACGGCGACCACCGAGATCTACACTGTTGCCAGAGCTGGTGCTGCAGCTTATTA
s2_F_1097_GAGGTGAGAC	AATGATACGGCGACCACCGAGATCTACACGAGGTGAGACGCTGGTGCTGCAGCTTATTA
s2_F_1098_AGGCTGAATG	AATGATACGGCGACCACCGAGATCTACACAGGCTGAATGGCTGGTGCTGCAGCTTATTA
s2_F_1099_GACACGACGA	AATGATACGGCGACCACCGAGATCTACACGACACGACGAGCTGGTGCTGCAGCTTATTA
s2_F_1100_TCTACGACGA	AATGATACGGCGACCACCGAGATCTACACTCTACGACGAGCTGGTGCTGCAGCTTATTA
s2_F_1101_GGCACAATCC	AATGATACGGCGACCACCGAGATCTACACGGCACAATCCGCTGGTGCTGCAGCTTATTA
s2_F_1102_GAACTGATCC	AATGATACGGCGACCACCGAGATCTACACGAACTGATCCGCTGGTGCTGCAGCTTATTA
s2_F_1103_GAAGGACTCG	AATGATACGGCGACCACCGAGATCTACACGAAGGACTCGGCTGGTGCTGCAGCTTATTA
s2_F_1104_TAGCCTCTCA	AATGATACGGCGACCACCGAGATCTACACTAGCCTCTCAGCTGGTGCTGCAGCTTATTA
s2_F_1105_GACTACGTGA	AATGATACGGCGACCACCGAGATCTACACGACTACGTGAGCTGGTGCTGCAGCTTATTA
s2_F_1106_AGGCTTGGAG	AATGATACGGCGACCACCGAGATCTACACAGGCTTGGAGGCTGGTGCTGCAGCTTATTA
s2_F_1107_GCGAATATCA	AATGATACGGCGACCACCGAGATCTACACGCGAATATCAGCTGGTGCTGCAGCTTATTA
s2_F_1108_GCGATGATAT	AATGATACGGCGACCACCGAGATCTACACGCGATGATATGCTGGTGCTGCAGCTTATTA
s2_F_1109_ATATCCGGAT	AATGATACGGCGACCACCGAGATCTACACATATCCGGATGCTGGTGCTGCAGCTTATTA
s2_F_1110_TGACAGTGCC	AATGATACGGCGACCACCGAGATCTACACTGACAGTGCCGCTGGTGCTGCAGCTTATTA
s2_F_1111_ACCAGATGTC	AATGATACGGCGACCACCGAGATCTACACACCAGATGTCGCTGGTGCTGCAGCTTATTA
s2_F_1112_AGCTATCGTC	AATGATACGGCGACCACCGAGATCTACACAGCTATCGTCGCTGGTGCTGCAGCTTATTA
s2_F_1113_AGTCATTGTC	AATGATACGGCGACCACCGAGATCTACACAGTCATTGTCGCTGGTGCTGCAGCTTATTA
s2_F_1114_GACAGCGTTA	AATGATACGGCGACCACCGAGATCTACACGACAGCGTTAGCTGGTGCTGCAGCTTATTA
s2_F_1115_GCCAACTCAG	AATGATACGGCGACCACCGAGATCTACACGCCAACTCAGGCTGGTGCTGCAGCTTATTA
s2_F_1116_GCCAAGTAAT	AATGATACGGCGACCACCGAGATCTACACGCCAAGTAATGCTGGTGCTGCAGCTTATTA
s2_F_1117_GCCAATCCTT	AATGATACGGCGACCACCGAGATCTACACGCCAATCCTTGCTGGTGCTGCAGCTTATTA
s2_F_1118_GCCACCAATA	AATGATACGGCGACCACCGAGATCTACACGCCACCAATAGCTGGTGCTGCAGCTTATTA
s2_F_1119_GCCACGAGAT	AATGATACGGCGACCACCGAGATCTACACGCCACGAGATGCTGGTGCTGCAGCTTATTA
s2_F_1120_GCCACGTACA	AATGATACGGCGACCACCGAGATCTACACGCCACGTACAGCTGGTGCTGCAGCTTATTA
s2_F_1121_GCCACTCTCA	AATGATACGGCGACCACCGAGATCTACACGCCACTCTCAGCTGGTGCTGCAGCTTATTA
s2_F_1122_GCCAGTAGGT	AATGATACGGCGACCACCGAGATCTACACGCCAGTAGGTGCTGGTGCTGCAGCTTATTA
s2_F_1123_GCCAGTGAAG	AATGATACGGCGACCACCGAGATCTACACGCCAGTGAAGGCTGGTGCTGCAGCTTATTA
s2_F_1124_GCCATACCTG	AATGATACGGCGACCACCGAGATCTACACGCCATACCTGGCTGGTGCTGCAGCTTATTA
s2_F_1125_GCCATAGAGG	AATGATACGGCGACCACCGAGATCTACACGCCATAGAGGGCTGGTGCTGCAGCTTATTA
s2_F_1126_GCCATCCGAA	AATGATACGGCGACCACCGAGATCTACACGCCATCCGAAGCTGGTGCTGCAGCTTATTA
s2_F_1127_GCCATTCAAT	AATGATACGGCGACCACCGAGATCTACACGCCATTCAATGCTGGTGCTGCAGCTTATTA
s2_F_1128_TGAGTACTCC	AATGATACGGCGACCACCGAGATCTACACTGAGTACTCCGCTGGTGCTGCAGCTTATTA
s2_F_1129_TAGCAGCTAG	AATGATACGGCGACCACCGAGATCTACACTAGCAGCTAGGCTGGTGCTGCAGCTTATTA
s2_F_1130_GACGAACGTT	AATGATACGGCGACCACCGAGATCTACACGACGAACGTTGCTGGTGCTGCAGCTTATTA
s2_F_1131_ACGTGTCTGG	AATGATACGGCGACCACCGAGATCTACACACGTGTCTGGGCTGGTGCTGCAGCTTATTA
s2_F_1132_CGAGGTTACC	AATGATACGGCGACCACCGAGATCTACACCGAGGTTACCGCTGGTGCTGCAGCTTATTA
s2_F_1133_AAGTTGCAAG	AATGATACGGCGACCACCGAGATCTACACAAGTTGCAAGGCTGGTGCTGCAGCTTATTA
s2_F_1134_AGTCGGACAC	AATGATACGGCGACCACCGAGATCTACACAGTCGGACACGCTGGTGCTGCAGCTTATTA
s2_F_1135_AACCGCACAG	AATGATACGGCGACCACCGAGATCTACACAACCGCACAGGCTGGTGCTGCAGCTTATTA
s2_F_1136_CACGTTCAAC	AATGATACGGCGACCACCGAGATCTACACCACGTTCAACGCTGGTGCTGCAGCTTATTA
s2_F_1137_CTGGAGATTC	AATGATACGGCGACCACCGAGATCTACACCTGGAGATTCGCTGGTGCTGCAGCTTATTA
s2_F_1138_TGTCCGACGT	AATGATACGGCGACCACCGAGATCTACACTGTCCGACGTGCTGGTGCTGCAGCTTATTA
s2_F_1139_ATTGTCGAAC	AATGATACGGCGACCACCGAGATCTACACATTGTCGAACGCTGGTGCTGCAGCTTATTA
s2_F_1140_AGGCTGCCAA	AATGATACGGCGACCACCGAGATCTACACAGGCTGCCAAGCTGGTGCTGCAGCTTATTA
s2_F_1141_ACCACCATCC	AATGATACGGCGACCACCGAGATCTACACACCACCATCCGCTGGTGCTGCAGCTTATTA
s2_F_1142_GAGTGGTTAA	AATGATACGGCGACCACCGAGATCTACACGAGTGGTTAAGCTGGTGCTGCAGCTTATTA
s2_F_1143_AAGGCCGGTT	AATGATACGGCGACCACCGAGATCTACACAAGGCCGGTTGCTGGTGCTGCAGCTTATTA
s2_F_1144_CATGAGACGA	AATGATACGGCGACCACCGAGATCTACACCATGAGACGAGCTGGTGCTGCAGCTTATTA
s2_F_1145_TTGATCTGTC	AATGATACGGCGACCACCGAGATCTACACTTGATCTGTCGCTGGTGCTGCAGCTTATTA
s2_F_1146_GAGCCAACAT	AATGATACGGCGACCACCGAGATCTACACGAGCCAACATGCTGGTGCTGCAGCTTATTA
s2_F_1147_CAGTAGGCGA	AATGATACGGCGACCACCGAGATCTACACCAGTAGGCGAGCTGGTGCTGCAGCTTATTA
s2_F_1148_ACAGGAGATG	AATGATACGGCGACCACCGAGATCTACACACAGGAGATGGCTGGTGCTGCAGCTTATTA
s2_F_1149_GGCAGACATC	AATGATACGGCGACCACCGAGATCTACACGGCAGACATCGCTGGTGCTGCAGCTTATTA
s2_F_1150_ACGACGTAGT	AATGATACGGCGACCACCGAGATCTACACACGACGTAGTGCTGGTGCTGCAGCTTATTA
s2_F_1151_AGGCTCTGTA	AATGATACGGCGACCACCGAGATCTACACAGGCTCTGTAGCTGGTGCTGCAGCTTATTA
s2_F_1152_AACTGGCGTA	AATGATACGGCGACCACCGAGATCTACACAACTGGCGTAGCTGGTGCTGCAGCTTATTA
s2_F_1153_ATCGCATTAG	AATGATACGGCGACCACCGAGATCTACACATCGCATTAGGCTGGTGCTGCAGCTTATTA
s2_F_1154_ATCCATGATG	AATGATACGGCGACCACCGAGATCTACACATCCATGATGGCTGGTGCTGCAGCTTATTA
s2_F_1155_GCATCGTGTT	AATGATACGGCGACCACCGAGATCTACACGCATCGTGTTGCTGGTGCTGCAGCTTATTA
s2_F_1156_AGTACAGTTC	AATGATACGGCGACCACCGAGATCTACACAGTACAGTTCGCTGGTGCTGCAGCTTATTA
s2_F_1157_CATGACGAGC	AATGATACGGCGACCACCGAGATCTACACCATGACGAGCGCTGGTGCTGCAGCTTATTA
s2_F_1158_AGTGAAGCTG	AATGATACGGCGACCACCGAGATCTACACAGTGAAGCTGGCTGGTGCTGCAGCTTATTA
s2_F_1159_AATGAGGCCG	AATGATACGGCGACCACCGAGATCTACACAATGAGGCCGGCTGGTGCTGCAGCTTATTA
s2_F_1160_TCGTCGGTAC	AATGATACGGCGACCACCGAGATCTACACTCGTCGGTACGCTGGTGCTGCAGCTTATTA
s2_F_1161_GAGTTGCACA	AATGATACGGCGACCACCGAGATCTACACGAGTTGCACAGCTGGTGCTGCAGCTTATTA
s2_F_1162_AATCTGCATG	AATGATACGGCGACCACCGAGATCTACACAATCTGCATGGCTGGTGCTGCAGCTTATTA
s2_F_1163_AACCGTCAGC	AATGATACGGCGACCACCGAGATCTACACAACCGTCAGCGCTGGTGCTGCAGCTTATTA
s2_F_1164_ACTGCATGAG	AATGATACGGCGACCACCGAGATCTACACACTGCATGAGGCTGGTGCTGCAGCTTATTA
s2_F_1165_ACGGCTTATC	AATGATACGGCGACCACCGAGATCTACACACGGCTTATCGCTGGTGCTGCAGCTTATTA
s2_F_1166_GGTACAAGTT	AATGATACGGCGACCACCGAGATCTACACGGTACAAGTTGCTGGTGCTGCAGCTTATTA
s2_F_1167_GGACATAAGC	AATGATACGGCGACCACCGAGATCTACACGGACATAAGCGCTGGTGCTGCAGCTTATTA
s2_F_1168_AGCTGGACTA	AATGATACGGCGACCACCGAGATCTACACAGCTGGACTAGCTGGTGCTGCAGCTTATTA
s2_F_1169_AACTGCCAAG	AATGATACGGCGACCACCGAGATCTACACAACTGCCAAGGCTGGTGCTGCAGCTTATTA
s2_F_1170_TGCGCCTGAA	AATGATACGGCGACCACCGAGATCTACACTGCGCCTGAAGCTGGTGCTGCAGCTTATTA
s2_F_1171_CTATCGAATC	AATGATACGGCGACCACCGAGATCTACACCTATCGAATCGCTGGTGCTGCAGCTTATTA
s2_F_1172_TTCTGCAATC	AATGATACGGCGACCACCGAGATCTACACTTCTGCAATCGCTGGTGCTGCAGCTTATTA
s2_F_1173_GTTGTGGCAC	AATGATACGGCGACCACCGAGATCTACACGTTGTGGCACGCTGGTGCTGCAGCTTATTA
s2_F_1174_CTGAAGGTGT	AATGATACGGCGACCACCGAGATCTACACCTGAAGGTGTGCTGGTGCTGCAGCTTATTA
s2_F_1175_AGTAACCGCT	AATGATACGGCGACCACCGAGATCTACACAGTAACCGCTGCTGGTGCTGCAGCTTATTA
s2_F_1176_AGGTAATCAC	AATGATACGGCGACCACCGAGATCTACACAGGTAATCACGCTGGTGCTGCAGCTTATTA
s2_F_1177_AAGCTAGCAA	AATGATACGGCGACCACCGAGATCTACACAAGCTAGCAAGCTGGTGCTGCAGCTTATTA
s2_F_1178_ACCGTTAATC	AATGATACGGCGACCACCGAGATCTACACACCGTTAATCGCTGGTGCTGCAGCTTATTA
s2_F_1179_AGAGGAGCTA	AATGATACGGCGACCACCGAGATCTACACAGAGGAGCTAGCTGGTGCTGCAGCTTATTA
s2_F_1180_AGGAGATTAG	AATGATACGGCGACCACCGAGATCTACACAGGAGATTAGGCTGGTGCTGCAGCTTATTA
s2_F_1181_GCCTGTACAC	AATGATACGGCGACCACCGAGATCTACACGCCTGTACACGCTGGTGCTGCAGCTTATTA
s2_F_1182_GCTGTGAATT	AATGATACGGCGACCACCGAGATCTACACGCTGTGAATTGCTGGTGCTGCAGCTTATTA
s2_F_1183_CATTCGTTAC	AATGATACGGCGACCACCGAGATCTACACCATTCGTTACGCTGGTGCTGCAGCTTATTA
s2_F_1184_GCACTCAATT	AATGATACGGCGACCACCGAGATCTACACGCACTCAATTGCTGGTGCTGCAGCTTATTA
s2_F_1185_AGTCAGACTG	AATGATACGGCGACCACCGAGATCTACACAGTCAGACTGGCTGGTGCTGCAGCTTATTA
s2_F_1186_CGACACATCC	AATGATACGGCGACCACCGAGATCTACACCGACACATCCGCTGGTGCTGCAGCTTATTA
s2_F_1187_CGAGCAGTTC	AATGATACGGCGACCACCGAGATCTACACCGAGCAGTTCGCTGGTGCTGCAGCTTATTA
s2_F_1188_AGATGGAACA	AATGATACGGCGACCACCGAGATCTACACAGATGGAACAGCTGGTGCTGCAGCTTATTA
s2_F_1189_AATGTAGACG	AATGATACGGCGACCACCGAGATCTACACAATGTAGACGGCTGGTGCTGCAGCTTATTA
s2_F_1190_CCTCGCCTTA	AATGATACGGCGACCACCGAGATCTACACCCTCGCCTTAGCTGGTGCTGCAGCTTATTA
s2_F_1191_GGTACGACAC	AATGATACGGCGACCACCGAGATCTACACGGTACGACACGCTGGTGCTGCAGCTTATTA
s2_F_1192_GCTTCACGAC	AATGATACGGCGACCACCGAGATCTACACGCTTCACGACGCTGGTGCTGCAGCTTATTA
s2_F_1193_GTCGAAGACC	AATGATACGGCGACCACCGAGATCTACACGTCGAAGACCGCTGGTGCTGCAGCTTATTA
s2_F_1194_CGAGTGCTTC	AATGATACGGCGACCACCGAGATCTACACCGAGTGCTTCGCTGGTGCTGCAGCTTATTA
s2_F_1195_CGGACATTAC	AATGATACGGCGACCACCGAGATCTACACCGGACATTACGCTGGTGCTGCAGCTTATTA
s2_F_1196_ATGTCTGGTG	AATGATACGGCGACCACCGAGATCTACACATGTCTGGTGGCTGGTGCTGCAGCTTATTA
s2_F_1197_TCTAGGCGTT	AATGATACGGCGACCACCGAGATCTACACTCTAGGCGTTGCTGGTGCTGCAGCTTATTA
s2_F_1198_CATAATCAGC	AATGATACGGCGACCACCGAGATCTACACCATAATCAGCGCTGGTGCTGCAGCTTATTA
s2_F_1199_AGATTAGGAG	AATGATACGGCGACCACCGAGATCTACACAGATTAGGAGGCTGGTGCTGCAGCTTATTA
s2_F_1200_ATCAGAGGAG	AATGATACGGCGACCACCGAGATCTACACATCAGAGGAGGCTGGTGCTGCAGCTTATTA
s2_F_1201_CTAGAAGGAG	AATGATACGGCGACCACCGAGATCTACACCTAGAAGGAGGCTGGTGCTGCAGCTTATTA
s2_F_1202_CTCTGCGGTT	AATGATACGGCGACCACCGAGATCTACACCTCTGCGGTTGCTGGTGCTGCAGCTTATTA
s2_F_1203_TCGAGAACAG	AATGATACGGCGACCACCGAGATCTACACTCGAGAACAGGCTGGTGCTGCAGCTTATTA
s2_F_1204_CCAGACTACA	AATGATACGGCGACCACCGAGATCTACACCCAGACTACAGCTGGTGCTGCAGCTTATTA
s2_F_1205_CGAACCTACA	AATGATACGGCGACCACCGAGATCTACACCGAACCTACAGCTGGTGCTGCAGCTTATTA
s2_F_1206_GAGAGTTACA	AATGATACGGCGACCACCGAGATCTACACGAGAGTTACAGCTGGTGCTGCAGCTTATTA
s2_F_1207_AGAGAACGGC	AATGATACGGCGACCACCGAGATCTACACAGAGAACGGCGCTGGTGCTGCAGCTTATTA
s2_F_1208_TACCGATGAC	AATGATACGGCGACCACCGAGATCTACACTACCGATGACGCTGGTGCTGCAGCTTATTA
s2_F_1209_AGTGAGGAAC	AATGATACGGCGACCACCGAGATCTACACAGTGAGGAACGCTGGTGCTGCAGCTTATTA
s2_F_1210_TGGTACATAC	AATGATACGGCGACCACCGAGATCTACACTGGTACATACGCTGGTGCTGCAGCTTATTA
s2_F_1211_AGATGCCTAG	AATGATACGGCGACCACCGAGATCTACACAGATGCCTAGGCTGGTGCTGCAGCTTATTA
s2_F_1212_GTGAAGGACT	AATGATACGGCGACCACCGAGATCTACACGTGAAGGACTGCTGGTGCTGCAGCTTATTA
s2_F_1213_GTGACACACT	AATGATACGGCGACCACCGAGATCTACACGTGACACACTGCTGGTGCTGCAGCTTATTA
s2_F_1214_TACTTCACAG	AATGATACGGCGACCACCGAGATCTACACTACTTCACAGGCTGGTGCTGCAGCTTATTA
s2_F_1215_TGAATCACAG	AATGATACGGCGACCACCGAGATCTACACTGAATCACAGGCTGGTGCTGCAGCTTATTA
s2_F_1216_TTCCACACAG	AATGATACGGCGACCACCGAGATCTACACTTCCACACAGGCTGGTGCTGCAGCTTATTA
s2_F_1217_GCGGTATAGC	AATGATACGGCGACCACCGAGATCTACACGCGGTATAGCGCTGGTGCTGCAGCTTATTA
s2_F_1218_GGACGGCTAT	AATGATACGGCGACCACCGAGATCTACACGGACGGCTATGCTGGTGCTGCAGCTTATTA
s2_F_1219_GGAGGCAATA	AATGATACGGCGACCACCGAGATCTACACGGAGGCAATAGCTGGTGCTGCAGCTTATTA
s2_F_1220_TGTCGAACAG	AATGATACGGCGACCACCGAGATCTACACTGTCGAACAGGCTGGTGCTGCAGCTTATTA
s2_F_1221_TGTCGATGAT	AATGATACGGCGACCACCGAGATCTACACTGTCGATGATGCTGGTGCTGCAGCTTATTA
s2_F_1222_ATCCGCCTAT	AATGATACGGCGACCACCGAGATCTACACATCCGCCTATGCTGGTGCTGCAGCTTATTA
s2_F_1223_CAGAGCTTCG	AATGATACGGCGACCACCGAGATCTACACCAGAGCTTCGGCTGGTGCTGCAGCTTATTA
s2_F_1224_GCACTCATGG	AATGATACGGCGACCACCGAGATCTACACGCACTCATGGGCTGGTGCTGCAGCTTATTA
s2_F_1225_TTCGAGGTGT	AATGATACGGCGACCACCGAGATCTACACTTCGAGGTGTGCTGGTGCTGCAGCTTATTA
s2_F_1226_TCAAGCTTAG	AATGATACGGCGACCACCGAGATCTACACTCAAGCTTAGGCTGGTGCTGCAGCTTATTA
s2_F_1227_TCGTGTACTT	AATGATACGGCGACCACCGAGATCTACACTCGTGTACTTGCTGGTGCTGCAGCTTATTA
s2_F_1228_ATAGCAGTCA	AATGATACGGCGACCACCGAGATCTACACATAGCAGTCAGCTGGTGCTGCAGCTTATTA
s2_F_1229_GTCTGAGGCT	AATGATACGGCGACCACCGAGATCTACACGTCTGAGGCTGCTGGTGCTGCAGCTTATTA
s2_F_1230_TACGTGGATC	AATGATACGGCGACCACCGAGATCTACACTACGTGGATCGCTGGTGCTGCAGCTTATTA
s2_F_1231_TGCGATGAGC	AATGATACGGCGACCACCGAGATCTACACTGCGATGAGCGCTGGTGCTGCAGCTTATTA
s2_F_1232_GCAACTGCCA	AATGATACGGCGACCACCGAGATCTACACGCAACTGCCAGCTGGTGCTGCAGCTTATTA
s2_F_1233_GAGGATCTTG	AATGATACGGCGACCACCGAGATCTACACGAGGATCTTGGCTGGTGCTGCAGCTTATTA
s2_F_1234_GGACGTCATG	AATGATACGGCGACCACCGAGATCTACACGGACGTCATGGCTGGTGCTGCAGCTTATTA
s2_F_1235_CTGATTGTGG	AATGATACGGCGACCACCGAGATCTACACCTGATTGTGGGCTGGTGCTGCAGCTTATTA
s2_F_1236_GTCCAGTCTG	AATGATACGGCGACCACCGAGATCTACACGTCCAGTCTGGCTGGTGCTGCAGCTTATTA
s2_F_1237_AGGAGTCTCG	AATGATACGGCGACCACCGAGATCTACACAGGAGTCTCGGCTGGTGCTGCAGCTTATTA
s2_F_1238_TCAACAGACC	AATGATACGGCGACCACCGAGATCTACACTCAACAGACCGCTGGTGCTGCAGCTTATTA
s2_F_1239_ACGGATATGC	AATGATACGGCGACCACCGAGATCTACACACGGATATGCGCTGGTGCTGCAGCTTATTA
s2_F_1240_GGTTACCAAC	AATGATACGGCGACCACCGAGATCTACACGGTTACCAACGCTGGTGCTGCAGCTTATTA
s2_F_1241_CACAGTACTG	AATGATACGGCGACCACCGAGATCTACACCACAGTACTGGCTGGTGCTGCAGCTTATTA
s2_F_1242_TGCTACTGTC	AATGATACGGCGACCACCGAGATCTACACTGCTACTGTCGCTGGTGCTGCAGCTTATTA
s2_F_1243_ACTCGTCGAA	AATGATACGGCGACCACCGAGATCTACACACTCGTCGAAGCTGGTGCTGCAGCTTATTA
s2_F_1244_CGATTCCTCG	AATGATACGGCGACCACCGAGATCTACACCGATTCCTCGGCTGGTGCTGCAGCTTATTA
s2_F_1245_AGCTTGAGCT	AATGATACGGCGACCACCGAGATCTACACAGCTTGAGCTGCTGGTGCTGCAGCTTATTA
s2_F_1246_ACCAGGTTCC	AATGATACGGCGACCACCGAGATCTACACACCAGGTTCCGCTGGTGCTGCAGCTTATTA
s2_F_1247_ACACCACCAT	AATGATACGGCGACCACCGAGATCTACACACACCACCATGCTGGTGCTGCAGCTTATTA
s2_F_1248_TGCGCTGCTA	AATGATACGGCGACCACCGAGATCTACACTGCGCTGCTAGCTGGTGCTGCAGCTTATTA
s2_F_1249_ATCGAGCCAC	AATGATACGGCGACCACCGAGATCTACACATCGAGCCACGCTGGTGCTGCAGCTTATTA
s2_F_1250_CGAGACAGAT	AATGATACGGCGACCACCGAGATCTACACCGAGACAGATGCTGGTGCTGCAGCTTATTA
s2_F_1251_ATTGACACAG	AATGATACGGCGACCACCGAGATCTACACATTGACACAGGCTGGTGCTGCAGCTTATTA
s2_F_1252_GGCCTTATGC	AATGATACGGCGACCACCGAGATCTACACGGCCTTATGCGCTGGTGCTGCAGCTTATTA
s2_F_1253_CGTCAACGGA	AATGATACGGCGACCACCGAGATCTACACCGTCAACGGAGCTGGTGCTGCAGCTTATTA
s2_F_1254_CATGGCAACC	AATGATACGGCGACCACCGAGATCTACACCATGGCAACCGCTGGTGCTGCAGCTTATTA
s2_F_1255_TTCCTGGCTG	AATGATACGGCGACCACCGAGATCTACACTTCCTGGCTGGCTGGTGCTGCAGCTTATTA
s2_F_1256_TACACTGCAA	AATGATACGGCGACCACCGAGATCTACACTACACTGCAAGCTGGTGCTGCAGCTTATTA
s2_F_1257_GCGTATCATC	AATGATACGGCGACCACCGAGATCTACACGCGTATCATCGCTGGTGCTGCAGCTTATTA
s2_F_1258_ATATCCAGTC	AATGATACGGCGACCACCGAGATCTACACATATCCAGTCGCTGGTGCTGCAGCTTATTA
s2_F_1259_GCCTAACTTC	AATGATACGGCGACCACCGAGATCTACACGCCTAACTTCGCTGGTGCTGCAGCTTATTA
s2_F_1260_CATTGTGACA	AATGATACGGCGACCACCGAGATCTACACCATTGTGACAGCTGGTGCTGCAGCTTATTA
s2_F_1261_GTGGTGCAAC	AATGATACGGCGACCACCGAGATCTACACGTGGTGCAACGCTGGTGCTGCAGCTTATTA
s2_F_1262_GGTTACTCGA	AATGATACGGCGACCACCGAGATCTACACGGTTACTCGAGCTGGTGCTGCAGCTTATTA
s2_F_1263_AGGATCACGG	AATGATACGGCGACCACCGAGATCTACACAGGATCACGGGCTGGTGCTGCAGCTTATTA
s2_F_1264_GCCTATATAG	AATGATACGGCGACCACCGAGATCTACACGCCTATATAGGCTGGTGCTGCAGCTTATTA
s2_F_1265_AACGCGGACA	AATGATACGGCGACCACCGAGATCTACACAACGCGGACAGCTGGTGCTGCAGCTTATTA
s2_F_1266_AACACGCTGA	AATGATACGGCGACCACCGAGATCTACACAACACGCTGAGCTGGTGCTGCAGCTTATTA
s2_F_1267_GTCTTGTCTC	AATGATACGGCGACCACCGAGATCTACACGTCTTGTCTCGCTGGTGCTGCAGCTTATTA
s2_F_1268_ACACTCGCGT	AATGATACGGCGACCACCGAGATCTACACACACTCGCGTGCTGGTGCTGCAGCTTATTA
s2_F_1269_CAACGAGTCA	AATGATACGGCGACCACCGAGATCTACACCAACGAGTCAGCTGGTGCTGCAGCTTATTA
s2_F_1270_AGCCAAGTTA	AATGATACGGCGACCACCGAGATCTACACAGCCAAGTTAGCTGGTGCTGCAGCTTATTA
s2_F_1271_AGCTCCTTCG	AATGATACGGCGACCACCGAGATCTACACAGCTCCTTCGGCTGGTGCTGCAGCTTATTA
s2_F_1272_GAGAGACTTC	AATGATACGGCGACCACCGAGATCTACACGAGAGACTTCGCTGGTGCTGCAGCTTATTA
s2_F_1273_TACCAGACGG	AATGATACGGCGACCACCGAGATCTACACTACCAGACGGGCTGGTGCTGCAGCTTATTA
s2_F_1274_CTAAGCCATC	AATGATACGGCGACCACCGAGATCTACACCTAAGCCATCGCTGGTGCTGCAGCTTATTA
s2_F_1275_CCATGAACAG	AATGATACGGCGACCACCGAGATCTACACCCATGAACAGGCTGGTGCTGCAGCTTATTA
s2_F_1276_GAATTGCGGC	AATGATACGGCGACCACCGAGATCTACACGAATTGCGGCGCTGGTGCTGCAGCTTATTA
s2_F_1277_TCGATCAGGC	AATGATACGGCGACCACCGAGATCTACACTCGATCAGGCGCTGGTGCTGCAGCTTATTA
s2_F_1278_TTAGGCTAAG	AATGATACGGCGACCACCGAGATCTACACTTAGGCTAAGGCTGGTGCTGCAGCTTATTA
s2_F_1279_GAAGGTACAG	AATGATACGGCGACCACCGAGATCTACACGAAGGTACAGGCTGGTGCTGCAGCTTATTA
s2_F_1280_CTAGAGGTCG	AATGATACGGCGACCACCGAGATCTACACCTAGAGGTCGGCTGGTGCTGCAGCTTATTA
s2_F_1281_TACAAGGTCG	AATGATACGGCGACCACCGAGATCTACACTACAAGGTCGGCTGGTGCTGCAGCTTATTA
s2_F_1282_AAGGCTCGGA	AATGATACGGCGACCACCGAGATCTACACAAGGCTCGGAGCTGGTGCTGCAGCTTATTA
s2_F_1283_ACAACGCCAG	AATGATACGGCGACCACCGAGATCTACACACAACGCCAGGCTGGTGCTGCAGCTTATTA
s2_F_1284_AGTAAGAACC	AATGATACGGCGACCACCGAGATCTACACAGTAAGAACCGCTGGTGCTGCAGCTTATTA
s2_F_1285_ACGCCAATGA	AATGATACGGCGACCACCGAGATCTACACACGCCAATGAGCTGGTGCTGCAGCTTATTA
s2_F_1286_ACGCCACGTA	AATGATACGGCGACCACCGAGATCTACACACGCCACGTAGCTGGTGCTGCAGCTTATTA
s2_F_1287_CAACATGTCC	AATGATACGGCGACCACCGAGATCTACACCAACATGTCCGCTGGTGCTGCAGCTTATTA
s2_F_1288_ATGCTCACAG	AATGATACGGCGACCACCGAGATCTACACATGCTCACAGGCTGGTGCTGCAGCTTATTA
s2_F_1289_ACTGCTTACA	AATGATACGGCGACCACCGAGATCTACACACTGCTTACAGCTGGTGCTGCAGCTTATTA
s2_F_1290_CGAAGCGCAA	AATGATACGGCGACCACCGAGATCTACACCGAAGCGCAAGCTGGTGCTGCAGCTTATTA
s2_F_1291_GAACACTCGG	AATGATACGGCGACCACCGAGATCTACACGAACACTCGGGCTGGTGCTGCAGCTTATTA
s2_F_1292_TACTACTCGG	AATGATACGGCGACCACCGAGATCTACACTACTACTCGGGCTGGTGCTGCAGCTTATTA
s2_F_1293_CATAGACTCG	AATGATACGGCGACCACCGAGATCTACACCATAGACTCGGCTGGTGCTGCAGCTTATTA
s2_F_1294_GGACAGGTTG	AATGATACGGCGACCACCGAGATCTACACGGACAGGTTGGCTGGTGCTGCAGCTTATTA
s2_F_1295_CAGAAGCAGA	AATGATACGGCGACCACCGAGATCTACACCAGAAGCAGAGCTGGTGCTGCAGCTTATTA
s2_F_1296_AACCGAGGTT	AATGATACGGCGACCACCGAGATCTACACAACCGAGGTTGCTGGTGCTGCAGCTTATTA
s2_F_1297_TTACTGAGTC	AATGATACGGCGACCACCGAGATCTACACTTACTGAGTCGCTGGTGCTGCAGCTTATTA
s2_F_1298_ATAACGGCGG	AATGATACGGCGACCACCGAGATCTACACATAACGGCGGGCTGGTGCTGCAGCTTATTA
s2_F_1299_CATTAGCCAG	AATGATACGGCGACCACCGAGATCTACACCATTAGCCAGGCTGGTGCTGCAGCTTATTA
s2_F_1300_CTCTAATGGC	AATGATACGGCGACCACCGAGATCTACACCTCTAATGGCGCTGGTGCTGCAGCTTATTA
s2_F_1301_GTCAAGCTCG	AATGATACGGCGACCACCGAGATCTACACGTCAAGCTCGGCTGGTGCTGCAGCTTATTA
s2_F_1302_GTTATGCTCC	AATGATACGGCGACCACCGAGATCTACACGTTATGCTCCGCTGGTGCTGCAGCTTATTA
s2_F_1303_AAGTAGATGC	AATGATACGGCGACCACCGAGATCTACACAAGTAGATGCGCTGGTGCTGCAGCTTATTA
s2_F_1304_TGCACTGTAT	AATGATACGGCGACCACCGAGATCTACACTGCACTGTATGCTGGTGCTGCAGCTTATTA
s2_F_1305_AGCACATCAA	AATGATACGGCGACCACCGAGATCTACACAGCACATCAAGCTGGTGCTGCAGCTTATTA
s2_F_1306_ACTAGGCTCG	AATGATACGGCGACCACCGAGATCTACACACTAGGCTCGGCTGGTGCTGCAGCTTATTA
s2_F_1307_CATCTGCTCG	AATGATACGGCGACCACCGAGATCTACACCATCTGCTCGGCTGGTGCTGCAGCTTATTA
s2_F_1308_GCGCAGTGAT	AATGATACGGCGACCACCGAGATCTACACGCGCAGTGATGCTGGTGCTGCAGCTTATTA
s2_F_1309_CATAAGGCTG	AATGATACGGCGACCACCGAGATCTACACCATAAGGCTGGCTGGTGCTGCAGCTTATTA
s2_F_1310_GATCACATGA	AATGATACGGCGACCACCGAGATCTACACGATCACATGAGCTGGTGCTGCAGCTTATTA
s2_F_1311_ACGGTAGTCC	AATGATACGGCGACCACCGAGATCTACACACGGTAGTCCGCTGGTGCTGCAGCTTATTA
s2_F_1312_AAGAGCTATC	AATGATACGGCGACCACCGAGATCTACACAAGAGCTATCGCTGGTGCTGCAGCTTATTA
s2_F_1313_CCTTCGAAGA	AATGATACGGCGACCACCGAGATCTACACCCTTCGAAGAGCTGGTGCTGCAGCTTATTA
s2_F_1314_CCACGAAGGT	AATGATACGGCGACCACCGAGATCTACACCCACGAAGGTGCTGGTGCTGCAGCTTATTA
s2_F_1315_CAAGCGTACC	AATGATACGGCGACCACCGAGATCTACACCAAGCGTACCGCTGGTGCTGCAGCTTATTA
s2_F_1316_CCTTCAGGCT	AATGATACGGCGACCACCGAGATCTACACCCTTCAGGCTGCTGGTGCTGCAGCTTATTA
s2_F_1317_GTGTGTTAAC	AATGATACGGCGACCACCGAGATCTACACGTGTGTTAACGCTGGTGCTGCAGCTTATTA
s2_F_1318_AAGACCGAGC	AATGATACGGCGACCACCGAGATCTACACAAGACCGAGCGCTGGTGCTGCAGCTTATTA
s2_F_1319_GTCGGTTACC	AATGATACGGCGACCACCGAGATCTACACGTCGGTTACCGCTGGTGCTGCAGCTTATTA
s2_F_1320_ATATCGGTCG	AATGATACGGCGACCACCGAGATCTACACATATCGGTCGGCTGGTGCTGCAGCTTATTA
s2_F_1321_GCGAACGGAT	AATGATACGGCGACCACCGAGATCTACACGCGAACGGATGCTGGTGCTGCAGCTTATTA
s2_F_1322_AGAGTGGCTG	AATGATACGGCGACCACCGAGATCTACACAGAGTGGCTGGCTGGTGCTGCAGCTTATTA
s2_F_1323_CAGGAGCATC	AATGATACGGCGACCACCGAGATCTACACCAGGAGCATCGCTGGTGCTGCAGCTTATTA
s2_F_1324_GCCAGACGTT	AATGATACGGCGACCACCGAGATCTACACGCCAGACGTTGCTGGTGCTGCAGCTTATTA
s2_F_1325_TGGCATGCTT	AATGATACGGCGACCACCGAGATCTACACTGGCATGCTTGCTGGTGCTGCAGCTTATTA
s2_F_1326_TAGCGGAGAG	AATGATACGGCGACCACCGAGATCTACACTAGCGGAGAGGCTGGTGCTGCAGCTTATTA
s2_F_1327_CTGAGATGAC	AATGATACGGCGACCACCGAGATCTACACCTGAGATGACGCTGGTGCTGCAGCTTATTA
s2_F_1328_CCGATGTAAC	AATGATACGGCGACCACCGAGATCTACACCCGATGTAACGCTGGTGCTGCAGCTTATTA
s2_F_1329_AGAGATGACA	AATGATACGGCGACCACCGAGATCTACACAGAGATGACAGCTGGTGCTGCAGCTTATTA
s2_F_1330_CAGACCTATA	AATGATACGGCGACCACCGAGATCTACACCAGACCTATAGCTGGTGCTGCAGCTTATTA
s2_F_1331_CTCAGAGTCA	AATGATACGGCGACCACCGAGATCTACACCTCAGAGTCAGCTGGTGCTGCAGCTTATTA
s2_F_1332_AGGTACCATC	AATGATACGGCGACCACCGAGATCTACACAGGTACCATCGCTGGTGCTGCAGCTTATTA
s2_F_1333_TCGATAGACT	AATGATACGGCGACCACCGAGATCTACACTCGATAGACTGCTGGTGCTGCAGCTTATTA
s2_F_1334_ATCTATGGAG	AATGATACGGCGACCACCGAGATCTACACATCTATGGAGGCTGGTGCTGCAGCTTATTA
s2_F_1335_AACGAGAACC	AATGATACGGCGACCACCGAGATCTACACAACGAGAACCGCTGGTGCTGCAGCTTATTA
s2_F_1336_GTTGAACAGC	AATGATACGGCGACCACCGAGATCTACACGTTGAACAGCGCTGGTGCTGCAGCTTATTA
s2_F_1337_AGTTACGACC	AATGATACGGCGACCACCGAGATCTACACAGTTACGACCGCTGGTGCTGCAGCTTATTA
s2_F_1338_CACAACGACC	AATGATACGGCGACCACCGAGATCTACACCACAACGACCGCTGGTGCTGCAGCTTATTA
s2_F_1339_CCTAGTGACC	AATGATACGGCGACCACCGAGATCTACACCCTAGTGACCGCTGGTGCTGCAGCTTATTA
s2_F_1340_GATCCTGACC	AATGATACGGCGACCACCGAGATCTACACGATCCTGACCGCTGGTGCTGCAGCTTATTA
s2_F_1341_TTCCACGACC	AATGATACGGCGACCACCGAGATCTACACTTCCACGACCGCTGGTGCTGCAGCTTATTA
s2_F_1342_TTGTAGGAGC	AATGATACGGCGACCACCGAGATCTACACTTGTAGGAGCGCTGGTGCTGCAGCTTATTA
s2_F_1343_AGGATCAGTC	AATGATACGGCGACCACCGAGATCTACACAGGATCAGTCGCTGGTGCTGCAGCTTATTA
s2_F_1344_ATGCGATCAC	AATGATACGGCGACCACCGAGATCTACACATGCGATCACGCTGGTGCTGCAGCTTATTA
s2_F_1345_TCCGCAATTC	AATGATACGGCGACCACCGAGATCTACACTCCGCAATTCGCTGGTGCTGCAGCTTATTA
s2_F_1346_CATCCTCGTG	AATGATACGGCGACCACCGAGATCTACACCATCCTCGTGGCTGGTGCTGCAGCTTATTA
s2_F_1347_GCTGATTGGC	AATGATACGGCGACCACCGAGATCTACACGCTGATTGGCGCTGGTGCTGCAGCTTATTA
s2_F_1348_GGATAAGATC	AATGATACGGCGACCACCGAGATCTACACGGATAAGATCGCTGGTGCTGCAGCTTATTA
s2_F_1349_AACCAGCCTA	AATGATACGGCGACCACCGAGATCTACACAACCAGCCTAGCTGGTGCTGCAGCTTATTA
s2_F_1350_CCTCGAGAAC	AATGATACGGCGACCACCGAGATCTACACCCTCGAGAACGCTGGTGCTGCAGCTTATTA
s2_F_1351_ACCGGACATC	AATGATACGGCGACCACCGAGATCTACACACCGGACATCGCTGGTGCTGCAGCTTATTA
s2_F_1352_GTGCTGATAC	AATGATACGGCGACCACCGAGATCTACACGTGCTGATACGCTGGTGCTGCAGCTTATTA
s2_F_1353_CGTACCTGGT	AATGATACGGCGACCACCGAGATCTACACCGTACCTGGTGCTGGTGCTGCAGCTTATTA
s2_F_1354_AGGACGCAAT	AATGATACGGCGACCACCGAGATCTACACAGGACGCAATGCTGGTGCTGCAGCTTATTA
s2_F_1355_CCGGAGAACA	AATGATACGGCGACCACCGAGATCTACACCCGGAGAACAGCTGGTGCTGCAGCTTATTA
s2_F_1356_ACGTCTACGT	AATGATACGGCGACCACCGAGATCTACACACGTCTACGTGCTGGTGCTGCAGCTTATTA
s2_F_1357_GCCTACTTGT	AATGATACGGCGACCACCGAGATCTACACGCCTACTTGTGCTGGTGCTGCAGCTTATTA
s2_F_1358_ACATCTGACC	AATGATACGGCGACCACCGAGATCTACACACATCTGACCGCTGGTGCTGCAGCTTATTA
s2_F_1359_CTGACCAACC	AATGATACGGCGACCACCGAGATCTACACCTGACCAACCGCTGGTGCTGCAGCTTATTA
s2_F_1360_TCTGTTCACC	AATGATACGGCGACCACCGAGATCTACACTCTGTTCACCGCTGGTGCTGCAGCTTATTA
s2_F_1361_TACAACGGCT	AATGATACGGCGACCACCGAGATCTACACTACAACGGCTGCTGGTGCTGCAGCTTATTA
s2_F_1362_AACTCTACAG	AATGATACGGCGACCACCGAGATCTACACAACTCTACAGGCTGGTGCTGCAGCTTATTA
s2_F_1363_AGGCATACAG	AATGATACGGCGACCACCGAGATCTACACAGGCATACAGGCTGGTGCTGCAGCTTATTA
s2_F_1364_CCTAGTACAG	AATGATACGGCGACCACCGAGATCTACACCCTAGTACAGGCTGGTGCTGCAGCTTATTA
s2_F_1365_GTCAGTACAG	AATGATACGGCGACCACCGAGATCTACACGTCAGTACAGGCTGGTGCTGCAGCTTATTA
s2_F_1366_CGTCAGAGAC	AATGATACGGCGACCACCGAGATCTACACCGTCAGAGACGCTGGTGCTGCAGCTTATTA
s2_F_1367_ATAGCGGCAA	AATGATACGGCGACCACCGAGATCTACACATAGCGGCAAGCTGGTGCTGCAGCTTATTA
s2_F_1368_AGTATGGAGC	AATGATACGGCGACCACCGAGATCTACACAGTATGGAGCGCTGGTGCTGCAGCTTATTA
s2_F_1369_GACGATATGG	AATGATACGGCGACCACCGAGATCTACACGACGATATGGGCTGGTGCTGCAGCTTATTA
s2_F_1370_ACTCGATACC	AATGATACGGCGACCACCGAGATCTACACACTCGATACCGCTGGTGCTGCAGCTTATTA
s2_F_1371_TACGCCATCC	AATGATACGGCGACCACCGAGATCTACACTACGCCATCCGCTGGTGCTGCAGCTTATTA
s2_F_1372_TCCAATGATC	AATGATACGGCGACCACCGAGATCTACACTCCAATGATCGCTGGTGCTGCAGCTTATTA
s2_F_1373_GACTCGTCAG	AATGATACGGCGACCACCGAGATCTACACGACTCGTCAGGCTGGTGCTGCAGCTTATTA
s2_F_1374_GGATCCAATG	AATGATACGGCGACCACCGAGATCTACACGGATCCAATGGCTGGTGCTGCAGCTTATTA
s2_F_1375_TGTATTCCAC	AATGATACGGCGACCACCGAGATCTACACTGTATTCCACGCTGGTGCTGCAGCTTATTA
s2_F_1376_AGCAAGCTAT	AATGATACGGCGACCACCGAGATCTACACAGCAAGCTATGCTGGTGCTGCAGCTTATTA
s2_F_1377_AACCACCGTG	AATGATACGGCGACCACCGAGATCTACACAACCACCGTGGCTGGTGCTGCAGCTTATTA
s2_F_1378_AGATAACTCG	AATGATACGGCGACCACCGAGATCTACACAGATAACTCGGCTGGTGCTGCAGCTTATTA
s2_F_1379_GGCAGTGGTA	AATGATACGGCGACCACCGAGATCTACACGGCAGTGGTAGCTGGTGCTGCAGCTTATTA
s2_F_1380_AACAAGCTCC	AATGATACGGCGACCACCGAGATCTACACAACAAGCTCCGCTGGTGCTGCAGCTTATTA
s2_F_1381_TGGCAACAAC	AATGATACGGCGACCACCGAGATCTACACTGGCAACAACGCTGGTGCTGCAGCTTATTA
s2_F_1382_CGTGCTACAG	AATGATACGGCGACCACCGAGATCTACACCGTGCTACAGGCTGGTGCTGCAGCTTATTA
s2_F_1383_CAGTCACTCG	AATGATACGGCGACCACCGAGATCTACACCAGTCACTCGGCTGGTGCTGCAGCTTATTA
s2_F_1384_TACCGACTCG	AATGATACGGCGACCACCGAGATCTACACTACCGACTCGGCTGGTGCTGCAGCTTATTA
s2_F_1385_TTGATACTCG	AATGATACGGCGACCACCGAGATCTACACTTGATACTCGGCTGGTGCTGCAGCTTATTA
s2_F_1386_AGCTTAACCG	AATGATACGGCGACCACCGAGATCTACACAGCTTAACCGGCTGGTGCTGCAGCTTATTA
s2_F_1387_AGACAATACC	AATGATACGGCGACCACCGAGATCTACACAGACAATACCGCTGGTGCTGCAGCTTATTA
s2_F_1388_AGGTCAGAAC	AATGATACGGCGACCACCGAGATCTACACAGGTCAGAACGCTGGTGCTGCAGCTTATTA
s2_F_1389_GTATCAGAAC	AATGATACGGCGACCACCGAGATCTACACGTATCAGAACGCTGGTGCTGCAGCTTATTA
s2_F_1390_GGAAGCGAAC	AATGATACGGCGACCACCGAGATCTACACGGAAGCGAACGCTGGTGCTGCAGCTTATTA
s2_F_1391_AGAATGCTGC	AATGATACGGCGACCACCGAGATCTACACAGAATGCTGCGCTGGTGCTGCAGCTTATTA
s2_F_1392_ACGCGGTAAC	AATGATACGGCGACCACCGAGATCTACACACGCGGTAACGCTGGTGCTGCAGCTTATTA
s2_F_1393_TCACTTCAGC	AATGATACGGCGACCACCGAGATCTACACTCACTTCAGCGCTGGTGCTGCAGCTTATTA
s2_F_1394_TTGACTAGCT	AATGATACGGCGACCACCGAGATCTACACTTGACTAGCTGCTGGTGCTGCAGCTTATTA
s2_F_1395_TGCTGTGAGT	AATGATACGGCGACCACCGAGATCTACACTGCTGTGAGTGCTGGTGCTGCAGCTTATTA
s2_F_1396_ACAACCTACC	AATGATACGGCGACCACCGAGATCTACACACAACCTACCGCTGGTGCTGCAGCTTATTA
s2_F_1397_ACGTGCGTAG	AATGATACGGCGACCACCGAGATCTACACACGTGCGTAGGCTGGTGCTGCAGCTTATTA
s2_F_1398_GGTAGATACC	AATGATACGGCGACCACCGAGATCTACACGGTAGATACCGCTGGTGCTGCAGCTTATTA
s2_F_1399_GCTAGTGGTT	AATGATACGGCGACCACCGAGATCTACACGCTAGTGGTTGCTGGTGCTGCAGCTTATTA
s2_F_1400_TCAACAAGTC	AATGATACGGCGACCACCGAGATCTACACTCAACAAGTCGCTGGTGCTGCAGCTTATTA
s2_F_1401_GTTAGCCACC	AATGATACGGCGACCACCGAGATCTACACGTTAGCCACCGCTGGTGCTGCAGCTTATTA
s2_F_1402_ATCCATCACC	AATGATACGGCGACCACCGAGATCTACACATCCATCACCGCTGGTGCTGCAGCTTATTA
s2_F_1403_GATATAGACC	AATGATACGGCGACCACCGAGATCTACACGATATAGACCGCTGGTGCTGCAGCTTATTA
s2_F_1404_GCAATACACC	AATGATACGGCGACCACCGAGATCTACACGCAATACACCGCTGGTGCTGCAGCTTATTA
s2_F_1405_TTACTCTACC	AATGATACGGCGACCACCGAGATCTACACTTACTCTACCGCTGGTGCTGCAGCTTATTA
s2_F_1406_TTCACATACC	AATGATACGGCGACCACCGAGATCTACACTTCACATACCGCTGGTGCTGCAGCTTATTA
s2_F_1407_ACTCGCCTAG	AATGATACGGCGACCACCGAGATCTACACACTCGCCTAGGCTGGTGCTGCAGCTTATTA
s2_F_1408_TATCAAGACG	AATGATACGGCGACCACCGAGATCTACACTATCAAGACGGCTGGTGCTGCAGCTTATTA
s2_F_1409_AATTCGCCTG	AATGATACGGCGACCACCGAGATCTACACAATTCGCCTGGCTGGTGCTGCAGCTTATTA
s2_F_1410_GCTTCGCCTA	AATGATACGGCGACCACCGAGATCTACACGCTTCGCCTAGCTGGTGCTGCAGCTTATTA
s2_F_1411_TGGCTCAGTG	AATGATACGGCGACCACCGAGATCTACACTGGCTCAGTGGCTGGTGCTGCAGCTTATTA
s2_F_1412_AACATCCTAG	AATGATACGGCGACCACCGAGATCTACACAACATCCTAGGCTGGTGCTGCAGCTTATTA
s2_F_1413_CCATCCTCAC	AATGATACGGCGACCACCGAGATCTACACCCATCCTCACGCTGGTGCTGCAGCTTATTA
s2_F_1414_CTTAGGTACC	AATGATACGGCGACCACCGAGATCTACACCTTAGGTACCGCTGGTGCTGCAGCTTATTA
s2_F_1415_AGGCACTCTG	AATGATACGGCGACCACCGAGATCTACACAGGCACTCTGGCTGGTGCTGCAGCTTATTA
s2_F_1416_TGCGCGATAC	AATGATACGGCGACCACCGAGATCTACACTGCGCGATACGCTGGTGCTGCAGCTTATTA
s2_F_1417_GCAGACATGT	AATGATACGGCGACCACCGAGATCTACACGCAGACATGTGCTGGTGCTGCAGCTTATTA
s2_F_1418_ACGGCAGACT	AATGATACGGCGACCACCGAGATCTACACACGGCAGACTGCTGGTGCTGCAGCTTATTA
s2_F_1419_TCTACACAGC	AATGATACGGCGACCACCGAGATCTACACTCTACACAGCGCTGGTGCTGCAGCTTATTA
s2_F_1420_CACATGCTGC	AATGATACGGCGACCACCGAGATCTACACCACATGCTGCGCTGGTGCTGCAGCTTATTA
s2_F_1421_AACCAGTCCG	AATGATACGGCGACCACCGAGATCTACACAACCAGTCCGGCTGGTGCTGCAGCTTATTA
s2_F_1422_GAGGACACAG	AATGATACGGCGACCACCGAGATCTACACGAGGACACAGGCTGGTGCTGCAGCTTATTA
s2_F_1423_AGAAGACTCC	AATGATACGGCGACCACCGAGATCTACACAGAAGACTCCGCTGGTGCTGCAGCTTATTA
s2_F_1424_CCAACGTGAC	AATGATACGGCGACCACCGAGATCTACACCCAACGTGACGCTGGTGCTGCAGCTTATTA
s2_F_1425_GCTGAGTTAC	AATGATACGGCGACCACCGAGATCTACACGCTGAGTTACGCTGGTGCTGCAGCTTATTA
s2_F_1426_CTTAAGCCGG	AATGATACGGCGACCACCGAGATCTACACCTTAAGCCGGGCTGGTGCTGCAGCTTATTA
s2_F_1427_AAGGTGAATC	AATGATACGGCGACCACCGAGATCTACACAAGGTGAATCGCTGGTGCTGCAGCTTATTA
s2_F_1428_AAGAGCGGCT	AATGATACGGCGACCACCGAGATCTACACAAGAGCGGCTGCTGGTGCTGCAGCTTATTA
s2_F_1429_TTCTAGAGCT	AATGATACGGCGACCACCGAGATCTACACTTCTAGAGCTGCTGGTGCTGCAGCTTATTA
s2_F_1430_TCGACATTCC	AATGATACGGCGACCACCGAGATCTACACTCGACATTCCGCTGGTGCTGCAGCTTATTA
s2_F_1431_AATACCGACA	AATGATACGGCGACCACCGAGATCTACACAATACCGACAGCTGGTGCTGCAGCTTATTA
s2_F_1432_CTAATGCGAC	AATGATACGGCGACCACCGAGATCTACACCTAATGCGACGCTGGTGCTGCAGCTTATTA
s2_F_1433_GCCAGTAACC	AATGATACGGCGACCACCGAGATCTACACGCCAGTAACCGCTGGTGCTGCAGCTTATTA
s2_F_1434_TAGCAACGTC	AATGATACGGCGACCACCGAGATCTACACTAGCAACGTCGCTGGTGCTGCAGCTTATTA
s2_F_1435_CAGTTGCGTC	AATGATACGGCGACCACCGAGATCTACACCAGTTGCGTCGCTGGTGCTGCAGCTTATTA
s2_F_1436_ACCAAGAGAC	AATGATACGGCGACCACCGAGATCTACACACCAAGAGACGCTGGTGCTGCAGCTTATTA
s2_F_1437_TTCATGAGAC	AATGATACGGCGACCACCGAGATCTACACTTCATGAGACGCTGGTGCTGCAGCTTATTA
s2_F_1438_AACGAATCAC	AATGATACGGCGACCACCGAGATCTACACAACGAATCACGCTGGTGCTGCAGCTTATTA
s2_F_1439_TCACGTCCAC	AATGATACGGCGACCACCGAGATCTACACTCACGTCCACGCTGGTGCTGCAGCTTATTA
s2_F_1440_CGACAACGCT	AATGATACGGCGACCACCGAGATCTACACCGACAACGCTGCTGGTGCTGCAGCTTATTA
s2_F_1441_CACTGCATCC	AATGATACGGCGACCACCGAGATCTACACCACTGCATCCGCTGGTGCTGCAGCTTATTA
s2_F_1442_TGAGCATACC	AATGATACGGCGACCACCGAGATCTACACTGAGCATACCGCTGGTGCTGCAGCTTATTA
s2_F_1443_TGAGGTGATC	AATGATACGGCGACCACCGAGATCTACACTGAGGTGATCGCTGGTGCTGCAGCTTATTA
s2_F_1444_GGCTCATAGC	AATGATACGGCGACCACCGAGATCTACACGGCTCATAGCGCTGGTGCTGCAGCTTATTA
s2_F_1445_TTGGCAAGGC	AATGATACGGCGACCACCGAGATCTACACTTGGCAAGGCGCTGGTGCTGCAGCTTATTA
s2_F_1446_CGCATGGCTT	AATGATACGGCGACCACCGAGATCTACACCGCATGGCTTGCTGGTGCTGCAGCTTATTA
s2_F_1447_TAACGCCACG	AATGATACGGCGACCACCGAGATCTACACTAACGCCACGGCTGGTGCTGCAGCTTATTA
s2_F_1448_TTGAGACGTC	AATGATACGGCGACCACCGAGATCTACACTTGAGACGTCGCTGGTGCTGCAGCTTATTA
s2_F_1449_ATCTCAAGTG	AATGATACGGCGACCACCGAGATCTACACATCTCAAGTGGCTGGTGCTGCAGCTTATTA
s2_F_1450_AGGAACTGAC	AATGATACGGCGACCACCGAGATCTACACAGGAACTGACGCTGGTGCTGCAGCTTATTA
s2_F_1451_AGTACTGAAC	AATGATACGGCGACCACCGAGATCTACACAGTACTGAACGCTGGTGCTGCAGCTTATTA
s2_F_1452_GACGTGTTAC	AATGATACGGCGACCACCGAGATCTACACGACGTGTTACGCTGGTGCTGCAGCTTATTA
s2_F_1453_TGAGATCAGT	AATGATACGGCGACCACCGAGATCTACACTGAGATCAGTGCTGGTGCTGCAGCTTATTA
s2_F_1454_TGAGCGCTTA	AATGATACGGCGACCACCGAGATCTACACTGAGCGCTTAGCTGGTGCTGCAGCTTATTA
s2_F_1455_GAGTACAAGC	AATGATACGGCGACCACCGAGATCTACACGAGTACAAGCGCTGGTGCTGCAGCTTATTA
s2_F_1456_GATCGCAGTC	AATGATACGGCGACCACCGAGATCTACACGATCGCAGTCGCTGGTGCTGCAGCTTATTA
s2_F_1457_TTAAGGCCAC	AATGATACGGCGACCACCGAGATCTACACTTAAGGCCACGCTGGTGCTGCAGCTTATTA
s2_F_1458_CAAGATTCAC	AATGATACGGCGACCACCGAGATCTACACCAAGATTCACGCTGGTGCTGCAGCTTATTA
s2_F_1459_CTATCAGCAA	AATGATACGGCGACCACCGAGATCTACACCTATCAGCAAGCTGGTGCTGCAGCTTATTA
s2_F_1460_TATGGCACGT	AATGATACGGCGACCACCGAGATCTACACTATGGCACGTGCTGGTGCTGCAGCTTATTA
s2_F_1461_CGTTAGGACA	AATGATACGGCGACCACCGAGATCTACACCGTTAGGACAGCTGGTGCTGCAGCTTATTA
s2_F_1462_GACCTGGACA	AATGATACGGCGACCACCGAGATCTACACGACCTGGACAGCTGGTGCTGCAGCTTATTA
s2_F_1463_GATGAGGACA	AATGATACGGCGACCACCGAGATCTACACGATGAGGACAGCTGGTGCTGCAGCTTATTA
s2_F_1464_GCGATGGACA	AATGATACGGCGACCACCGAGATCTACACGCGATGGACAGCTGGTGCTGCAGCTTATTA
s2_F_1465_GGCCACTAAC	AATGATACGGCGACCACCGAGATCTACACGGCCACTAACGCTGGTGCTGCAGCTTATTA
s2_F_1466_GTAAGACCTC	AATGATACGGCGACCACCGAGATCTACACGTAAGACCTCGCTGGTGCTGCAGCTTATTA
s2_F_1467_GCTGTTATCC	AATGATACGGCGACCACCGAGATCTACACGCTGTTATCCGCTGGTGCTGCAGCTTATTA
s2_F_1468_ATCCACAGTC	AATGATACGGCGACCACCGAGATCTACACATCCACAGTCGCTGGTGCTGCAGCTTATTA
s2_F_1469_GACAACGGAC	AATGATACGGCGACCACCGAGATCTACACGACAACGGACGCTGGTGCTGCAGCTTATTA
s2_F_1470_AGTTCTCAGC	AATGATACGGCGACCACCGAGATCTACACAGTTCTCAGCGCTGGTGCTGCAGCTTATTA
s2_F_1471_ACTTGGTCGG	AATGATACGGCGACCACCGAGATCTACACACTTGGTCGGGCTGGTGCTGCAGCTTATTA
s2_F_1472_AAGGTCGTGC	AATGATACGGCGACCACCGAGATCTACACAAGGTCGTGCGCTGGTGCTGCAGCTTATTA
s2_F_1473_GTTACTGACA	AATGATACGGCGACCACCGAGATCTACACGTTACTGACAGCTGGTGCTGCAGCTTATTA
s2_F_1474_GCTGCCATAG	AATGATACGGCGACCACCGAGATCTACACGCTGCCATAGGCTGGTGCTGCAGCTTATTA
s2_F_1475_CGCGCCAATT	AATGATACGGCGACCACCGAGATCTACACCGCGCCAATTGCTGGTGCTGCAGCTTATTA
s2_F_1476_ACCAGGTGAG	AATGATACGGCGACCACCGAGATCTACACACCAGGTGAGGCTGGTGCTGCAGCTTATTA
s2_F_1477_TTACGAGACT	AATGATACGGCGACCACCGAGATCTACACTTACGAGACTGCTGGTGCTGCAGCTTATTA
s2_F_1478_AGAACCTCAC	AATGATACGGCGACCACCGAGATCTACACAGAACCTCACGCTGGTGCTGCAGCTTATTA
s2_F_1479_TCAGACATAC	AATGATACGGCGACCACCGAGATCTACACTCAGACATACGCTGGTGCTGCAGCTTATTA
s2_F_1480_GCGCTAATTG	AATGATACGGCGACCACCGAGATCTACACGCGCTAATTGGCTGGTGCTGCAGCTTATTA
s2_F_1481_GAATGTCAGC	AATGATACGGCGACCACCGAGATCTACACGAATGTCAGCGCTGGTGCTGCAGCTTATTA
s2_F_1482_TTCTTGGTGC	AATGATACGGCGACCACCGAGATCTACACTTCTTGGTGCGCTGGTGCTGCAGCTTATTA
s2_F_1483_CACAGCAATC	AATGATACGGCGACCACCGAGATCTACACCACAGCAATCGCTGGTGCTGCAGCTTATTA
s2_F_1484_ACCGTAACAC	AATGATACGGCGACCACCGAGATCTACACACCGTAACACGCTGGTGCTGCAGCTTATTA
s2_F_1485_TTAGACGCCA	AATGATACGGCGACCACCGAGATCTACACTTAGACGCCAGCTGGTGCTGCAGCTTATTA
s2_F_1486_CACTTCCACC	AATGATACGGCGACCACCGAGATCTACACCACTTCCACCGCTGGTGCTGCAGCTTATTA
s2_F_1487_TAGTACCACC	AATGATACGGCGACCACCGAGATCTACACTAGTACCACCGCTGGTGCTGCAGCTTATTA
s2_F_1488_TCAACCTCCG	AATGATACGGCGACCACCGAGATCTACACTCAACCTCCGGCTGGTGCTGCAGCTTATTA
s2_F_1489_ACAGTGCCAC	AATGATACGGCGACCACCGAGATCTACACACAGTGCCACGCTGGTGCTGCAGCTTATTA
s2_F_1490_ATTCTTCCAC	AATGATACGGCGACCACCGAGATCTACACATTCTTCCACGCTGGTGCTGCAGCTTATTA
s2_F_1491_CAGGTTATAC	AATGATACGGCGACCACCGAGATCTACACCAGGTTATACGCTGGTGCTGCAGCTTATTA
s2_F_1492_CCACTCACAC	AATGATACGGCGACCACCGAGATCTACACCCACTCACACGCTGGTGCTGCAGCTTATTA
s2_F_1493_CGATTGTCAC	AATGATACGGCGACCACCGAGATCTACACCGATTGTCACGCTGGTGCTGCAGCTTATTA
s2_F_1494_GACGAACTAC	AATGATACGGCGACCACCGAGATCTACACGACGAACTACGCTGGTGCTGCAGCTTATTA
s2_F_1495_GCCAGATCAC	AATGATACGGCGACCACCGAGATCTACACGCCAGATCACGCTGGTGCTGCAGCTTATTA
s2_F_1496_GTTCAGTCAC	AATGATACGGCGACCACCGAGATCTACACGTTCAGTCACGCTGGTGCTGCAGCTTATTA
s2_F_1497_TTAACCACAC	AATGATACGGCGACCACCGAGATCTACACTTAACCACACGCTGGTGCTGCAGCTTATTA
s2_F_1498_CCAAGAGGTC	AATGATACGGCGACCACCGAGATCTACACCCAAGAGGTCGCTGGTGCTGCAGCTTATTA
s2_F_1499_GCAGCTTCAA	AATGATACGGCGACCACCGAGATCTACACGCAGCTTCAAGCTGGTGCTGCAGCTTATTA
s2_F_1500_TTGGCGAATC	AATGATACGGCGACCACCGAGATCTACACTTGGCGAATCGCTGGTGCTGCAGCTTATTA
s2_F_1501_AGTAGGCGTG	AATGATACGGCGACCACCGAGATCTACACAGTAGGCGTGGCTGGTGCTGCAGCTTATTA
s2_F_1502_CGATATCACC	AATGATACGGCGACCACCGAGATCTACACCGATATCACCGCTGGTGCTGCAGCTTATTA
s2_F_1503_TGAACTCACC	AATGATACGGCGACCACCGAGATCTACACTGAACTCACCGCTGGTGCTGCAGCTTATTA
s2_F_1504_TTCGCTGATT	AATGATACGGCGACCACCGAGATCTACACTTCGCTGATTGCTGGTGCTGCAGCTTATTA
s2_F_1505_TCGTTACGTC	AATGATACGGCGACCACCGAGATCTACACTCGTTACGTCGCTGGTGCTGCAGCTTATTA
s2_F_1506_ACACAACGGT	AATGATACGGCGACCACCGAGATCTACACACACAACGGTGCTGGTGCTGCAGCTTATTA
s2_F_1507_GCCTAACGGT	AATGATACGGCGACCACCGAGATCTACACGCCTAACGGTGCTGGTGCTGCAGCTTATTA
s2_F_1508_GCTTATGAGC	AATGATACGGCGACCACCGAGATCTACACGCTTATGAGCGCTGGTGCTGCAGCTTATTA
s2_F_1509_ATTGCATGCT	AATGATACGGCGACCACCGAGATCTACACATTGCATGCTGCTGGTGCTGCAGCTTATTA
s2_F_1510_TTCGCCTCGA	AATGATACGGCGACCACCGAGATCTACACTTCGCCTCGAGCTGGTGCTGCAGCTTATTA
s2_F_1511_AAGTGGCGAC	AATGATACGGCGACCACCGAGATCTACACAAGTGGCGACGCTGGTGCTGCAGCTTATTA
s2_F_1512_GGATTGGACG	AATGATACGGCGACCACCGAGATCTACACGGATTGGACGGCTGGTGCTGCAGCTTATTA
s2_F_1513_GAGCTGCTGT	AATGATACGGCGACCACCGAGATCTACACGAGCTGCTGTGCTGGTGCTGCAGCTTATTA
s2_F_1514_AGCAGTCCTG	AATGATACGGCGACCACCGAGATCTACACAGCAGTCCTGGCTGGTGCTGCAGCTTATTA
s2_F_1515_CTGTTAGAAC	AATGATACGGCGACCACCGAGATCTACACCTGTTAGAACGCTGGTGCTGCAGCTTATTA
s2_F_1516_GAGATACCAC	AATGATACGGCGACCACCGAGATCTACACGAGATACCACGCTGGTGCTGCAGCTTATTA
s2_F_1517_GATAAGGAAC	AATGATACGGCGACCACCGAGATCTACACGATAAGGAACGCTGGTGCTGCAGCTTATTA
s2_F_1518_TAGTGACTAC	AATGATACGGCGACCACCGAGATCTACACTAGTGACTACGCTGGTGCTGCAGCTTATTA
s2_F_1519_ACCAGTGGAT	AATGATACGGCGACCACCGAGATCTACACACCAGTGGATGCTGGTGCTGCAGCTTATTA
s2_F_1520_TTAGTCAGCT	AATGATACGGCGACCACCGAGATCTACACTTAGTCAGCTGCTGGTGCTGCAGCTTATTA
s2_F_1521_ATTCTTGTGG	AATGATACGGCGACCACCGAGATCTACACATTCTTGTGGGCTGGTGCTGCAGCTTATTA
s2_F_1522_CACGATAGTC	AATGATACGGCGACCACCGAGATCTACACCACGATAGTCGCTGGTGCTGCAGCTTATTA
s2_F_1523_CATGTCAGTC	AATGATACGGCGACCACCGAGATCTACACCATGTCAGTCGCTGGTGCTGCAGCTTATTA
s2_F_1524_CTAGCCTCAG	AATGATACGGCGACCACCGAGATCTACACCTAGCCTCAGGCTGGTGCTGCAGCTTATTA
s2_F_1525_GCCACAGCAA	AATGATACGGCGACCACCGAGATCTACACGCCACAGCAAGCTGGTGCTGCAGCTTATTA
s2_F_1526_AAGATACACC	AATGATACGGCGACCACCGAGATCTACACAAGATACACCGCTGGTGCTGCAGCTTATTA
s2_F_1527_CATCAATACC	AATGATACGGCGACCACCGAGATCTACACCATCAATACCGCTGGTGCTGCAGCTTATTA
s2_F_1528_GACTAGTACC	AATGATACGGCGACCACCGAGATCTACACGACTAGTACCGCTGGTGCTGCAGCTTATTA
s2_F_1529_ACAGCCTCTG	AATGATACGGCGACCACCGAGATCTACACACAGCCTCTGGCTGGTGCTGCAGCTTATTA
s2_F_1530_TTGACAGACA	AATGATACGGCGACCACCGAGATCTACACTTGACAGACAGCTGGTGCTGCAGCTTATTA
s2_F_1531_ACGCATTCTC	AATGATACGGCGACCACCGAGATCTACACACGCATTCTCGCTGGTGCTGCAGCTTATTA
s2_F_1532_ACCGAAGACA	AATGATACGGCGACCACCGAGATCTACACACCGAAGACAGCTGGTGCTGCAGCTTATTA
s2_F_1533_ACATTGAGAC	AATGATACGGCGACCACCGAGATCTACACACATTGAGACGCTGGTGCTGCAGCTTATTA
s2_F_1534_ATAACGAGAC	AATGATACGGCGACCACCGAGATCTACACATAACGAGACGCTGGTGCTGCAGCTTATTA
s2_F_1535_CATAGAGGAC	AATGATACGGCGACCACCGAGATCTACACCATAGAGGACGCTGGTGCTGCAGCTTATTA
s2_F_1536_CGTTATACAC	AATGATACGGCGACCACCGAGATCTACACCGTTATACACGCTGGTGCTGCAGCTTATTA
s2_F_1537_TAGGCCTCAC	AATGATACGGCGACCACCGAGATCTACACTAGGCCTCACGCTGGTGCTGCAGCTTATTA
s2_F_1538_CATCACGCTA	AATGATACGGCGACCACCGAGATCTACACCATCACGCTAGCTGGTGCTGCAGCTTATTA
s2_F_1539_TAAGTAGGAC	AATGATACGGCGACCACCGAGATCTACACTAAGTAGGACGCTGGTGCTGCAGCTTATTA
s2_F_1540_TATCTAAGGC	AATGATACGGCGACCACCGAGATCTACACTATCTAAGGCGCTGGTGCTGCAGCTTATTA
s2_F_1541_GAGAGAGACT	AATGATACGGCGACCACCGAGATCTACACGAGAGAGACTGCTGGTGCTGCAGCTTATTA
s2_F_1542_TTGGCCGACT	AATGATACGGCGACCACCGAGATCTACACTTGGCCGACTGCTGGTGCTGCAGCTTATTA
s2_F_1543_CAGAACGTTC	AATGATACGGCGACCACCGAGATCTACACCAGAACGTTCGCTGGTGCTGCAGCTTATTA
s2_F_1544_GTCGCAAGTA	AATGATACGGCGACCACCGAGATCTACACGTCGCAAGTAGCTGGTGCTGCAGCTTATTA
s2_F_1545_CTGCCTTCAC	AATGATACGGCGACCACCGAGATCTACACCTGCCTTCACGCTGGTGCTGCAGCTTATTA
s2_F_1546_GGTTCCGCAT	AATGATACGGCGACCACCGAGATCTACACGGTTCCGCATGCTGGTGCTGCAGCTTATTA
s2_F_1547_GGATGGTATC	AATGATACGGCGACCACCGAGATCTACACGGATGGTATCGCTGGTGCTGCAGCTTATTA
s2_F_1548_ATCTGATGCC	AATGATACGGCGACCACCGAGATCTACACATCTGATGCCGCTGGTGCTGCAGCTTATTA
s2_F_1549_AACTGCTACC	AATGATACGGCGACCACCGAGATCTACACAACTGCTACCGCTGGTGCTGCAGCTTATTA
s2_F_1550_TTGGATACAG	AATGATACGGCGACCACCGAGATCTACACTTGGATACAGGCTGGTGCTGCAGCTTATTA
s2_F_1551_TTGGAGTCTC	AATGATACGGCGACCACCGAGATCTACACTTGGAGTCTCGCTGGTGCTGCAGCTTATTA
s2_F_1552_TCCAGTAGAC	AATGATACGGCGACCACCGAGATCTACACTCCAGTAGACGCTGGTGCTGCAGCTTATTA
s2_F_1553_CGGTTGCCTT	AATGATACGGCGACCACCGAGATCTACACCGGTTGCCTTGCTGGTGCTGCAGCTTATTA
s2_F_1554_CACAGATGCC	AATGATACGGCGACCACCGAGATCTACACCACAGATGCCGCTGGTGCTGCAGCTTATTA
s2_F_1555_ACACACAGAC	AATGATACGGCGACCACCGAGATCTACACACACACAGACGCTGGTGCTGCAGCTTATTA
s2_F_1556_GCCTGGATTC	AATGATACGGCGACCACCGAGATCTACACGCCTGGATTCGCTGGTGCTGCAGCTTATTA
s2_F_1557_TCACGTGGTT	AATGATACGGCGACCACCGAGATCTACACTCACGTGGTTGCTGGTGCTGCAGCTTATTA
s2_F_1558_GCTGCGATCA	AATGATACGGCGACCACCGAGATCTACACGCTGCGATCAGCTGGTGCTGCAGCTTATTA
s2_F_1559_TTCATCGATC	AATGATACGGCGACCACCGAGATCTACACTTCATCGATCGCTGGTGCTGCAGCTTATTA
s2_F_1560_AGCAAGATGC	AATGATACGGCGACCACCGAGATCTACACAGCAAGATGCGCTGGTGCTGCAGCTTATTA
s2_F_1561_AGCCAATTGC	AATGATACGGCGACCACCGAGATCTACACAGCCAATTGCGCTGGTGCTGCAGCTTATTA
s2_F_1562_GATATCAGCT	AATGATACGGCGACCACCGAGATCTACACGATATCAGCTGCTGGTGCTGCAGCTTATTA
s2_F_1563_ACTACTAGAC	AATGATACGGCGACCACCGAGATCTACACACTACTAGACGCTGGTGCTGCAGCTTATTA
s2_F_1564_GCGACTGAAC	AATGATACGGCGACCACCGAGATCTACACGCGACTGAACGCTGGTGCTGCAGCTTATTA
s2_F_1565_AACAACGAGA	AATGATACGGCGACCACCGAGATCTACACAACAACGAGAGCTGGTGCTGCAGCTTATTA
s2_F_1566_AACACAGTAG	AATGATACGGCGACCACCGAGATCTACACAACACAGTAGGCTGGTGCTGCAGCTTATTA
s2_F_1567_AACACCATTG	AATGATACGGCGACCACCGAGATCTACACAACACCATTGGCTGGTGCTGCAGCTTATTA
s2_F_1568_AACACGTCCA	AATGATACGGCGACCACCGAGATCTACACAACACGTCCAGCTGGTGCTGCAGCTTATTA
s2_F_1569_AACAGGATTC	AATGATACGGCGACCACCGAGATCTACACAACAGGATTCGCTGGTGCTGCAGCTTATTA
s2_F_1570_AACATCAAGC	AATGATACGGCGACCACCGAGATCTACACAACATCAAGCGCTGGTGCTGCAGCTTATTA
s2_F_1571_AACATGCAGT	AATGATACGGCGACCACCGAGATCTACACAACATGCAGTGCTGGTGCTGCAGCTTATTA
s2_F_1572_AACCAACCAG	AATGATACGGCGACCACCGAGATCTACACAACCAACCAGGCTGGTGCTGCAGCTTATTA
s2_F_1573_AACCAATAGG	AATGATACGGCGACCACCGAGATCTACACAACCAATAGGGCTGGTGCTGCAGCTTATTA
s2_F_1574_AACCAGCGAT	AATGATACGGCGACCACCGAGATCTACACAACCAGCGATGCTGGTGCTGCAGCTTATTA
s2_F_1575_AACCGAATGC	AATGATACGGCGACCACCGAGATCTACACAACCGAATGCGCTGGTGCTGCAGCTTATTA
s2_F_1576_AACCGATCGT	AATGATACGGCGACCACCGAGATCTACACAACCGATCGTGCTGGTGCTGCAGCTTATTA
s2_F_1577_AACCTGAAGG	AATGATACGGCGACCACCGAGATCTACACAACCTGAAGGGCTGGTGCTGCAGCTTATTA
s2_F_1578_AACCTTAGAG	AATGATACGGCGACCACCGAGATCTACACAACCTTAGAGGCTGGTGCTGCAGCTTATTA
s2_F_1579_AACGAACCGT	AATGATACGGCGACCACCGAGATCTACACAACGAACCGTGCTGGTGCTGCAGCTTATTA
s2_F_1580_AACGACAGAA	AATGATACGGCGACCACCGAGATCTACACAACGACAGAAGCTGGTGCTGCAGCTTATTA
s2_F_1581_AACGACCACA	AATGATACGGCGACCACCGAGATCTACACAACGACCACAGCTGGTGCTGCAGCTTATTA
s2_F_1582_AACGACTCCT	AATGATACGGCGACCACCGAGATCTACACAACGACTCCTGCTGGTGCTGCAGCTTATTA
s2_F_1583_AACGAGTTAG	AATGATACGGCGACCACCGAGATCTACACAACGAGTTAGGCTGGTGCTGCAGCTTATTA
s2_F_1584_AACGATTCTG	AATGATACGGCGACCACCGAGATCTACACAACGATTCTGGCTGGTGCTGCAGCTTATTA
s2_F_1585_AACGCACAAC	AATGATACGGCGACCACCGAGATCTACACAACGCACAACGCTGGTGCTGCAGCTTATTA
s2_F_1586_AACTACATGG	AATGATACGGCGACCACCGAGATCTACACAACTACATGGGCTGGTGCTGCAGCTTATTA
s2_F_1587_AACTACGTCT	AATGATACGGCGACCACCGAGATCTACACAACTACGTCTGCTGGTGCTGCAGCTTATTA
s2_F_1588_AACTAGAGAG	AATGATACGGCGACCACCGAGATCTACACAACTAGAGAGGCTGGTGCTGCAGCTTATTA
s2_F_1589_AACTCACCTT	AATGATACGGCGACCACCGAGATCTACACAACTCACCTTGCTGGTGCTGCAGCTTATTA
s2_F_1590_AACTGCCTTC	AATGATACGGCGACCACCGAGATCTACACAACTGCCTTCGCTGGTGCTGCAGCTTATTA
s2_F_1591_AACTGGATGA	AATGATACGGCGACCACCGAGATCTACACAACTGGATGAGCTGGTGCTGCAGCTTATTA
s2_F_1592_AACTGGCCAT	AATGATACGGCGACCACCGAGATCTACACAACTGGCCATGCTGGTGCTGCAGCTTATTA
s2_F_1593_AAGAACCTCT	AATGATACGGCGACCACCGAGATCTACACAAGAACCTCTGCTGGTGCTGCAGCTTATTA
s2_F_1594_AAGAAGGATG	AATGATACGGCGACCACCGAGATCTACACAAGAAGGATGGCTGGTGCTGCAGCTTATTA
s2_F_1595_AAGACCAGGA	AATGATACGGCGACCACCGAGATCTACACAAGACCAGGAGCTGGTGCTGCAGCTTATTA
s2_F_1596_AAGACTGACT	AATGATACGGCGACCACCGAGATCTACACAAGACTGACTGCTGGTGCTGCAGCTTATTA
s2_F_1597_AAGAGACCAA	AATGATACGGCGACCACCGAGATCTACACAAGAGACCAAGCTGGTGCTGCAGCTTATTA
s2_F_1598_AAGAGTAGGT	AATGATACGGCGACCACCGAGATCTACACAAGAGTAGGTGCTGGTGCTGCAGCTTATTA
s2_F_1599_AAGCAAGTTG	AATGATACGGCGACCACCGAGATCTACACAAGCAAGTTGGCTGGTGCTGCAGCTTATTA
s2_F_1600_AAGCACTGAG	AATGATACGGCGACCACCGAGATCTACACAAGCACTGAGGCTGGTGCTGCAGCTTATTA
s2_F_1601_AAGCCAGATT	AATGATACGGCGACCACCGAGATCTACACAAGCCAGATTGCTGGTGCTGCAGCTTATTA
s2_F_1602_AAGGACACGA	AATGATACGGCGACCACCGAGATCTACACAAGGACACGAGCTGGTGCTGCAGCTTATTA
s2_F_1603_AAGGACGTAA	AATGATACGGCGACCACCGAGATCTACACAAGGACGTAAGCTGGTGCTGCAGCTTATTA
s2_F_1604_AAGGATGAGA	AATGATACGGCGACCACCGAGATCTACACAAGGATGAGAGCTGGTGCTGCAGCTTATTA
s2_F_1605_AAGGATTCCA	AATGATACGGCGACCACCGAGATCTACACAAGGATTCCAGCTGGTGCTGCAGCTTATTA
s2_F_1606_AAGGCAACCT	AATGATACGGCGACCACCGAGATCTACACAAGGCAACCTGCTGGTGCTGCAGCTTATTA
s2_F_1607_AAGGCAGGAA	AATGATACGGCGACCACCGAGATCTACACAAGGCAGGAAGCTGGTGCTGCAGCTTATTA
s2_F_1608_AAGGCATAGT	AATGATACGGCGACCACCGAGATCTACACAAGGCATAGTGCTGGTGCTGCAGCTTATTA
s2_F_1609_AAGGCTCATT	AATGATACGGCGACCACCGAGATCTACACAAGGCTCATTGCTGGTGCTGCAGCTTATTA
s2_F_1610_AAGTAACGTG	AATGATACGGCGACCACCGAGATCTACACAAGTAACGTGGCTGGTGCTGCAGCTTATTA
s2_F_1611_AAGTCTCAGG	AATGATACGGCGACCACCGAGATCTACACAAGTCTCAGGGCTGGTGCTGCAGCTTATTA
s2_F_1612_AAGTTCGAGA	AATGATACGGCGACCACCGAGATCTACACAAGTTCGAGAGCTGGTGCTGCAGCTTATTA
s2_F_1613_AATACACTCC	AATGATACGGCGACCACCGAGATCTACACAATACACTCCGCTGGTGCTGCAGCTTATTA
s2_F_1614_AATCCATCTG	AATGATACGGCGACCACCGAGATCTACACAATCCATCTGGCTGGTGCTGCAGCTTATTA
s2_F_1615_AATCCGTTCT	AATGATACGGCGACCACCGAGATCTACACAATCCGTTCTGCTGGTGCTGCAGCTTATTA
s2_F_1616_AATCGAGTCT	AATGATACGGCGACCACCGAGATCTACACAATCGAGTCTGCTGGTGCTGCAGCTTATTA
s2_F_1617_AATCGTCCAT	AATGATACGGCGACCACCGAGATCTACACAATCGTCCATGCTGGTGCTGCAGCTTATTA
s2_F_1618_AATCGTCTTG	AATGATACGGCGACCACCGAGATCTACACAATCGTCTTGGCTGGTGCTGCAGCTTATTA
s2_F_1619_AATCTGTCGT	AATGATACGGCGACCACCGAGATCTACACAATCTGTCGTGCTGGTGCTGCAGCTTATTA
s2_F_1620_AATGAACGAC	AATGATACGGCGACCACCGAGATCTACACAATGAACGACGCTGGTGCTGCAGCTTATTA
s2_F_1621_AATGAGCAAG	AATGATACGGCGACCACCGAGATCTACACAATGAGCAAGGCTGGTGCTGCAGCTTATTA
s2_F_1622_AATGCGAAGA	AATGATACGGCGACCACCGAGATCTACACAATGCGAAGAGCTGGTGCTGCAGCTTATTA
s2_F_1623_AATGCTGAGT	AATGATACGGCGACCACCGAGATCTACACAATGCTGAGTGCTGGTGCTGCAGCTTATTA
s2_F_1624_AATGCTGTTG	AATGATACGGCGACCACCGAGATCTACACAATGCTGTTGGCTGGTGCTGCAGCTTATTA
s2_F_1625_AATTACCAGG	AATGATACGGCGACCACCGAGATCTACACAATTACCAGGGCTGGTGCTGCAGCTTATTA
s2_F_1626_AATTGCCACT	AATGATACGGCGACCACCGAGATCTACACAATTGCCACTGCTGGTGCTGCAGCTTATTA
s2_F_1627_ACAACCTCGA	AATGATACGGCGACCACCGAGATCTACACACAACCTCGAGCTGGTGCTGCAGCTTATTA
s2_F_1628_ACAACGAATG	AATGATACGGCGACCACCGAGATCTACACACAACGAATGGCTGGTGCTGCAGCTTATTA
s2_F_1629_ACAACTTAGG	AATGATACGGCGACCACCGAGATCTACACACAACTTAGGGCTGGTGCTGCAGCTTATTA
s2_F_1630_ACAACTTGCT	AATGATACGGCGACCACCGAGATCTACACACAACTTGCTGCTGGTGCTGCAGCTTATTA
s2_F_1631_ACAAGCCACT	AATGATACGGCGACCACCGAGATCTACACACAAGCCACTGCTGGTGCTGCAGCTTATTA
s2_F_1632_ACAAGCCTAA	AATGATACGGCGACCACCGAGATCTACACACAAGCCTAAGCTGGTGCTGCAGCTTATTA
s2_F_1633_ACAAGTAGGA	AATGATACGGCGACCACCGAGATCTACACACAAGTAGGAGCTGGTGCTGCAGCTTATTA
s2_F_1634_ACAAGTCTTG	AATGATACGGCGACCACCGAGATCTACACACAAGTCTTGGCTGGTGCTGCAGCTTATTA
s2_F_1635_ACAAGTTCAG	AATGATACGGCGACCACCGAGATCTACACACAAGTTCAGGCTGGTGCTGCAGCTTATTA
s2_F_1636_ACAATGGTTG	AATGATACGGCGACCACCGAGATCTACACACAATGGTTGGCTGGTGCTGCAGCTTATTA
s2_F_1637_ACACAGGCAA	AATGATACGGCGACCACCGAGATCTACACACACAGGCAAGCTGGTGCTGCAGCTTATTA
s2_F_1638_ACACATGAGA	AATGATACGGCGACCACCGAGATCTACACACACATGAGAGCTGGTGCTGCAGCTTATTA
s2_F_1639_ACACATGCCT	AATGATACGGCGACCACCGAGATCTACACACACATGCCTGCTGGTGCTGCAGCTTATTA
s2_F_1640_ACACCATATC	AATGATACGGCGACCACCGAGATCTACACACACCATATCGCTGGTGCTGCAGCTTATTA
s2_F_1641_ACACCTGATG	AATGATACGGCGACCACCGAGATCTACACACACCTGATGGCTGGTGCTGCAGCTTATTA
s2_F_1642_ACACTCAGGA	AATGATACGGCGACCACCGAGATCTACACACACTCAGGAGCTGGTGCTGCAGCTTATTA
s2_F_1643_ACACTGTCTG	AATGATACGGCGACCACCGAGATCTACACACACTGTCTGGCTGGTGCTGCAGCTTATTA
s2_F_1644_ACACTTCCAA	AATGATACGGCGACCACCGAGATCTACACACACTTCCAAGCTGGTGCTGCAGCTTATTA
s2_F_1645_ACAGAACAGG	AATGATACGGCGACCACCGAGATCTACACACAGAACAGGGCTGGTGCTGCAGCTTATTA
s2_F_1646_ACAGATCCTA	AATGATACGGCGACCACCGAGATCTACACACAGATCCTAGCTGGTGCTGCAGCTTATTA
s2_F_1647_ACAGGACTGC	AATGATACGGCGACCACCGAGATCTACACACAGGACTGCGCTGGTGCTGCAGCTTATTA
s2_F_1648_ACATAGCGAG	AATGATACGGCGACCACCGAGATCTACACACATAGCGAGGCTGGTGCTGCAGCTTATTA
s2_F_1649_ACATAGTAGC	AATGATACGGCGACCACCGAGATCTACACACATAGTAGCGCTGGTGCTGCAGCTTATTA
s2_F_1650_ACATCCGTGA	AATGATACGGCGACCACCGAGATCTACACACATCCGTGAGCTGGTGCTGCAGCTTATTA
s2_F_1651_ACATTCCATC	AATGATACGGCGACCACCGAGATCTACACACATTCCATCGCTGGTGCTGCAGCTTATTA
s2_F_1652_ACATTGGCGA	AATGATACGGCGACCACCGAGATCTACACACATTGGCGAGCTGGTGCTGCAGCTTATTA
s2_F_1653_ACCAACAAGG	AATGATACGGCGACCACCGAGATCTACACACCAACAAGGGCTGGTGCTGCAGCTTATTA
s2_F_1654_ACCAACACTA	AATGATACGGCGACCACCGAGATCTACACACCAACACTAGCTGGTGCTGCAGCTTATTA
s2_F_1655_ACCAACTATC	AATGATACGGCGACCACCGAGATCTACACACCAACTATCGCTGGTGCTGCAGCTTATTA
s2_F_1656_ACCAAGGATT	AATGATACGGCGACCACCGAGATCTACACACCAAGGATTGCTGGTGCTGCAGCTTATTA
s2_F_1657_ACCACAAGAA	AATGATACGGCGACCACCGAGATCTACACACCACAAGAAGCTGGTGCTGCAGCTTATTA
s2_F_1658_ACCACATAAG	AATGATACGGCGACCACCGAGATCTACACACCACATAAGGCTGGTGCTGCAGCTTATTA
s2_F_1659_ACCAGATACT	AATGATACGGCGACCACCGAGATCTACACACCAGATACTGCTGGTGCTGCAGCTTATTA
s2_F_1660_ACCAGGAAGA	AATGATACGGCGACCACCGAGATCTACACACCAGGAAGAGCTGGTGCTGCAGCTTATTA
s2_F_1661_ACCATCTTAC	AATGATACGGCGACCACCGAGATCTACACACCATCTTACGCTGGTGCTGCAGCTTATTA
s2_F_1662_ACCATTACTG	AATGATACGGCGACCACCGAGATCTACACACCATTACTGGCTGGTGCTGCAGCTTATTA
s2_F_1663_ACCGAGAATG	AATGATACGGCGACCACCGAGATCTACACACCGAGAATGGCTGGTGCTGCAGCTTATTA
s2_F_1664_ACCGTCCTCA	AATGATACGGCGACCACCGAGATCTACACACCGTCCTCAGCTGGTGCTGCAGCTTATTA
s2_F_1665_ACCTACTTAG	AATGATACGGCGACCACCGAGATCTACACACCTACTTAGGCTGGTGCTGCAGCTTATTA
s2_F_1666_ACCTGAACGA	AATGATACGGCGACCACCGAGATCTACACACCTGAACGAGCTGGTGCTGCAGCTTATTA
s2_F_1667_ACCTGTCTAT	AATGATACGGCGACCACCGAGATCTACACACCTGTCTATGCTGGTGCTGCAGCTTATTA
s2_F_1668_ACCTTATAGG	AATGATACGGCGACCACCGAGATCTACACACCTTATAGGGCTGGTGCTGCAGCTTATTA
s2_F_1669_ACGAAGTCAA	AATGATACGGCGACCACCGAGATCTACACACGAAGTCAAGCTGGTGCTGCAGCTTATTA
s2_F_1670_ACGAATCAGT	AATGATACGGCGACCACCGAGATCTACACACGAATCAGTGCTGGTGCTGCAGCTTATTA
s2_F_1671_ACGACCTCAG	AATGATACGGCGACCACCGAGATCTACACACGACCTCAGGCTGGTGCTGCAGCTTATTA
s2_F_1672_ACGACTATCT	AATGATACGGCGACCACCGAGATCTACACACGACTATCTGCTGGTGCTGCAGCTTATTA
s2_F_1673_ACGAGATAGG	AATGATACGGCGACCACCGAGATCTACACACGAGATAGGGCTGGTGCTGCAGCTTATTA
s2_F_1674_ACGATAGCCA	AATGATACGGCGACCACCGAGATCTACACACGATAGCCAGCTGGTGCTGCAGCTTATTA
s2_F_1675_ACGCATAACT	AATGATACGGCGACCACCGAGATCTACACACGCATAACTGCTGGTGCTGCAGCTTATTA
s2_F_1676_ACGCTTCAAG	AATGATACGGCGACCACCGAGATCTACACACGCTTCAAGGCTGGTGCTGCAGCTTATTA
s2_F_1677_ACGTAATTGG	AATGATACGGCGACCACCGAGATCTACACACGTAATTGGGCTGGTGCTGCAGCTTATTA
s2_F_1678_ACGTACACCT	AATGATACGGCGACCACCGAGATCTACACACGTACACCTGCTGGTGCTGCAGCTTATTA
s2_F_1679_ACGTCACGAG	AATGATACGGCGACCACCGAGATCTACACACGTCACGAGGCTGGTGCTGCAGCTTATTA
s2_F_1680_ACTAACCTTG	AATGATACGGCGACCACCGAGATCTACACACTAACCTTGGCTGGTGCTGCAGCTTATTA
s2_F_1681_ACTACAACTG	AATGATACGGCGACCACCGAGATCTACACACTACAACTGGCTGGTGCTGCAGCTTATTA
s2_F_1682_ACTACCAAGC	AATGATACGGCGACCACCGAGATCTACACACTACCAAGCGCTGGTGCTGCAGCTTATTA
s2_F_1683_ACTACCACAA	AATGATACGGCGACCACCGAGATCTACACACTACCACAAGCTGGTGCTGCAGCTTATTA
s2_F_1684_ACTACGAACA	AATGATACGGCGACCACCGAGATCTACACACTACGAACAGCTGGTGCTGCAGCTTATTA
s2_F_1685_ACTAGAGCAA	AATGATACGGCGACCACCGAGATCTACACACTAGAGCAAGCTGGTGCTGCAGCTTATTA
s2_F_1686_ACTAGTCAAG	AATGATACGGCGACCACCGAGATCTACACACTAGTCAAGGCTGGTGCTGCAGCTTATTA
s2_F_1687_ACTCAGCCAT	AATGATACGGCGACCACCGAGATCTACACACTCAGCCATGCTGGTGCTGCAGCTTATTA
s2_F_1688_ACTCATTCAG	AATGATACGGCGACCACCGAGATCTACACACTCATTCAGGCTGGTGCTGCAGCTTATTA
s2_F_1689_ACTCCTCAAT	AATGATACGGCGACCACCGAGATCTACACACTCCTCAATGCTGGTGCTGCAGCTTATTA
s2_F_1690_ACTCCTTAGC	AATGATACGGCGACCACCGAGATCTACACACTCCTTAGCGCTGGTGCTGCAGCTTATTA
s2_F_1691_ACTCGACTGA	AATGATACGGCGACCACCGAGATCTACACACTCGACTGAGCTGGTGCTGCAGCTTATTA
s2_F_1692_ACTCTGCTCT	AATGATACGGCGACCACCGAGATCTACACACTCTGCTCTGCTGGTGCTGCAGCTTATTA
s2_F_1693_ACTGAGTTCA	AATGATACGGCGACCACCGAGATCTACACACTGAGTTCAGCTGGTGCTGCAGCTTATTA
s2_F_1694_ACTGCCATTA	AATGATACGGCGACCACCGAGATCTACACACTGCCATTAGCTGGTGCTGCAGCTTATTA
s2_F_1695_ACTGGCTATT	AATGATACGGCGACCACCGAGATCTACACACTGGCTATTGCTGGTGCTGCAGCTTATTA
s2_F_1696_ACTGGTAAGT	AATGATACGGCGACCACCGAGATCTACACACTGGTAAGTGCTGGTGCTGCAGCTTATTA
s2_F_1697_ACTTACAGAG	AATGATACGGCGACCACCGAGATCTACACACTTACAGAGGCTGGTGCTGCAGCTTATTA
s2_F_1698_AGAACACAAC	AATGATACGGCGACCACCGAGATCTACACAGAACACAACGCTGGTGCTGCAGCTTATTA
s2_F_1699_AGAACACTGA	AATGATACGGCGACCACCGAGATCTACACAGAACACTGAGCTGGTGCTGCAGCTTATTA
s2_F_1700_AGAACTCCAA	AATGATACGGCGACCACCGAGATCTACACAGAACTCCAAGCTGGTGCTGCAGCTTATTA
s2_F_1701_AGAATACAGG	AATGATACGGCGACCACCGAGATCTACACAGAATACAGGGCTGGTGCTGCAGCTTATTA
s2_F_1702_AGAATGAGGA	AATGATACGGCGACCACCGAGATCTACACAGAATGAGGAGCTGGTGCTGCAGCTTATTA
s2_F_1703_AGACAACCTG	AATGATACGGCGACCACCGAGATCTACACAGACAACCTGGCTGGTGCTGCAGCTTATTA
s2_F_1704_AGACAGATGA	AATGATACGGCGACCACCGAGATCTACACAGACAGATGAGCTGGTGCTGCAGCTTATTA
s2_F_1705_AGACCGATTC	AATGATACGGCGACCACCGAGATCTACACAGACCGATTCGCTGGTGCTGCAGCTTATTA
s2_F_1706_AGACGACATT	AATGATACGGCGACCACCGAGATCTACACAGACGACATTGCTGGTGCTGCAGCTTATTA
s2_F_1707_AGACGTAACC	AATGATACGGCGACCACCGAGATCTACACAGACGTAACCGCTGGTGCTGCAGCTTATTA
s2_F_1708_AGACTACTAG	AATGATACGGCGACCACCGAGATCTACACAGACTACTAGGCTGGTGCTGCAGCTTATTA
s2_F_1709_AGAGAAGTGG	AATGATACGGCGACCACCGAGATCTACACAGAGAAGTGGGCTGGTGCTGCAGCTTATTA
s2_F_1710_AGAGACTAAG	AATGATACGGCGACCACCGAGATCTACACAGAGACTAAGGCTGGTGCTGCAGCTTATTA
s2_F_1711_AGAGAGTCGT	AATGATACGGCGACCACCGAGATCTACACAGAGAGTCGTGCTGGTGCTGCAGCTTATTA
s2_F_1712_AGAGCAACGA	AATGATACGGCGACCACCGAGATCTACACAGAGCAACGAGCTGGTGCTGCAGCTTATTA
s2_F_1713_AGAGCCTTCC	AATGATACGGCGACCACCGAGATCTACACAGAGCCTTCCGCTGGTGCTGCAGCTTATTA
s2_F_1714_AGAGGATTCT	AATGATACGGCGACCACCGAGATCTACACAGAGGATTCTGCTGGTGCTGCAGCTTATTA
s2_F_1715_AGAGGCATGA	AATGATACGGCGACCACCGAGATCTACACAGAGGCATGAGCTGGTGCTGCAGCTTATTA
s2_F_1716_AGAGGCCAAT	AATGATACGGCGACCACCGAGATCTACACAGAGGCCAATGCTGGTGCTGCAGCTTATTA
s2_F_1717_AGCAAGACAA	AATGATACGGCGACCACCGAGATCTACACAGCAAGACAAGCTGGTGCTGCAGCTTATTA
s2_F_1718_AGCAGACCGA	AATGATACGGCGACCACCGAGATCTACACAGCAGACCGAGCTGGTGCTGCAGCTTATTA
s2_F_1719_AGCCACTGAA	AATGATACGGCGACCACCGAGATCTACACAGCCACTGAAGCTGGTGCTGCAGCTTATTA
s2_F_1720_AGCCATTCCT	AATGATACGGCGACCACCGAGATCTACACAGCCATTCCTGCTGGTGCTGCAGCTTATTA
s2_F_1721_AGCCTAACAA	AATGATACGGCGACCACCGAGATCTACACAGCCTAACAAGCTGGTGCTGCAGCTTATTA
s2_F_1722_AGCTAACGAG	AATGATACGGCGACCACCGAGATCTACACAGCTAACGAGGCTGGTGCTGCAGCTTATTA
s2_F_1723_AGCTAGAAGG	AATGATACGGCGACCACCGAGATCTACACAGCTAGAAGGGCTGGTGCTGCAGCTTATTA
s2_F_1724_AGGAACCAAG	AATGATACGGCGACCACCGAGATCTACACAGGAACCAAGGCTGGTGCTGCAGCTTATTA
s2_F_1725_AGGACCTTCA	AATGATACGGCGACCACCGAGATCTACACAGGACCTTCAGCTGGTGCTGCAGCTTATTA
s2_F_1726_AGGATATCTG	AATGATACGGCGACCACCGAGATCTACACAGGATATCTGGCTGGTGCTGCAGCTTATTA
s2_F_1727_AGGCAATCGT	AATGATACGGCGACCACCGAGATCTACACAGGCAATCGTGCTGGTGCTGCAGCTTATTA
s2_F_1728_AGGCAGTAAT	AATGATACGGCGACCACCGAGATCTACACAGGCAGTAATGCTGGTGCTGCAGCTTATTA
s2_F_1729_AGGTACAGGA	AATGATACGGCGACCACCGAGATCTACACAGGTACAGGAGCTGGTGCTGCAGCTTATTA
s2_F_1730_AGTACGAGAT	AATGATACGGCGACCACCGAGATCTACACAGTACGAGATGCTGGTGCTGCAGCTTATTA
s2_F_1731_AGTATACCAG	AATGATACGGCGACCACCGAGATCTACACAGTATACCAGGCTGGTGCTGCAGCTTATTA
s2_F_1732_AGTCACAACA	AATGATACGGCGACCACCGAGATCTACACAGTCACAACAGCTGGTGCTGCAGCTTATTA
s2_F_1733_AGTCCTCCAG	AATGATACGGCGACCACCGAGATCTACACAGTCCTCCAGGCTGGTGCTGCAGCTTATTA
s2_F_1734_AGTCTCAGAA	AATGATACGGCGACCACCGAGATCTACACAGTCTCAGAAGCTGGTGCTGCAGCTTATTA
s2_F_1735_AGTCTTCATC	AATGATACGGCGACCACCGAGATCTACACAGTCTTCATCGCTGGTGCTGCAGCTTATTA
s2_F_1736_AGTGCCATGT	AATGATACGGCGACCACCGAGATCTACACAGTGCCATGTGCTGGTGCTGCAGCTTATTA
s2_F_1737_AGTGCGTCAT	AATGATACGGCGACCACCGAGATCTACACAGTGCGTCATGCTGGTGCTGCAGCTTATTA
s2_F_1738_AGTTCCTGAC	AATGATACGGCGACCACCGAGATCTACACAGTTCCTGACGCTGGTGCTGCAGCTTATTA
s2_F_1739_ATACCACATG	AATGATACGGCGACCACCGAGATCTACACATACCACATGGCTGGTGCTGCAGCTTATTA
s2_F_1740_ATACCATCGA	AATGATACGGCGACCACCGAGATCTACACATACCATCGAGCTGGTGCTGCAGCTTATTA
s2_F_1741_ATACCTCACA	AATGATACGGCGACCACCGAGATCTACACATACCTCACAGCTGGTGCTGCAGCTTATTA
s2_F_1742_ATACGACTCA	AATGATACGGCGACCACCGAGATCTACACATACGACTCAGCTGGTGCTGCAGCTTATTA
s2_F_1743_ATAGCCTAAC	AATGATACGGCGACCACCGAGATCTACACATAGCCTAACGCTGGTGCTGCAGCTTATTA
s2_F_1744_ATAGGATAGG	AATGATACGGCGACCACCGAGATCTACACATAGGATAGGGCTGGTGCTGCAGCTTATTA
s2_F_1745_ATAGTCTTGG	AATGATACGGCGACCACCGAGATCTACACATAGTCTTGGGCTGGTGCTGCAGCTTATTA
s2_F_1746_ATCAACTGGA	AATGATACGGCGACCACCGAGATCTACACATCAACTGGAGCTGGTGCTGCAGCTTATTA
s2_F_1747_ATCAATCCAG	AATGATACGGCGACCACCGAGATCTACACATCAATCCAGGCTGGTGCTGCAGCTTATTA
s2_F_1748_ATCATGCCTG	AATGATACGGCGACCACCGAGATCTACACATCATGCCTGGCTGGTGCTGCAGCTTATTA
s2_F_1749_ATCCACCATT	AATGATACGGCGACCACCGAGATCTACACATCCACCATTGCTGGTGCTGCAGCTTATTA
s2_F_1750_ATCCAGTCAT	AATGATACGGCGACCACCGAGATCTACACATCCAGTCATGCTGGTGCTGCAGCTTATTA
s2_F_1751_ATCCGATCCA	AATGATACGGCGACCACCGAGATCTACACATCCGATCCAGCTGGTGCTGCAGCTTATTA
s2_F_1752_ATCCTAAGGA	AATGATACGGCGACCACCGAGATCTACACATCCTAAGGAGCTGGTGCTGCAGCTTATTA
s2_F_1753_ATCCTCGAAG	AATGATACGGCGACCACCGAGATCTACACATCCTCGAAGGCTGGTGCTGCAGCTTATTA
s2_F_1754_ATCCTGCATA	AATGATACGGCGACCACCGAGATCTACACATCCTGCATAGCTGGTGCTGCAGCTTATTA
s2_F_1755_ATCCTTCTAG	AATGATACGGCGACCACCGAGATCTACACATCCTTCTAGGCTGGTGCTGCAGCTTATTA
s2_F_1756_ATCTCCACGA	AATGATACGGCGACCACCGAGATCTACACATCTCCACGAGCTGGTGCTGCAGCTTATTA
s2_F_1757_ATCTGCCTCA	AATGATACGGCGACCACCGAGATCTACACATCTGCCTCAGCTGGTGCTGCAGCTTATTA
s2_F_1758_ATGAAGGTCA	AATGATACGGCGACCACCGAGATCTACACATGAAGGTCAGCTGGTGCTGCAGCTTATTA
s2_F_1759_ATGACCGAAG	AATGATACGGCGACCACCGAGATCTACACATGACCGAAGGCTGGTGCTGCAGCTTATTA
s2_F_1760_ATGACGAGTT	AATGATACGGCGACCACCGAGATCTACACATGACGAGTTGCTGGTGCTGCAGCTTATTA
s2_F_1761_ATGCGTACAA	AATGATACGGCGACCACCGAGATCTACACATGCGTACAAGCTGGTGCTGCAGCTTATTA
s2_F_1762_ATGGACATCT	AATGATACGGCGACCACCGAGATCTACACATGGACATCTGCTGGTGCTGCAGCTTATTA
s2_F_1763_ATTACGATGC	AATGATACGGCGACCACCGAGATCTACACATTACGATGCGCTGGTGCTGCAGCTTATTA
s2_F_1764_ATTGGACAGA	AATGATACGGCGACCACCGAGATCTACACATTGGACAGAGCTGGTGCTGCAGCTTATTA
s2_F_1765_ATTGTCATCC	AATGATACGGCGACCACCGAGATCTACACATTGTCATCCGCTGGTGCTGCAGCTTATTA
s2_F_1766_CAACAAGCGA	AATGATACGGCGACCACCGAGATCTACACCAACAAGCGAGCTGGTGCTGCAGCTTATTA
s2_F_1767_CAACATAGGT	AATGATACGGCGACCACCGAGATCTACACCAACATAGGTGCTGGTGCTGCAGCTTATTA
s2_F_1768_CAACATGAAG	AATGATACGGCGACCACCGAGATCTACACCAACATGAAGGCTGGTGCTGCAGCTTATTA
s2_F_1769_CAACTACAAC	AATGATACGGCGACCACCGAGATCTACACCAACTACAACGCTGGTGCTGCAGCTTATTA
s2_F_1770_CAACTCAGAA	AATGATACGGCGACCACCGAGATCTACACCAACTCAGAAGCTGGTGCTGCAGCTTATTA
s2_F_1771_CAAGACCTGA	AATGATACGGCGACCACCGAGATCTACACCAAGACCTGAGCTGGTGCTGCAGCTTATTA
s2_F_1772_CAAGATCCTT	AATGATACGGCGACCACCGAGATCTACACCAAGATCCTTGCTGGTGCTGCAGCTTATTA
s2_F_1773_CAAGCCATAG	AATGATACGGCGACCACCGAGATCTACACCAAGCCATAGGCTGGTGCTGCAGCTTATTA
s2_F_1774_CAAGGATAAG	AATGATACGGCGACCACCGAGATCTACACCAAGGATAAGGCTGGTGCTGCAGCTTATTA
s2_F_1775_CAAGTCATCC	AATGATACGGCGACCACCGAGATCTACACCAAGTCATCCGCTGGTGCTGCAGCTTATTA
s2_F_1776_CAATAGGAGT	AATGATACGGCGACCACCGAGATCTACACCAATAGGAGTGCTGGTGCTGCAGCTTATTA
s2_F_1777_CAATATGCCT	AATGATACGGCGACCACCGAGATCTACACCAATATGCCTGCTGGTGCTGCAGCTTATTA
s2_F_1778_CAATTACCTG	AATGATACGGCGACCACCGAGATCTACACCAATTACCTGGCTGGTGCTGCAGCTTATTA
s2_F_1779_CAATTCCGAT	AATGATACGGCGACCACCGAGATCTACACCAATTCCGATGCTGGTGCTGCAGCTTATTA
s2_F_1780_CACAACTCTG	AATGATACGGCGACCACCGAGATCTACACCACAACTCTGGCTGGTGCTGCAGCTTATTA
s2_F_1781_CACAACTTCA	AATGATACGGCGACCACCGAGATCTACACCACAACTTCAGCTGGTGCTGCAGCTTATTA
s2_F_1782_CACAAGAAGG	AATGATACGGCGACCACCGAGATCTACACCACAAGAAGGGCTGGTGCTGCAGCTTATTA
s2_F_1783_CACACCACTA	AATGATACGGCGACCACCGAGATCTACACCACACCACTAGCTGGTGCTGCAGCTTATTA
s2_F_1784_CACAGAACGA	AATGATACGGCGACCACCGAGATCTACACCACAGAACGAGCTGGTGCTGCAGCTTATTA
s2_F_1785_CACAGACTAT	AATGATACGGCGACCACCGAGATCTACACCACAGACTATGCTGGTGCTGCAGCTTATTA
s2_F_1786_CACAGTTAAG	AATGATACGGCGACCACCGAGATCTACACCACAGTTAAGGCTGGTGCTGCAGCTTATTA
s2_F_1787_CACATATAGG	AATGATACGGCGACCACCGAGATCTACACCACATATAGGGCTGGTGCTGCAGCTTATTA
s2_F_1788_CACATGCGAA	AATGATACGGCGACCACCGAGATCTACACCACATGCGAAGCTGGTGCTGCAGCTTATTA
s2_F_1789_CACATTCGTG	AATGATACGGCGACCACCGAGATCTACACCACATTCGTGGCTGGTGCTGCAGCTTATTA
s2_F_1790_CACCAACAGA	AATGATACGGCGACCACCGAGATCTACACCACCAACAGAGCTGGTGCTGCAGCTTATTA
s2_F_1791_CACCAATTAC	AATGATACGGCGACCACCGAGATCTACACCACCAATTACGCTGGTGCTGCAGCTTATTA
s2_F_1792_CACCATAACA	AATGATACGGCGACCACCGAGATCTACACCACCATAACAGCTGGTGCTGCAGCTTATTA
s2_F_1793_CACCTCCTTA	AATGATACGGCGACCACCGAGATCTACACCACCTCCTTAGCTGGTGCTGCAGCTTATTA
s2_F_1794_CACCTTACAA	AATGATACGGCGACCACCGAGATCTACACCACCTTACAAGCTGGTGCTGCAGCTTATTA
s2_F_1795_CACGAGATTA	AATGATACGGCGACCACCGAGATCTACACCACGAGATTAGCTGGTGCTGCAGCTTATTA
s2_F_1796_CACGTTGCTT	AATGATACGGCGACCACCGAGATCTACACCACGTTGCTTGCTGGTGCTGCAGCTTATTA
s2_F_1797_CACTACTCAA	AATGATACGGCGACCACCGAGATCTACACCACTACTCAAGCTGGTGCTGCAGCTTATTA
s2_F_1798_CACTATCCGA	AATGATACGGCGACCACCGAGATCTACACCACTATCCGAGCTGGTGCTGCAGCTTATTA
s2_F_1799_CACTATTGCT	AATGATACGGCGACCACCGAGATCTACACCACTATTGCTGCTGGTGCTGCAGCTTATTA
s2_F_1800_CACTTCCTGT	AATGATACGGCGACCACCGAGATCTACACCACTTCCTGTGCTGGTGCTGCAGCTTATTA
s2_F_1801_CACTTCTAAG	AATGATACGGCGACCACCGAGATCTACACCACTTCTAAGGCTGGTGCTGCAGCTTATTA
s2_F_1802_CAGAGATGGA	AATGATACGGCGACCACCGAGATCTACACCAGAGATGGAGCTGGTGCTGCAGCTTATTA
s2_F_1803_CAGTACTTCC	AATGATACGGCGACCACCGAGATCTACACCAGTACTTCCGCTGGTGCTGCAGCTTATTA
s2_F_1804_CAGTTGATTG	AATGATACGGCGACCACCGAGATCTACACCAGTTGATTGGCTGGTGCTGCAGCTTATTA
s2_F_1805_CATACAATGC	AATGATACGGCGACCACCGAGATCTACACCATACAATGCGCTGGTGCTGCAGCTTATTA
s2_F_1806_CATACTCCTA	AATGATACGGCGACCACCGAGATCTACACCATACTCCTAGCTGGTGCTGCAGCTTATTA
s2_F_1807_CATCAGGTAG	AATGATACGGCGACCACCGAGATCTACACCATCAGGTAGGCTGGTGCTGCAGCTTATTA
s2_F_1808_CATCATGGCT	AATGATACGGCGACCACCGAGATCTACACCATCATGGCTGCTGGTGCTGCAGCTTATTA
s2_F_1809_CATCCACTAT	AATGATACGGCGACCACCGAGATCTACACCATCCACTATGCTGGTGCTGCAGCTTATTA
s2_F_1810_CATGAATAGG	AATGATACGGCGACCACCGAGATCTACACCATGAATAGGGCTGGTGCTGCAGCTTATTA
s2_F_1811_CATTCACGAA	AATGATACGGCGACCACCGAGATCTACACCATTCACGAAGCTGGTGCTGCAGCTTATTA
s2_F_1812_CCAACACTCC	AATGATACGGCGACCACCGAGATCTACACCCAACACTCCGCTGGTGCTGCAGCTTATTA
s2_F_1813_CCAACCACTG	AATGATACGGCGACCACCGAGATCTACACCCAACCACTGGCTGGTGCTGCAGCTTATTA
s2_F_1814_CCAAGAGAAG	AATGATACGGCGACCACCGAGATCTACACCCAAGAGAAGGCTGGTGCTGCAGCTTATTA
s2_F_1815_CCAATACAGT	AATGATACGGCGACCACCGAGATCTACACCCAATACAGTGCTGGTGCTGCAGCTTATTA
s2_F_1816_CCAATAGCGA	AATGATACGGCGACCACCGAGATCTACACCCAATAGCGAGCTGGTGCTGCAGCTTATTA
s2_F_1817_CCACATAACC	AATGATACGGCGACCACCGAGATCTACACCCACATAACCGCTGGTGCTGCAGCTTATTA
s2_F_1818_CCACCGAACA	AATGATACGGCGACCACCGAGATCTACACCCACCGAACAGCTGGTGCTGCAGCTTATTA
s2_F_1819_CCAGAAGTTG	AATGATACGGCGACCACCGAGATCTACACCCAGAAGTTGGCTGGTGCTGCAGCTTATTA
s2_F_1820_CCAGGAATTC	AATGATACGGCGACCACCGAGATCTACACCCAGGAATTCGCTGGTGCTGCAGCTTATTA
s2_F_1821_CCATAACTAC	AATGATACGGCGACCACCGAGATCTACACCCATAACTACGCTGGTGCTGCAGCTTATTA
s2_F_1822_CCATCACAGA	AATGATACGGCGACCACCGAGATCTACACCCATCACAGAGCTGGTGCTGCAGCTTATTA
s2_F_1823_CCATCATTAG	AATGATACGGCGACCACCGAGATCTACACCCATCATTAGGCTGGTGCTGCAGCTTATTA
s2_F_1824_CCATTGTTGC	AATGATACGGCGACCACCGAGATCTACACCCATTGTTGCGCTGGTGCTGCAGCTTATTA
s2_F_1825_CCGAATTGAA	AATGATACGGCGACCACCGAGATCTACACCCGAATTGAAGCTGGTGCTGCAGCTTATTA
s2_F_1826_CCGACAACGA	AATGATACGGCGACCACCGAGATCTACACCCGACAACGAGCTGGTGCTGCAGCTTATTA
s2_F_1827_CCGATAACTT	AATGATACGGCGACCACCGAGATCTACACCCGATAACTTGCTGGTGCTGCAGCTTATTA
s2_F_1828_CCGATGCGTT	AATGATACGGCGACCACCGAGATCTACACCCGATGCGTTGCTGGTGCTGCAGCTTATTA
s2_F_1829_CCGTAACCTG	AATGATACGGCGACCACCGAGATCTACACCCGTAACCTGGCTGGTGCTGCAGCTTATTA
s2_F_1830_CCGTCCATGA	AATGATACGGCGACCACCGAGATCTACACCCGTCCATGAGCTGGTGCTGCAGCTTATTA
s2_F_1831_CCGTTAATAG	AATGATACGGCGACCACCGAGATCTACACCCGTTAATAGGCTGGTGCTGCAGCTTATTA
s2_F_1832_CCGTTACTCT	AATGATACGGCGACCACCGAGATCTACACCCGTTACTCTGCTGGTGCTGCAGCTTATTA
s2_F_1833_CCGTTCTTCA	AATGATACGGCGACCACCGAGATCTACACCCGTTCTTCAGCTGGTGCTGCAGCTTATTA
s2_F_1834_CCGTTGTCAA	AATGATACGGCGACCACCGAGATCTACACCCGTTGTCAAGCTGGTGCTGCAGCTTATTA
s2_F_1835_CCTAACATCT	AATGATACGGCGACCACCGAGATCTACACCCTAACATCTGCTGGTGCTGCAGCTTATTA
s2_F_1836_CCTACTGCGA	AATGATACGGCGACCACCGAGATCTACACCCTACTGCGAGCTGGTGCTGCAGCTTATTA
s2_F_1837_CCTAGGAAGC	AATGATACGGCGACCACCGAGATCTACACCCTAGGAAGCGCTGGTGCTGCAGCTTATTA
s2_F_1838_CCTATTGATG	AATGATACGGCGACCACCGAGATCTACACCCTATTGATGGCTGGTGCTGCAGCTTATTA
s2_F_1839_CCTCAACCAA	AATGATACGGCGACCACCGAGATCTACACCCTCAACCAAGCTGGTGCTGCAGCTTATTA
s2_F_1840_CCTCATTCTT	AATGATACGGCGACCACCGAGATCTACACCCTCATTCTTGCTGGTGCTGCAGCTTATTA
s2_F_1841_CCTCTACGAG	AATGATACGGCGACCACCGAGATCTACACCCTCTACGAGGCTGGTGCTGCAGCTTATTA
s2_F_1842_CCTGAATCTG	AATGATACGGCGACCACCGAGATCTACACCCTGAATCTGGCTGGTGCTGCAGCTTATTA
s2_F_1843_CCTTACGTTG	AATGATACGGCGACCACCGAGATCTACACCCTTACGTTGGCTGGTGCTGCAGCTTATTA
s2_F_1844_CCTTAGAATG	AATGATACGGCGACCACCGAGATCTACACCCTTAGAATGGCTGGTGCTGCAGCTTATTA
s2_F_1845_CCTTCCGTCA	AATGATACGGCGACCACCGAGATCTACACCCTTCCGTCAGCTGGTGCTGCAGCTTATTA
s2_F_1846_CCTTCCTCTT	AATGATACGGCGACCACCGAGATCTACACCCTTCCTCTTGCTGGTGCTGCAGCTTATTA
s2_F_1847_CGAACCAAGG	AATGATACGGCGACCACCGAGATCTACACCGAACCAAGGGCTGGTGCTGCAGCTTATTA
s2_F_1848_CGAACCAGTA	AATGATACGGCGACCACCGAGATCTACACCGAACCAGTAGCTGGTGCTGCAGCTTATTA
s2_F_1849_CGAACGCTTG	AATGATACGGCGACCACCGAGATCTACACCGAACGCTTGGCTGGTGCTGCAGCTTATTA
s2_F_1850_CGAAGACACA	AATGATACGGCGACCACCGAGATCTACACCGAAGACACAGCTGGTGCTGCAGCTTATTA
s2_F_1851_CGAAGATGAA	AATGATACGGCGACCACCGAGATCTACACCGAAGATGAAGCTGGTGCTGCAGCTTATTA
s2_F_1852_CGAAGCTCTT	AATGATACGGCGACCACCGAGATCTACACCGAAGCTCTTGCTGGTGCTGCAGCTTATTA
s2_F_1853_CGAAGTAACT	AATGATACGGCGACCACCGAGATCTACACCGAAGTAACTGCTGGTGCTGCAGCTTATTA
s2_F_1854_CGAATCTAAG	AATGATACGGCGACCACCGAGATCTACACCGAATCTAAGGCTGGTGCTGCAGCTTATTA
s2_F_1855_CGACAATCTT	AATGATACGGCGACCACCGAGATCTACACCGACAATCTTGCTGGTGCTGCAGCTTATTA
s2_F_1856_CGACAGAATG	AATGATACGGCGACCACCGAGATCTACACCGACAGAATGGCTGGTGCTGCAGCTTATTA
s2_F_1857_CGACCAATAG	AATGATACGGCGACCACCGAGATCTACACCGACCAATAGGCTGGTGCTGCAGCTTATTA
s2_F_1858_CGACTAAGTA	AATGATACGGCGACCACCGAGATCTACACCGACTAAGTAGCTGGTGCTGCAGCTTATTA
s2_F_1859_CGACTCACTT	AATGATACGGCGACCACCGAGATCTACACCGACTCACTTGCTGGTGCTGCAGCTTATTA
s2_F_1860_CGACTGACAA	AATGATACGGCGACCACCGAGATCTACACCGACTGACAAGCTGGTGCTGCAGCTTATTA
s2_F_1861_CGAGATTCGA	AATGATACGGCGACCACCGAGATCTACACCGAGATTCGAGCTGGTGCTGCAGCTTATTA
s2_F_1862_CGAGGACTAA	AATGATACGGCGACCACCGAGATCTACACCGAGGACTAAGCTGGTGCTGCAGCTTATTA
s2_F_1863_CGAGTCATAA	AATGATACGGCGACCACCGAGATCTACACCGAGTCATAAGCTGGTGCTGCAGCTTATTA
s2_F_1864_CGATTAGTTG	AATGATACGGCGACCACCGAGATCTACACCGATTAGTTGGCTGGTGCTGCAGCTTATTA
s2_F_1865_CGCACTCAAG	AATGATACGGCGACCACCGAGATCTACACCGCACTCAAGGCTGGTGCTGCAGCTTATTA
s2_F_1866_CGTAACTCAG	AATGATACGGCGACCACCGAGATCTACACCGTAACTCAGGCTGGTGCTGCAGCTTATTA
s2_F_1867_CGTACCAACT	AATGATACGGCGACCACCGAGATCTACACCGTACCAACTGCTGGTGCTGCAGCTTATTA
s2_F_1868_CGTACCGTTA	AATGATACGGCGACCACCGAGATCTACACCGTACCGTTAGCTGGTGCTGCAGCTTATTA
s2_F_1869_CGTAGTTAGC	AATGATACGGCGACCACCGAGATCTACACCGTAGTTAGCGCTGGTGCTGCAGCTTATTA
s2_F_1870_CGTCATTCCA	AATGATACGGCGACCACCGAGATCTACACCGTCATTCCAGCTGGTGCTGCAGCTTATTA
s2_F_1871_CGTCCTTGTT	AATGATACGGCGACCACCGAGATCTACACCGTCCTTGTTGCTGGTGCTGCAGCTTATTA
s2_F_1872_CGTCTGAATT	AATGATACGGCGACCACCGAGATCTACACCGTCTGAATTGCTGGTGCTGCAGCTTATTA
s2_F_1873_CGTGATGAGG	AATGATACGGCGACCACCGAGATCTACACCGTGATGAGGGCTGGTGCTGCAGCTTATTA
s2_F_1874_CGTTACAATC	AATGATACGGCGACCACCGAGATCTACACCGTTACAATCGCTGGTGCTGCAGCTTATTA
s2_F_1875_CGTTCTACCT	AATGATACGGCGACCACCGAGATCTACACCGTTCTACCTGCTGGTGCTGCAGCTTATTA
s2_F_1876_CTAATGCTGG	AATGATACGGCGACCACCGAGATCTACACCTAATGCTGGGCTGGTGCTGCAGCTTATTA
s2_F_1877_CTACACTATC	AATGATACGGCGACCACCGAGATCTACACCTACACTATCGCTGGTGCTGCAGCTTATTA
s2_F_1878_CTACACTCCT	AATGATACGGCGACCACCGAGATCTACACCTACACTCCTGCTGGTGCTGCAGCTTATTA
s2_F_1879_CTACCAAGGA	AATGATACGGCGACCACCGAGATCTACACCTACCAAGGAGCTGGTGCTGCAGCTTATTA
s2_F_1880_CTACGTTGAG	AATGATACGGCGACCACCGAGATCTACACCTACGTTGAGGCTGGTGCTGCAGCTTATTA
s2_F_1881_CTACTGCATT	AATGATACGGCGACCACCGAGATCTACACCTACTGCATTGCTGGTGCTGCAGCTTATTA
s2_F_1882_CTAGCACTGA	AATGATACGGCGACCACCGAGATCTACACCTAGCACTGAGCTGGTGCTGCAGCTTATTA
s2_F_1883_CTAGCTCAAT	AATGATACGGCGACCACCGAGATCTACACCTAGCTCAATGCTGGTGCTGCAGCTTATTA
s2_F_1884_CTATACCGAG	AATGATACGGCGACCACCGAGATCTACACCTATACCGAGGCTGGTGCTGCAGCTTATTA
s2_F_1885_CTATGACGAT	AATGATACGGCGACCACCGAGATCTACACCTATGACGATGCTGGTGCTGCAGCTTATTA
s2_F_1886_CTATTCCAGT	AATGATACGGCGACCACCGAGATCTACACCTATTCCAGTGCTGGTGCTGCAGCTTATTA
s2_F_1887_CTCAAGATGA	AATGATACGGCGACCACCGAGATCTACACCTCAAGATGAGCTGGTGCTGCAGCTTATTA
s2_F_1888_CTCACGATCC	AATGATACGGCGACCACCGAGATCTACACCTCACGATCCGCTGGTGCTGCAGCTTATTA
s2_F_1889_CTCACTCCGA	AATGATACGGCGACCACCGAGATCTACACCTCACTCCGAGCTGGTGCTGCAGCTTATTA
s2_F_1890_CTCAGATTAG	AATGATACGGCGACCACCGAGATCTACACCTCAGATTAGGCTGGTGCTGCAGCTTATTA
s2_F_1891_CTCATATCTG	AATGATACGGCGACCACCGAGATCTACACCTCATATCTGGCTGGTGCTGCAGCTTATTA
s2_F_1892_CTCCAACCTT	AATGATACGGCGACCACCGAGATCTACACCTCCAACCTTGCTGGTGCTGCAGCTTATTA
s2_F_1893_CTCCACCACA	AATGATACGGCGACCACCGAGATCTACACCTCCACCACAGCTGGTGCTGCAGCTTATTA
s2_F_1894_CTCCACTCTA	AATGATACGGCGACCACCGAGATCTACACCTCCACTCTAGCTGGTGCTGCAGCTTATTA
s2_F_1895_CTCCAGAAGT	AATGATACGGCGACCACCGAGATCTACACCTCCAGAAGTGCTGGTGCTGCAGCTTATTA
s2_F_1896_CTCCGTAGTA	AATGATACGGCGACCACCGAGATCTACACCTCCGTAGTAGCTGGTGCTGCAGCTTATTA
s2_F_1897_CTCTACATTG	AATGATACGGCGACCACCGAGATCTACACCTCTACATTGGCTGGTGCTGCAGCTTATTA
s2_F_1898_CTCTAGTCCT	AATGATACGGCGACCACCGAGATCTACACCTCTAGTCCTGCTGGTGCTGCAGCTTATTA
s2_F_1899_CTGAGCCTAC	AATGATACGGCGACCACCGAGATCTACACCTGAGCCTACGCTGGTGCTGCAGCTTATTA
s2_F_1900_CTGGAATACT	AATGATACGGCGACCACCGAGATCTACACCTGGAATACTGCTGGTGCTGCAGCTTATTA
s2_F_1901_CTGTCTGAGT	AATGATACGGCGACCACCGAGATCTACACCTGTCTGAGTGCTGGTGCTGCAGCTTATTA
s2_F_1902_CTTACCTAAG	AATGATACGGCGACCACCGAGATCTACACCTTACCTAAGGCTGGTGCTGCAGCTTATTA
s2_F_1903_CTTCACTGTT	AATGATACGGCGACCACCGAGATCTACACCTTCACTGTTGCTGGTGCTGCAGCTTATTA
s2_F_1904_CTTCCTCGAA	AATGATACGGCGACCACCGAGATCTACACCTTCCTCGAAGCTGGTGCTGCAGCTTATTA
s2_F_1905_CTTCTCACTA	AATGATACGGCGACCACCGAGATCTACACCTTCTCACTAGCTGGTGCTGCAGCTTATTA
s2_F_1906_GAACACAGTT	AATGATACGGCGACCACCGAGATCTACACGAACACAGTTGCTGGTGCTGCAGCTTATTA
s2_F_1907_GAACACGTAA	AATGATACGGCGACCACCGAGATCTACACGAACACGTAAGCTGGTGCTGCAGCTTATTA
s2_F_1908_GAACAGTTGT	AATGATACGGCGACCACCGAGATCTACACGAACAGTTGTGCTGGTGCTGCAGCTTATTA
s2_F_1909_GAACCAGAAG	AATGATACGGCGACCACCGAGATCTACACGAACCAGAAGGCTGGTGCTGCAGCTTATTA
s2_F_1910_GAACGAATCT	AATGATACGGCGACCACCGAGATCTACACGAACGAATCTGCTGGTGCTGCAGCTTATTA
s2_F_1911_GAACTGTAAG	AATGATACGGCGACCACCGAGATCTACACGAACTGTAAGGCTGGTGCTGCAGCTTATTA
s2_F_1912_GAATTGTCTG	AATGATACGGCGACCACCGAGATCTACACGAATTGTCTGGCTGGTGCTGCAGCTTATTA
s2_F_1913_GACACTAGAG	AATGATACGGCGACCACCGAGATCTACACGACACTAGAGGCTGGTGCTGCAGCTTATTA
s2_F_1914_GACAGTAAGA	AATGATACGGCGACCACCGAGATCTACACGACAGTAAGAGCTGGTGCTGCAGCTTATTA
s2_F_1915_GACATAGCTA	AATGATACGGCGACCACCGAGATCTACACGACATAGCTAGCTGGTGCTGCAGCTTATTA
s2_F_1916_GACATCACTG	AATGATACGGCGACCACCGAGATCTACACGACATCACTGGCTGGTGCTGCAGCTTATTA
s2_F_1917_GACCAACTGT	AATGATACGGCGACCACCGAGATCTACACGACCAACTGTGCTGGTGCTGCAGCTTATTA
s2_F_1918_GACCAAGGAA	AATGATACGGCGACCACCGAGATCTACACGACCAAGGAAGCTGGTGCTGCAGCTTATTA
s2_F_1919_GACCGAATTA	AATGATACGGCGACCACCGAGATCTACACGACCGAATTAGCTGGTGCTGCAGCTTATTA
s2_F_1920_GACCTCTTAT	AATGATACGGCGACCACCGAGATCTACACGACCTCTTATGCTGGTGCTGCAGCTTATTA
s2_F_1921_GACCTGAGTT	AATGATACGGCGACCACCGAGATCTACACGACCTGAGTTGCTGGTGCTGCAGCTTATTA
s2_F_1922_GACTGACATG	AATGATACGGCGACCACCGAGATCTACACGACTGACATGGCTGGTGCTGCAGCTTATTA
s2_F_1923_GACTGGATAT	AATGATACGGCGACCACCGAGATCTACACGACTGGATATGCTGGTGCTGCAGCTTATTA
s2_F_1924_GACTGTTCCT	AATGATACGGCGACCACCGAGATCTACACGACTGTTCCTGCTGGTGCTGCAGCTTATTA
s2_F_1925_GAGACAGGTA	AATGATACGGCGACCACCGAGATCTACACGAGACAGGTAGCTGGTGCTGCAGCTTATTA
s2_F_1926_GAGATAGTGA	AATGATACGGCGACCACCGAGATCTACACGAGATAGTGAGCTGGTGCTGCAGCTTATTA
s2_F_1927_GAGATGCTAA	AATGATACGGCGACCACCGAGATCTACACGAGATGCTAAGCTGGTGCTGCAGCTTATTA
s2_F_1928_GAGCAGACTA	AATGATACGGCGACCACCGAGATCTACACGAGCAGACTAGCTGGTGCTGCAGCTTATTA
s2_F_1929_GAGCAGGATT	AATGATACGGCGACCACCGAGATCTACACGAGCAGGATTGCTGGTGCTGCAGCTTATTA
s2_F_1930_GAGTACCGAA	AATGATACGGCGACCACCGAGATCTACACGAGTACCGAAGCTGGTGCTGCAGCTTATTA
s2_F_1931_GAGTACGACT	AATGATACGGCGACCACCGAGATCTACACGAGTACGACTGCTGGTGCTGCAGCTTATTA
s2_F_1932_GAGTCATTGA	AATGATACGGCGACCACCGAGATCTACACGAGTCATTGAGCTGGTGCTGCAGCTTATTA
s2_F_1933_GATACACATC	AATGATACGGCGACCACCGAGATCTACACGATACACATCGCTGGTGCTGCAGCTTATTA
s2_F_1934_GATAGGTTCA	AATGATACGGCGACCACCGAGATCTACACGATAGGTTCAGCTGGTGCTGCAGCTTATTA
s2_F_1935_GATCAGCCTT	AATGATACGGCGACCACCGAGATCTACACGATCAGCCTTGCTGGTGCTGCAGCTTATTA
s2_F_1936_GATCCTACGA	AATGATACGGCGACCACCGAGATCTACACGATCCTACGAGCTGGTGCTGCAGCTTATTA
s2_F_1937_GATCTGCAAT	AATGATACGGCGACCACCGAGATCTACACGATCTGCAATGCTGGTGCTGCAGCTTATTA
s2_F_1938_GATGCTCATG	AATGATACGGCGACCACCGAGATCTACACGATGCTCATGGCTGGTGCTGCAGCTTATTA
s2_F_1939_GATTCCTCAA	AATGATACGGCGACCACCGAGATCTACACGATTCCTCAAGCTGGTGCTGCAGCTTATTA
s2_F_1940_GCAACCACAT	AATGATACGGCGACCACCGAGATCTACACGCAACCACATGCTGGTGCTGCAGCTTATTA
s2_F_1941_GCAATCGAGA	AATGATACGGCGACCACCGAGATCTACACGCAATCGAGAGCTGGTGCTGCAGCTTATTA
s2_F_1942_GCACGATTAG	AATGATACGGCGACCACCGAGATCTACACGCACGATTAGGCTGGTGCTGCAGCTTATTA
s2_F_1943_GCAGTCCAAT	AATGATACGGCGACCACCGAGATCTACACGCAGTCCAATGCTGGTGCTGCAGCTTATTA
s2_F_1944_GCATAGCTGG	AATGATACGGCGACCACCGAGATCTACACGCATAGCTGGGCTGGTGCTGCAGCTTATTA
s2_F_1945_GCATGTCTAA	AATGATACGGCGACCACCGAGATCTACACGCATGTCTAAGCTGGTGCTGCAGCTTATTA
s2_F_1946_GCTAACGCTT	AATGATACGGCGACCACCGAGATCTACACGCTAACGCTTGCTGGTGCTGCAGCTTATTA
s2_F_1947_GCTAATATGC	AATGATACGGCGACCACCGAGATCTACACGCTAATATGCGCTGGTGCTGCAGCTTATTA
s2_F_1948_GCTACAGATA	AATGATACGGCGACCACCGAGATCTACACGCTACAGATAGCTGGTGCTGCAGCTTATTA
s2_F_1949_GCTATGTGCT	AATGATACGGCGACCACCGAGATCTACACGCTATGTGCTGCTGGTGCTGCAGCTTATTA
s2_F_1950_GCTATTAGGA	AATGATACGGCGACCACCGAGATCTACACGCTATTAGGAGCTGGTGCTGCAGCTTATTA
s2_F_1951_GTATTGAAGC	AATGATACGGCGACCACCGAGATCTACACGTATTGAAGCGCTGGTGCTGCAGCTTATTA
s2_F_1952_GTCCTTACAT	AATGATACGGCGACCACCGAGATCTACACGTCCTTACATGCTGGTGCTGCAGCTTATTA
s2_F_1953_GTCTCTGAAT	AATGATACGGCGACCACCGAGATCTACACGTCTCTGAATGCTGGTGCTGCAGCTTATTA
s2_F_1954_GTTATACAGG	AATGATACGGCGACCACCGAGATCTACACGTTATACAGGGCTGGTGCTGCAGCTTATTA
s2_F_1955_GTTCACAGAA	AATGATACGGCGACCACCGAGATCTACACGTTCACAGAAGCTGGTGCTGCAGCTTATTA
s2_F_1956_GTTCATCAAG	AATGATACGGCGACCACCGAGATCTACACGTTCATCAAGGCTGGTGCTGCAGCTTATTA
s2_F_1957_GTTGCTTAGG	AATGATACGGCGACCACCGAGATCTACACGTTGCTTAGGGCTGGTGCTGCAGCTTATTA
s2_F_1958_TAAGTGCATG	AATGATACGGCGACCACCGAGATCTACACTAAGTGCATGGCTGGTGCTGCAGCTTATTA
s2_F_1959_TAATGCGTGA	AATGATACGGCGACCACCGAGATCTACACTAATGCGTGAGCTGGTGCTGCAGCTTATTA
s2_F_1960_TACACTGTTC	AATGATACGGCGACCACCGAGATCTACACTACACTGTTCGCTGGTGCTGCAGCTTATTA
s2_F_1961_TACCAATCTG	AATGATACGGCGACCACCGAGATCTACACTACCAATCTGGCTGGTGCTGCAGCTTATTA
s2_F_1962_TACCACAAGC	AATGATACGGCGACCACCGAGATCTACACTACCACAAGCGCTGGTGCTGCAGCTTATTA
s2_F_1963_TACGACATAG	AATGATACGGCGACCACCGAGATCTACACTACGACATAGGCTGGTGCTGCAGCTTATTA
s2_F_1964_TACGAGGAGG	AATGATACGGCGACCACCGAGATCTACACTACGAGGAGGGCTGGTGCTGCAGCTTATTA
s2_F_1965_TACGTACAGG	AATGATACGGCGACCACCGAGATCTACACTACGTACAGGGCTGGTGCTGCAGCTTATTA
s2_F_1966_TAGACATCGA	AATGATACGGCGACCACCGAGATCTACACTAGACATCGAGCTGGTGCTGCAGCTTATTA
s2_F_1967_TAGAGAGGTT	AATGATACGGCGACCACCGAGATCTACACTAGAGAGGTTGCTGGTGCTGCAGCTTATTA
s2_F_1968_TAGCAGAAGA	AATGATACGGCGACCACCGAGATCTACACTAGCAGAAGAGCTGGTGCTGCAGCTTATTA
s2_F_1969_TAGGAGAATG	AATGATACGGCGACCACCGAGATCTACACTAGGAGAATGGCTGGTGCTGCAGCTTATTA
s2_F_1970_TAGGCATGAG	AATGATACGGCGACCACCGAGATCTACACTAGGCATGAGGCTGGTGCTGCAGCTTATTA
s2_F_1971_TAGGTACACA	AATGATACGGCGACCACCGAGATCTACACTAGGTACACAGCTGGTGCTGCAGCTTATTA
s2_F_1972_TATGAGGCAT	AATGATACGGCGACCACCGAGATCTACACTATGAGGCATGCTGGTGCTGCAGCTTATTA
s2_F_1973_TATGCGTTAG	AATGATACGGCGACCACCGAGATCTACACTATGCGTTAGGCTGGTGCTGCAGCTTATTA
s2_F_1974_TATGTCCAAG	AATGATACGGCGACCACCGAGATCTACACTATGTCCAAGGCTGGTGCTGCAGCTTATTA
s2_F_1975_TCAACCTGGT	AATGATACGGCGACCACCGAGATCTACACTCAACCTGGTGCTGGTGCTGCAGCTTATTA
s2_F_1976_TCAAGGTTGC	AATGATACGGCGACCACCGAGATCTACACTCAAGGTTGCGCTGGTGCTGCAGCTTATTA
s2_F_1977_TCAGAGAAGG	AATGATACGGCGACCACCGAGATCTACACTCAGAGAAGGGCTGGTGCTGCAGCTTATTA
s2_F_1978_TCAGGACTTA	AATGATACGGCGACCACCGAGATCTACACTCAGGACTTAGCTGGTGCTGCAGCTTATTA
s2_F_1979_TCATGGCAAG	AATGATACGGCGACCACCGAGATCTACACTCATGGCAAGGCTGGTGCTGCAGCTTATTA
s2_F_1980_TCCAGAATCC	AATGATACGGCGACCACCGAGATCTACACTCCAGAATCCGCTGGTGCTGCAGCTTATTA
s2_F_1981_TCCATACGAT	AATGATACGGCGACCACCGAGATCTACACTCCATACGATGCTGGTGCTGCAGCTTATTA
s2_F_1982_TCCGACATCT	AATGATACGGCGACCACCGAGATCTACACTCCGACATCTGCTGGTGCTGCAGCTTATTA
s2_F_1983_TCCGAGTTAT	AATGATACGGCGACCACCGAGATCTACACTCCGAGTTATGCTGGTGCTGCAGCTTATTA
s2_F_1984_TCCTTGAACT	AATGATACGGCGACCACCGAGATCTACACTCCTTGAACTGCTGGTGCTGCAGCTTATTA
s2_F_1985_TCGACCACTA	AATGATACGGCGACCACCGAGATCTACACTCGACCACTAGCTGGTGCTGCAGCTTATTA
s2_F_1986_TCGATGAGAA	AATGATACGGCGACCACCGAGATCTACACTCGATGAGAAGCTGGTGCTGCAGCTTATTA
s2_F_1987_TCGCTTCATT	AATGATACGGCGACCACCGAGATCTACACTCGCTTCATTGCTGGTGCTGCAGCTTATTA
s2_F_1988_TCTCATGCAA	AATGATACGGCGACCACCGAGATCTACACTCTCATGCAAGCTGGTGCTGCAGCTTATTA
s2_F_1989_TCTGTTCGTT	AATGATACGGCGACCACCGAGATCTACACTCTGTTCGTTGCTGGTGCTGCAGCTTATTA
s2_F_1990_TCTTCTCCGA	AATGATACGGCGACCACCGAGATCTACACTCTTCTCCGAGCTGGTGCTGCAGCTTATTA
s2_F_1991_TGAATGTCCT	AATGATACGGCGACCACCGAGATCTACACTGAATGTCCTGCTGGTGCTGCAGCTTATTA
s2_F_1992_TGACAATCCA	AATGATACGGCGACCACCGAGATCTACACTGACAATCCAGCTGGTGCTGCAGCTTATTA
s2_F_1993_TGAGAATGAG	AATGATACGGCGACCACCGAGATCTACACTGAGAATGAGGCTGGTGCTGCAGCTTATTA
s2_F_1994_TGATACGAGC	AATGATACGGCGACCACCGAGATCTACACTGATACGAGCGCTGGTGCTGCAGCTTATTA
s2_F_1995_TGATCCGTCC	AATGATACGGCGACCACCGAGATCTACACTGATCCGTCCGCTGGTGCTGCAGCTTATTA
s2_F_1996_TGATGAATCC	AATGATACGGCGACCACCGAGATCTACACTGATGAATCCGCTGGTGCTGCAGCTTATTA
s2_F_1997_TGCTACCATT	AATGATACGGCGACCACCGAGATCTACACTGCTACCATTGCTGGTGCTGCAGCTTATTA
s2_F_1998_TGCTATACCT	AATGATACGGCGACCACCGAGATCTACACTGCTATACCTGCTGGTGCTGCAGCTTATTA
s2_F_1999_TGTCCACGAG	AATGATACGGCGACCACCGAGATCTACACTGTCCACGAGGCTGGTGCTGCAGCTTATTA
s2_F_2000_TGTCTCCTCA	AATGATACGGCGACCACCGAGATCTACACTGTCTCCTCAGCTGGTGCTGCAGCTTATTA
s2_F_2001_TGTCTTGCTA	AATGATACGGCGACCACCGAGATCTACACTGTCTTGCTAGCTGGTGCTGCAGCTTATTA
s2_F_2002_TTAGGTGCCT	AATGATACGGCGACCACCGAGATCTACACTTAGGTGCCTGCTGGTGCTGCAGCTTATTA
s2_F_2003_TTCGACAGAT	AATGATACGGCGACCACCGAGATCTACACTTCGACAGATGCTGGTGCTGCAGCTTATTA
s2_F_2004_TTCTGATCCT	AATGATACGGCGACCACCGAGATCTACACTTCTGATCCTGCTGGTGCTGCAGCTTATTA
s2_F_2005_TTCTTCTAGC	AATGATACGGCGACCACCGAGATCTACACTTCTTCTAGCGCTGGTGCTGCAGCTTATTA
s2_F_2006_GTAACGCATC	AATGATACGGCGACCACCGAGATCTACACGTAACGCATCGCTGGTGCTGCAGCTTATTA
s2_F_2007_TCACTGACAG	AATGATACGGCGACCACCGAGATCTACACTCACTGACAGGCTGGTGCTGCAGCTTATTA
s2_F_2008_GAATCCAGAC	AATGATACGGCGACCACCGAGATCTACACGAATCCAGACGCTGGTGCTGCAGCTTATTA
s2_F_2009_GATCGACGAT	AATGATACGGCGACCACCGAGATCTACACGATCGACGATGCTGGTGCTGCAGCTTATTA
s2_F_2010_GTAACGCGAA	AATGATACGGCGACCACCGAGATCTACACGTAACGCGAAGCTGGTGCTGCAGCTTATTA
s2_F_2011_CAGGCTGGTA	AATGATACGGCGACCACCGAGATCTACACCAGGCTGGTAGCTGGTGCTGCAGCTTATTA
s2_F_2012_GAATATCGTG	AATGATACGGCGACCACCGAGATCTACACGAATATCGTGGCTGGTGCTGCAGCTTATTA
s2_F_2013_AGAGGAATAC	AATGATACGGCGACCACCGAGATCTACACAGAGGAATACGCTGGTGCTGCAGCTTATTA
s2_F_2014_CCAAGCATAT	AATGATACGGCGACCACCGAGATCTACACCCAAGCATATGCTGGTGCTGCAGCTTATTA
s2_F_2015_ATTATCTGCC	AATGATACGGCGACCACCGAGATCTACACATTATCTGCCGCTGGTGCTGCAGCTTATTA
s2_F_2016_TGGTGGACCT	AATGATACGGCGACCACCGAGATCTACACTGGTGGACCTGCTGGTGCTGCAGCTTATTA
s2_F_2017_TGAGGAGTCA	AATGATACGGCGACCACCGAGATCTACACTGAGGAGTCAGCTGGTGCTGCAGCTTATTA
s2_F_2018_CTACGCGAAC	AATGATACGGCGACCACCGAGATCTACACCTACGCGAACGCTGGTGCTGCAGCTTATTA
s2_F_2019_TGTCGCTTGT	AATGATACGGCGACCACCGAGATCTACACTGTCGCTTGTGCTGGTGCTGCAGCTTATTA
s2_F_2020_ATGTTGCCTC	AATGATACGGCGACCACCGAGATCTACACATGTTGCCTCGCTGGTGCTGCAGCTTATTA
s2_F_2021_TGCATTGGCC	AATGATACGGCGACCACCGAGATCTACACTGCATTGGCCGCTGGTGCTGCAGCTTATTA
s2_F_2022_TGTCTGACTC	AATGATACGGCGACCACCGAGATCTACACTGTCTGACTCGCTGGTGCTGCAGCTTATTA
s2_F_2023_GAATCGCACC	AATGATACGGCGACCACCGAGATCTACACGAATCGCACCGCTGGTGCTGCAGCTTATTA
