s2_R_1_CTGTCCGTTC	CAAGCAGAAGACGGCATACGAGATCTGTCCGTTCAGGGTCAAGTGCACAGTCTA
s2_R_2_CACAACGTAG	CAAGCAGAAGACGGCATACGAGATCACAACGTAGAGGGTCAAGTGCACAGTCTA
s2_R_3_CTACAGTGAC	CAAGCAGAAGACGGCATACGAGATCTACAGTGACAGGGTCAAGTGCACAGTCTA
s2_R_4_CTACTGTTGT	CAAGCAGAAGACGGCATACGAGATCTACTGTTGTAGGGTCAAGTGCACAGTCTA
s2_R_5_CCAGTGAGTC	CAAGCAGAAGACGGCATACGAGATCCAGTGAGTCAGGGTCAAGTGCACAGTCTA
s2_R_6_GTCTCAGTAG	CAAGCAGAAGACGGCATACGAGATGTCTCAGTAGAGGGTCAAGTGCACAGTCTA
s2_R_7_TGTACGCCTA	CAAGCAGAAGACGGCATACGAGATTGTACGCCTAAGGGTCAAGTGCACAGTCTA
s2_R_8_TACTGTACGT	CAAGCAGAAGACGGCATACGAGATTACTGTACGTAGGGTCAAGTGCACAGTCTA
s2_R_9_CGGTAGCTTG	CAAGCAGAAGACGGCATACGAGATCGGTAGCTTGAGGGTCAAGTGCACAGTCTA
s2_R_10_TTGAGTCGAA	CAAGCAGAAGACGGCATACGAGATTTGAGTCGAAAGGGTCAAGTGCACAGTCTA
s2_R_11_TTCTGGTAGG	CAAGCAGAAGACGGCATACGAGATTTCTGGTAGGAGGGTCAAGTGCACAGTCTA
s2_R_12_GTCTTGTAAG	CAAGCAGAAGACGGCATACGAGATGTCTTGTAAGAGGGTCAAGTGCACAGTCTA
s2_R_13_AGGATCTGGT	CAAGCAGAAGACGGCATACGAGATAGGATCTGGTAGGGTCAAGTGCACAGTCTA
s2_R_14_GTTGAGTCTT	CAAGCAGAAGACGGCATACGAGATGTTGAGTCTTAGGGTCAAGTGCACAGTCTA
s2_R_15_CCGAACATGG	CAAGCAGAAGACGGCATACGAGATCCGAACATGGAGGGTCAAGTGCACAGTCTA
s2_R_16_CCAACGAGGA	CAAGCAGAAGACGGCATACGAGATCCAACGAGGAAGGGTCAAGTGCACAGTCTA
s2_R_17_ATCAGTGTTG	CAAGCAGAAGACGGCATACGAGATATCAGTGTTGAGGGTCAAGTGCACAGTCTA
s2_R_18_ACTCTGTAAG	CAAGCAGAAGACGGCATACGAGATACTCTGTAAGAGGGTCAAGTGCACAGTCTA
s2_R_19_TTGTCGGCCT	CAAGCAGAAGACGGCATACGAGATTTGTCGGCCTAGGGTCAAGTGCACAGTCTA
s2_R_20_CCTATGTAGA	CAAGCAGAAGACGGCATACGAGATCCTATGTAGAAGGGTCAAGTGCACAGTCTA
s2_R_21_TCATCTTCTC	CAAGCAGAAGACGGCATACGAGATTCATCTTCTCAGGGTCAAGTGCACAGTCTA
s2_R_22_ACAAGATCGT	CAAGCAGAAGACGGCATACGAGATACAAGATCGTAGGGTCAAGTGCACAGTCTA
s2_R_23_CTACAAGAGT	CAAGCAGAAGACGGCATACGAGATCTACAAGAGTAGGGTCAAGTGCACAGTCTA
s2_R_24_CATTCGTCGT	CAAGCAGAAGACGGCATACGAGATCATTCGTCGTAGGGTCAAGTGCACAGTCTA
s2_R_25_AACTCTCTGT	CAAGCAGAAGACGGCATACGAGATAACTCTCTGTAGGGTCAAGTGCACAGTCTA
s2_R_26_GTACAGCGGT	CAAGCAGAAGACGGCATACGAGATGTACAGCGGTAGGGTCAAGTGCACAGTCTA
s2_R_27_CTAAGTCGTT	CAAGCAGAAGACGGCATACGAGATCTAAGTCGTTAGGGTCAAGTGCACAGTCTA
s2_R_28_GTAACATCGT	CAAGCAGAAGACGGCATACGAGATGTAACATCGTAGGGTCAAGTGCACAGTCTA
s2_R_29_GATACTCTGT	CAAGCAGAAGACGGCATACGAGATGATACTCTGTAGGGTCAAGTGCACAGTCTA
s2_R_30_TGCTCTGGTT	CAAGCAGAAGACGGCATACGAGATTGCTCTGGTTAGGGTCAAGTGCACAGTCTA
s2_R_31_CCATTCATGT	CAAGCAGAAGACGGCATACGAGATCCATTCATGTAGGGTCAAGTGCACAGTCTA
s2_R_32_CCACCTTGGT	CAAGCAGAAGACGGCATACGAGATCCACCTTGGTAGGGTCAAGTGCACAGTCTA
s2_R_33_ATCAACGCTG	CAAGCAGAAGACGGCATACGAGATATCAACGCTGAGGGTCAAGTGCACAGTCTA
s2_R_34_CCAGATGGAC	CAAGCAGAAGACGGCATACGAGATCCAGATGGACAGGGTCAAGTGCACAGTCTA
s2_R_35_GGTTCTTCGT	CAAGCAGAAGACGGCATACGAGATGGTTCTTCGTAGGGTCAAGTGCACAGTCTA
s2_R_36_CCAATCGAAT	CAAGCAGAAGACGGCATACGAGATCCAATCGAATAGGGTCAAGTGCACAGTCTA
s2_R_37_CGGATCGTAG	CAAGCAGAAGACGGCATACGAGATCGGATCGTAGAGGGTCAAGTGCACAGTCTA
s2_R_38_CACAGTGTCT	CAAGCAGAAGACGGCATACGAGATCACAGTGTCTAGGGTCAAGTGCACAGTCTA
s2_R_39_TCGTGTCTCC	CAAGCAGAAGACGGCATACGAGATTCGTGTCTCCAGGGTCAAGTGCACAGTCTA
s2_R_40_AGAACTGTCT	CAAGCAGAAGACGGCATACGAGATAGAACTGTCTAGGGTCAAGTGCACAGTCTA
s2_R_41_CAATACTGGT	CAAGCAGAAGACGGCATACGAGATCAATACTGGTAGGGTCAAGTGCACAGTCTA
s2_R_42_GGACTCTTGT	CAAGCAGAAGACGGCATACGAGATGGACTCTTGTAGGGTCAAGTGCACAGTCTA
s2_R_43_CTACCGTGTT	CAAGCAGAAGACGGCATACGAGATCTACCGTGTTAGGGTCAAGTGCACAGTCTA
s2_R_44_CCACGTTATG	CAAGCAGAAGACGGCATACGAGATCCACGTTATGAGGGTCAAGTGCACAGTCTA
s2_R_45_CAAGAGATCT	CAAGCAGAAGACGGCATACGAGATCAAGAGATCTAGGGTCAAGTGCACAGTCTA
s2_R_46_CCTTGTAGCT	CAAGCAGAAGACGGCATACGAGATCCTTGTAGCTAGGGTCAAGTGCACAGTCTA
s2_R_47_CTGTTGTGAC	CAAGCAGAAGACGGCATACGAGATCTGTTGTGACAGGGTCAAGTGCACAGTCTA
s2_R_48_TGTTCGCTAT	CAAGCAGAAGACGGCATACGAGATTGTTCGCTATAGGGTCAAGTGCACAGTCTA
s2_R_49_CCTACGGAAT	CAAGCAGAAGACGGCATACGAGATCCTACGGAATAGGGTCAAGTGCACAGTCTA
s2_R_50_CGGTTATGAT	CAAGCAGAAGACGGCATACGAGATCGGTTATGATAGGGTCAAGTGCACAGTCTA
s2_R_51_TTCCGTATAG	CAAGCAGAAGACGGCATACGAGATTTCCGTATAGAGGGTCAAGTGCACAGTCTA
s2_R_52_GGTGCCTCTT	CAAGCAGAAGACGGCATACGAGATGGTGCCTCTTAGGGTCAAGTGCACAGTCTA
s2_R_53_CAGTCAGACA	CAAGCAGAAGACGGCATACGAGATCAGTCAGACAAGGGTCAAGTGCACAGTCTA
s2_R_54_CCTTCAACGT	CAAGCAGAAGACGGCATACGAGATCCTTCAACGTAGGGTCAAGTGCACAGTCTA
s2_R_55_CTACCGTAGC	CAAGCAGAAGACGGCATACGAGATCTACCGTAGCAGGGTCAAGTGCACAGTCTA
s2_R_56_TGGAAGCACG	CAAGCAGAAGACGGCATACGAGATTGGAAGCACGAGGGTCAAGTGCACAGTCTA
s2_R_57_GTTCGATGGA	CAAGCAGAAGACGGCATACGAGATGTTCGATGGAAGGGTCAAGTGCACAGTCTA
s2_R_58_TAGGTGCGTT	CAAGCAGAAGACGGCATACGAGATTAGGTGCGTTAGGGTCAAGTGCACAGTCTA
s2_R_59_TCGCAGCCTT	CAAGCAGAAGACGGCATACGAGATTCGCAGCCTTAGGGTCAAGTGCACAGTCTA
s2_R_60_CTAACGACGT	CAAGCAGAAGACGGCATACGAGATCTAACGACGTAGGGTCAAGTGCACAGTCTA
s2_R_61_TCGGCATACG	CAAGCAGAAGACGGCATACGAGATTCGGCATACGAGGGTCAAGTGCACAGTCTA
s2_R_62_GACATACGGT	CAAGCAGAAGACGGCATACGAGATGACATACGGTAGGGTCAAGTGCACAGTCTA
s2_R_63_CCTCAAGTCC	CAAGCAGAAGACGGCATACGAGATCCTCAAGTCCAGGGTCAAGTGCACAGTCTA
s2_R_64_TTCTGGCTAT	CAAGCAGAAGACGGCATACGAGATTTCTGGCTATAGGGTCAAGTGCACAGTCTA
s2_R_65_CCGAACTAGA	CAAGCAGAAGACGGCATACGAGATCCGAACTAGAAGGGTCAAGTGCACAGTCTA
s2_R_66_ACTATGTGAC	CAAGCAGAAGACGGCATACGAGATACTATGTGACAGGGTCAAGTGCACAGTCTA
s2_R_67_ACGTAGAATC	CAAGCAGAAGACGGCATACGAGATACGTAGAATCAGGGTCAAGTGCACAGTCTA
s2_R_68_CTTCTACTGG	CAAGCAGAAGACGGCATACGAGATCTTCTACTGGAGGGTCAAGTGCACAGTCTA
s2_R_69_GCGTAGTTCA	CAAGCAGAAGACGGCATACGAGATGCGTAGTTCAAGGGTCAAGTGCACAGTCTA
s2_R_70_ATCGTTCGTA	CAAGCAGAAGACGGCATACGAGATATCGTTCGTAAGGGTCAAGTGCACAGTCTA
s2_R_71_CTTGCTCTGT	CAAGCAGAAGACGGCATACGAGATCTTGCTCTGTAGGGTCAAGTGCACAGTCTA
s2_R_72_TCCGGATGGT	CAAGCAGAAGACGGCATACGAGATTCCGGATGGTAGGGTCAAGTGCACAGTCTA
s2_R_73_CCATCTAAGT	CAAGCAGAAGACGGCATACGAGATCCATCTAAGTAGGGTCAAGTGCACAGTCTA
s2_R_74_CCACATCCAT	CAAGCAGAAGACGGCATACGAGATCCACATCCATAGGGTCAAGTGCACAGTCTA
s2_R_75_CTTCAGGATC	CAAGCAGAAGACGGCATACGAGATCTTCAGGATCAGGGTCAAGTGCACAGTCTA
s2_R_76_AGATTCGGCT	CAAGCAGAAGACGGCATACGAGATAGATTCGGCTAGGGTCAAGTGCACAGTCTA
s2_R_77_TCTTCCTTGT	CAAGCAGAAGACGGCATACGAGATTCTTCCTTGTAGGGTCAAGTGCACAGTCTA
s2_R_78_TGTACATCTG	CAAGCAGAAGACGGCATACGAGATTGTACATCTGAGGGTCAAGTGCACAGTCTA
s2_R_79_CATCTCTGTA	CAAGCAGAAGACGGCATACGAGATCATCTCTGTAAGGGTCAAGTGCACAGTCTA
s2_R_80_GTGGCATCCA	CAAGCAGAAGACGGCATACGAGATGTGGCATCCAAGGGTCAAGTGCACAGTCTA
s2_R_81_ATATGCGACG	CAAGCAGAAGACGGCATACGAGATATATGCGACGAGGGTCAAGTGCACAGTCTA
s2_R_82_TCTAGAAGGT	CAAGCAGAAGACGGCATACGAGATTCTAGAAGGTAGGGTCAAGTGCACAGTCTA
s2_R_83_CACACATGTT	CAAGCAGAAGACGGCATACGAGATCACACATGTTAGGGTCAAGTGCACAGTCTA
s2_R_84_GGTCTGCTAC	CAAGCAGAAGACGGCATACGAGATGGTCTGCTACAGGGTCAAGTGCACAGTCTA
s2_R_85_CGCCATGTTG	CAAGCAGAAGACGGCATACGAGATCGCCATGTTGAGGGTCAAGTGCACAGTCTA
s2_R_86_CGGTTGTATG	CAAGCAGAAGACGGCATACGAGATCGGTTGTATGAGGGTCAAGTGCACAGTCTA
s2_R_87_AACGTCATGT	CAAGCAGAAGACGGCATACGAGATAACGTCATGTAGGGTCAAGTGCACAGTCTA
s2_R_88_GTACTTAGGT	CAAGCAGAAGACGGCATACGAGATGTACTTAGGTAGGGTCAAGTGCACAGTCTA
s2_R_89_GGTGCCAGTA	CAAGCAGAAGACGGCATACGAGATGGTGCCAGTAAGGGTCAAGTGCACAGTCTA
s2_R_90_CAGTCGGCTT	CAAGCAGAAGACGGCATACGAGATCAGTCGGCTTAGGGTCAAGTGCACAGTCTA
s2_R_91_CTCCGTAACC	CAAGCAGAAGACGGCATACGAGATCTCCGTAACCAGGGTCAAGTGCACAGTCTA
s2_R_92_CAGATTCTGT	CAAGCAGAAGACGGCATACGAGATCAGATTCTGTAGGGTCAAGTGCACAGTCTA
s2_R_93_CAATCCGTAC	CAAGCAGAAGACGGCATACGAGATCAATCCGTACAGGGTCAAGTGCACAGTCTA
s2_R_94_TCGTGCTTGG	CAAGCAGAAGACGGCATACGAGATTCGTGCTTGGAGGGTCAAGTGCACAGTCTA
s2_R_95_CTGTGTAACA	CAAGCAGAAGACGGCATACGAGATCTGTGTAACAAGGGTCAAGTGCACAGTCTA
s2_R_96_AAGTGATCAG	CAAGCAGAAGACGGCATACGAGATAAGTGATCAGAGGGTCAAGTGCACAGTCTA
s2_R_97_AGCTCAACGT	CAAGCAGAAGACGGCATACGAGATAGCTCAACGTAGGGTCAAGTGCACAGTCTA
s2_R_98_ACCTGTAGTC	CAAGCAGAAGACGGCATACGAGATACCTGTAGTCAGGGTCAAGTGCACAGTCTA
s2_R_99_GTGACCGATC	CAAGCAGAAGACGGCATACGAGATGTGACCGATCAGGGTCAAGTGCACAGTCTA
s2_R_100_CATGGCATTA	CAAGCAGAAGACGGCATACGAGATCATGGCATTAAGGGTCAAGTGCACAGTCTA
s2_R_101_TCCTGCTTCC	CAAGCAGAAGACGGCATACGAGATTCCTGCTTCCAGGGTCAAGTGCACAGTCTA
s2_R_102_TGATGGACGG	CAAGCAGAAGACGGCATACGAGATTGATGGACGGAGGGTCAAGTGCACAGTCTA
s2_R_103_CTATGGATGT	CAAGCAGAAGACGGCATACGAGATCTATGGATGTAGGGTCAAGTGCACAGTCTA
s2_R_104_CTGTGATACC	CAAGCAGAAGACGGCATACGAGATCTGTGATACCAGGGTCAAGTGCACAGTCTA
s2_R_105_AGAGCTTGAC	CAAGCAGAAGACGGCATACGAGATAGAGCTTGACAGGGTCAAGTGCACAGTCTA
s2_R_106_TAAGCAGTCG	CAAGCAGAAGACGGCATACGAGATTAAGCAGTCGAGGGTCAAGTGCACAGTCTA
s2_R_107_GAGAGAATGT	CAAGCAGAAGACGGCATACGAGATGAGAGAATGTAGGGTCAAGTGCACAGTCTA
s2_R_108_TCTGTGGTAG	CAAGCAGAAGACGGCATACGAGATTCTGTGGTAGAGGGTCAAGTGCACAGTCTA
s2_R_109_TGGTCTTAGG	CAAGCAGAAGACGGCATACGAGATTGGTCTTAGGAGGGTCAAGTGCACAGTCTA
s2_R_110_CTAGACCGTA	CAAGCAGAAGACGGCATACGAGATCTAGACCGTAAGGGTCAAGTGCACAGTCTA
s2_R_111_AACGGCCTAA	CAAGCAGAAGACGGCATACGAGATAACGGCCTAAAGGGTCAAGTGCACAGTCTA
s2_R_112_GCGTGATGTC	CAAGCAGAAGACGGCATACGAGATGCGTGATGTCAGGGTCAAGTGCACAGTCTA
s2_R_113_CAAGGTCGTA	CAAGCAGAAGACGGCATACGAGATCAAGGTCGTAAGGGTCAAGTGCACAGTCTA
s2_R_114_CCTATTCCGG	CAAGCAGAAGACGGCATACGAGATCCTATTCCGGAGGGTCAAGTGCACAGTCTA
s2_R_115_CTTCTTGTAC	CAAGCAGAAGACGGCATACGAGATCTTCTTGTACAGGGTCAAGTGCACAGTCTA
s2_R_116_CCTTATCTGT	CAAGCAGAAGACGGCATACGAGATCCTTATCTGTAGGGTCAAGTGCACAGTCTA
s2_R_117_GTTCGGCTCT	CAAGCAGAAGACGGCATACGAGATGTTCGGCTCTAGGGTCAAGTGCACAGTCTA
s2_R_118_CATCGTTGGC	CAAGCAGAAGACGGCATACGAGATCATCGTTGGCAGGGTCAAGTGCACAGTCTA
s2_R_119_GTACGGCTGA	CAAGCAGAAGACGGCATACGAGATGTACGGCTGAAGGGTCAAGTGCACAGTCTA
s2_R_120_CACTCAGAGT	CAAGCAGAAGACGGCATACGAGATCACTCAGAGTAGGGTCAAGTGCACAGTCTA
s2_R_121_TCTCAGTGGC	CAAGCAGAAGACGGCATACGAGATTCTCAGTGGCAGGGTCAAGTGCACAGTCTA
s2_R_122_GTGAACGAGA	CAAGCAGAAGACGGCATACGAGATGTGAACGAGAAGGGTCAAGTGCACAGTCTA
s2_R_123_AGCGACTTGT	CAAGCAGAAGACGGCATACGAGATAGCGACTTGTAGGGTCAAGTGCACAGTCTA
s2_R_124_CGTGTATTAC	CAAGCAGAAGACGGCATACGAGATCGTGTATTACAGGGTCAAGTGCACAGTCTA
s2_R_125_ACAATGACCG	CAAGCAGAAGACGGCATACGAGATACAATGACCGAGGGTCAAGTGCACAGTCTA
s2_R_126_CTTCAGAGGA	CAAGCAGAAGACGGCATACGAGATCTTCAGAGGAAGGGTCAAGTGCACAGTCTA
s2_R_127_CCAGGTACTA	CAAGCAGAAGACGGCATACGAGATCCAGGTACTAAGGGTCAAGTGCACAGTCTA
s2_R_128_GAGTAGCCTC	CAAGCAGAAGACGGCATACGAGATGAGTAGCCTCAGGGTCAAGTGCACAGTCTA
s2_R_129_CCAACGGCTA	CAAGCAGAAGACGGCATACGAGATCCAACGGCTAAGGGTCAAGTGCACAGTCTA
s2_R_130_CCACTGATCT	CAAGCAGAAGACGGCATACGAGATCCACTGATCTAGGGTCAAGTGCACAGTCTA
s2_R_131_CACTTCGCCT	CAAGCAGAAGACGGCATACGAGATCACTTCGCCTAGGGTCAAGTGCACAGTCTA
s2_R_132_TCCATCTTGT	CAAGCAGAAGACGGCATACGAGATTCCATCTTGTAGGGTCAAGTGCACAGTCTA
s2_R_133_GTCAGATCCG	CAAGCAGAAGACGGCATACGAGATGTCAGATCCGAGGGTCAAGTGCACAGTCTA
s2_R_134_CCTATTGGAA	CAAGCAGAAGACGGCATACGAGATCCTATTGGAAAGGGTCAAGTGCACAGTCTA
s2_R_135_GGACGTGTCT	CAAGCAGAAGACGGCATACGAGATGGACGTGTCTAGGGTCAAGTGCACAGTCTA
s2_R_136_CCAACAATGT	CAAGCAGAAGACGGCATACGAGATCCAACAATGTAGGGTCAAGTGCACAGTCTA
s2_R_137_CGGACGAATC	CAAGCAGAAGACGGCATACGAGATCGGACGAATCAGGGTCAAGTGCACAGTCTA
s2_R_138_ATAGACGTAG	CAAGCAGAAGACGGCATACGAGATATAGACGTAGAGGGTCAAGTGCACAGTCTA
s2_R_139_AGTCTCCTGT	CAAGCAGAAGACGGCATACGAGATAGTCTCCTGTAGGGTCAAGTGCACAGTCTA
s2_R_140_CCTTACACGA	CAAGCAGAAGACGGCATACGAGATCCTTACACGAAGGGTCAAGTGCACAGTCTA
s2_R_141_ACGATGAGCT	CAAGCAGAAGACGGCATACGAGATACGATGAGCTAGGGTCAAGTGCACAGTCTA
s2_R_142_CGAGAGTGCT	CAAGCAGAAGACGGCATACGAGATCGAGAGTGCTAGGGTCAAGTGCACAGTCTA
s2_R_143_GGCTTAGTCT	CAAGCAGAAGACGGCATACGAGATGGCTTAGTCTAGGGTCAAGTGCACAGTCTA
s2_R_144_CACTGGTACT	CAAGCAGAAGACGGCATACGAGATCACTGGTACTAGGGTCAAGTGCACAGTCTA
s2_R_145_AGTTCGGATT	CAAGCAGAAGACGGCATACGAGATAGTTCGGATTAGGGTCAAGTGCACAGTCTA
s2_R_146_CATAGCGTAT	CAAGCAGAAGACGGCATACGAGATCATAGCGTATAGGGTCAAGTGCACAGTCTA
s2_R_147_TGTTCAACAC	CAAGCAGAAGACGGCATACGAGATTGTTCAACACAGGGTCAAGTGCACAGTCTA
s2_R_148_GAATCACGGA	CAAGCAGAAGACGGCATACGAGATGAATCACGGAAGGGTCAAGTGCACAGTCTA
s2_R_149_AACCACTGGT	CAAGCAGAAGACGGCATACGAGATAACCACTGGTAGGGTCAAGTGCACAGTCTA
s2_R_150_ATTCCGACTC	CAAGCAGAAGACGGCATACGAGATATTCCGACTCAGGGTCAAGTGCACAGTCTA
s2_R_151_GAGGCTTAGA	CAAGCAGAAGACGGCATACGAGATGAGGCTTAGAAGGGTCAAGTGCACAGTCTA
s2_R_152_CTGATACGGA	CAAGCAGAAGACGGCATACGAGATCTGATACGGAAGGGTCAAGTGCACAGTCTA
s2_R_153_GATTCCGAGT	CAAGCAGAAGACGGCATACGAGATGATTCCGAGTAGGGTCAAGTGCACAGTCTA
s2_R_154_CAAGGTAGGC	CAAGCAGAAGACGGCATACGAGATCAAGGTAGGCAGGGTCAAGTGCACAGTCTA
s2_R_155_TCAGTTGCCA	CAAGCAGAAGACGGCATACGAGATTCAGTTGCCAAGGGTCAAGTGCACAGTCTA
s2_R_156_GGAACGGTTA	CAAGCAGAAGACGGCATACGAGATGGAACGGTTAAGGGTCAAGTGCACAGTCTA
s2_R_157_ACAGCGTTGG	CAAGCAGAAGACGGCATACGAGATACAGCGTTGGAGGGTCAAGTGCACAGTCTA
s2_R_158_CCACGAATCG	CAAGCAGAAGACGGCATACGAGATCCACGAATCGAGGGTCAAGTGCACAGTCTA
s2_R_159_CTAGCCAACA	CAAGCAGAAGACGGCATACGAGATCTAGCCAACAAGGGTCAAGTGCACAGTCTA
s2_R_160_CAATCCGGTT	CAAGCAGAAGACGGCATACGAGATCAATCCGGTTAGGGTCAAGTGCACAGTCTA
s2_R_161_TTAGTGCGAG	CAAGCAGAAGACGGCATACGAGATTTAGTGCGAGAGGGTCAAGTGCACAGTCTA
s2_R_162_TGACATGCAG	CAAGCAGAAGACGGCATACGAGATTGACATGCAGAGGGTCAAGTGCACAGTCTA
s2_R_163_GGACTAGTAT	CAAGCAGAAGACGGCATACGAGATGGACTAGTATAGGGTCAAGTGCACAGTCTA
s2_R_164_TGTCCGGTGA	CAAGCAGAAGACGGCATACGAGATTGTCCGGTGAAGGGTCAAGTGCACAGTCTA
s2_R_165_ATTGTCCGTG	CAAGCAGAAGACGGCATACGAGATATTGTCCGTGAGGGTCAAGTGCACAGTCTA
s2_R_166_CTCCTAGGAC	CAAGCAGAAGACGGCATACGAGATCTCCTAGGACAGGGTCAAGTGCACAGTCTA
s2_R_167_CCATCGAGAG	CAAGCAGAAGACGGCATACGAGATCCATCGAGAGAGGGTCAAGTGCACAGTCTA
s2_R_168_TACCTTGGTA	CAAGCAGAAGACGGCATACGAGATTACCTTGGTAAGGGTCAAGTGCACAGTCTA
s2_R_169_CAACGTCGCT	CAAGCAGAAGACGGCATACGAGATCAACGTCGCTAGGGTCAAGTGCACAGTCTA
s2_R_170_CTCTCTTCGT	CAAGCAGAAGACGGCATACGAGATCTCTCTTCGTAGGGTCAAGTGCACAGTCTA
s2_R_171_TCGCCTTCAG	CAAGCAGAAGACGGCATACGAGATTCGCCTTCAGAGGGTCAAGTGCACAGTCTA
s2_R_172_GAATCTGTTC	CAAGCAGAAGACGGCATACGAGATGAATCTGTTCAGGGTCAAGTGCACAGTCTA
s2_R_173_CAGGAAGACC	CAAGCAGAAGACGGCATACGAGATCAGGAAGACCAGGGTCAAGTGCACAGTCTA
s2_R_174_GTCTCTTGCT	CAAGCAGAAGACGGCATACGAGATGTCTCTTGCTAGGGTCAAGTGCACAGTCTA
s2_R_175_CTCTAACTGT	CAAGCAGAAGACGGCATACGAGATCTCTAACTGTAGGGTCAAGTGCACAGTCTA
s2_R_176_TCCTGAGGTA	CAAGCAGAAGACGGCATACGAGATTCCTGAGGTAAGGGTCAAGTGCACAGTCTA
s2_R_177_AGCTAGTGAT	CAAGCAGAAGACGGCATACGAGATAGCTAGTGATAGGGTCAAGTGCACAGTCTA
s2_R_178_CACATCATGA	CAAGCAGAAGACGGCATACGAGATCACATCATGAAGGGTCAAGTGCACAGTCTA
s2_R_179_CCTAGTCTCA	CAAGCAGAAGACGGCATACGAGATCCTAGTCTCAAGGGTCAAGTGCACAGTCTA
s2_R_180_CCGTACTATC	CAAGCAGAAGACGGCATACGAGATCCGTACTATCAGGGTCAAGTGCACAGTCTA
s2_R_181_CTAGCCTTGT	CAAGCAGAAGACGGCATACGAGATCTAGCCTTGTAGGGTCAAGTGCACAGTCTA
s2_R_182_CTTAGTCAGG	CAAGCAGAAGACGGCATACGAGATCTTAGTCAGGAGGGTCAAGTGCACAGTCTA
s2_R_183_ACCTTGTCGT	CAAGCAGAAGACGGCATACGAGATACCTTGTCGTAGGGTCAAGTGCACAGTCTA
s2_R_184_ACCGTACAGT	CAAGCAGAAGACGGCATACGAGATACCGTACAGTAGGGTCAAGTGCACAGTCTA
s2_R_185_CCTCTGGCTT	CAAGCAGAAGACGGCATACGAGATCCTCTGGCTTAGGGTCAAGTGCACAGTCTA
s2_R_186_CTAGAGCAGT	CAAGCAGAAGACGGCATACGAGATCTAGAGCAGTAGGGTCAAGTGCACAGTCTA
s2_R_187_GTTCATCCGT	CAAGCAGAAGACGGCATACGAGATGTTCATCCGTAGGGTCAAGTGCACAGTCTA
s2_R_188_TGTCGGATTA	CAAGCAGAAGACGGCATACGAGATTGTCGGATTAAGGGTCAAGTGCACAGTCTA
s2_R_189_GTTCCGTATC	CAAGCAGAAGACGGCATACGAGATGTTCCGTATCAGGGTCAAGTGCACAGTCTA
s2_R_190_AAGACACTGT	CAAGCAGAAGACGGCATACGAGATAAGACACTGTAGGGTCAAGTGCACAGTCTA
s2_R_191_GAGCTTATGG	CAAGCAGAAGACGGCATACGAGATGAGCTTATGGAGGGTCAAGTGCACAGTCTA
s2_R_192_CCTGGATAGT	CAAGCAGAAGACGGCATACGAGATCCTGGATAGTAGGGTCAAGTGCACAGTCTA
s2_R_193_ACCGTTCGAG	CAAGCAGAAGACGGCATACGAGATACCGTTCGAGAGGGTCAAGTGCACAGTCTA
s2_R_194_GAAGGTAGCT	CAAGCAGAAGACGGCATACGAGATGAAGGTAGCTAGGGTCAAGTGCACAGTCTA
s2_R_195_CGACTATGGC	CAAGCAGAAGACGGCATACGAGATCGACTATGGCAGGGTCAAGTGCACAGTCTA
s2_R_196_CTTCTTACAG	CAAGCAGAAGACGGCATACGAGATCTTCTTACAGAGGGTCAAGTGCACAGTCTA
s2_R_197_CGAGATCTTA	CAAGCAGAAGACGGCATACGAGATCGAGATCTTAAGGGTCAAGTGCACAGTCTA
s2_R_198_GGTAACGTCC	CAAGCAGAAGACGGCATACGAGATGGTAACGTCCAGGGTCAAGTGCACAGTCTA
s2_R_199_AACACATCTC	CAAGCAGAAGACGGCATACGAGATAACACATCTCAGGGTCAAGTGCACAGTCTA
s2_R_200_TTAGATTGCC	CAAGCAGAAGACGGCATACGAGATTTAGATTGCCAGGGTCAAGTGCACAGTCTA
s2_R_201_CAGTGTGGTG	CAAGCAGAAGACGGCATACGAGATCAGTGTGGTGAGGGTCAAGTGCACAGTCTA
s2_R_202_GAGATTCCGG	CAAGCAGAAGACGGCATACGAGATGAGATTCCGGAGGGTCAAGTGCACAGTCTA
s2_R_203_GTGTGGCAAG	CAAGCAGAAGACGGCATACGAGATGTGTGGCAAGAGGGTCAAGTGCACAGTCTA
s2_R_204_CAGAATTCAG	CAAGCAGAAGACGGCATACGAGATCAGAATTCAGAGGGTCAAGTGCACAGTCTA
s2_R_205_GTTGCGGTGA	CAAGCAGAAGACGGCATACGAGATGTTGCGGTGAAGGGTCAAGTGCACAGTCTA
s2_R_206_TGTTCGTGGC	CAAGCAGAAGACGGCATACGAGATTGTTCGTGGCAGGGTCAAGTGCACAGTCTA
s2_R_207_ATCAGTGAAC	CAAGCAGAAGACGGCATACGAGATATCAGTGAACAGGGTCAAGTGCACAGTCTA
s2_R_208_CAAGTGACTT	CAAGCAGAAGACGGCATACGAGATCAAGTGACTTAGGGTCAAGTGCACAGTCTA
s2_R_209_GTTCTGTACT	CAAGCAGAAGACGGCATACGAGATGTTCTGTACTAGGGTCAAGTGCACAGTCTA
s2_R_210_ATAGTGGACA	CAAGCAGAAGACGGCATACGAGATATAGTGGACAAGGGTCAAGTGCACAGTCTA
s2_R_211_CGAACAGCGT	CAAGCAGAAGACGGCATACGAGATCGAACAGCGTAGGGTCAAGTGCACAGTCTA
s2_R_212_TGGCACTGGT	CAAGCAGAAGACGGCATACGAGATTGGCACTGGTAGGGTCAAGTGCACAGTCTA
s2_R_213_ATGACTCTGG	CAAGCAGAAGACGGCATACGAGATATGACTCTGGAGGGTCAAGTGCACAGTCTA
s2_R_214_TCGTAAGTAG	CAAGCAGAAGACGGCATACGAGATTCGTAAGTAGAGGGTCAAGTGCACAGTCTA
s2_R_215_CGCACAATTG	CAAGCAGAAGACGGCATACGAGATCGCACAATTGAGGGTCAAGTGCACAGTCTA
s2_R_216_TGTCGGCTAG	CAAGCAGAAGACGGCATACGAGATTGTCGGCTAGAGGGTCAAGTGCACAGTCTA
s2_R_217_GTTGCCTGGA	CAAGCAGAAGACGGCATACGAGATGTTGCCTGGAAGGGTCAAGTGCACAGTCTA
s2_R_218_GGTCGTAGAG	CAAGCAGAAGACGGCATACGAGATGGTCGTAGAGAGGGTCAAGTGCACAGTCTA
s2_R_219_ATACGTACTG	CAAGCAGAAGACGGCATACGAGATATACGTACTGAGGGTCAAGTGCACAGTCTA
s2_R_220_CAATGCGTCT	CAAGCAGAAGACGGCATACGAGATCAATGCGTCTAGGGTCAAGTGCACAGTCTA
s2_R_221_CCGGACTTGT	CAAGCAGAAGACGGCATACGAGATCCGGACTTGTAGGGTCAAGTGCACAGTCTA
s2_R_222_CAATGCTATC	CAAGCAGAAGACGGCATACGAGATCAATGCTATCAGGGTCAAGTGCACAGTCTA
s2_R_223_GAACCTGGAT	CAAGCAGAAGACGGCATACGAGATGAACCTGGATAGGGTCAAGTGCACAGTCTA
s2_R_224_GTAGTGTTCT	CAAGCAGAAGACGGCATACGAGATGTAGTGTTCTAGGGTCAAGTGCACAGTCTA
s2_R_225_CATACGAAGT	CAAGCAGAAGACGGCATACGAGATCATACGAAGTAGGGTCAAGTGCACAGTCTA
s2_R_226_CAGACCAGTC	CAAGCAGAAGACGGCATACGAGATCAGACCAGTCAGGGTCAAGTGCACAGTCTA
s2_R_227_GTAGTCGGAT	CAAGCAGAAGACGGCATACGAGATGTAGTCGGATAGGGTCAAGTGCACAGTCTA
s2_R_228_TGTAAGGCAG	CAAGCAGAAGACGGCATACGAGATTGTAAGGCAGAGGGTCAAGTGCACAGTCTA
s2_R_229_CACCAAGATC	CAAGCAGAAGACGGCATACGAGATCACCAAGATCAGGGTCAAGTGCACAGTCTA
s2_R_230_ACGTGTCGTT	CAAGCAGAAGACGGCATACGAGATACGTGTCGTTAGGGTCAAGTGCACAGTCTA
s2_R_231_CCTTCGATCC	CAAGCAGAAGACGGCATACGAGATCCTTCGATCCAGGGTCAAGTGCACAGTCTA
s2_R_232_AGTCCGTACC	CAAGCAGAAGACGGCATACGAGATAGTCCGTACCAGGGTCAAGTGCACAGTCTA
s2_R_233_CTAGGAATGG	CAAGCAGAAGACGGCATACGAGATCTAGGAATGGAGGGTCAAGTGCACAGTCTA
s2_R_234_GTGAAGCCAT	CAAGCAGAAGACGGCATACGAGATGTGAAGCCATAGGGTCAAGTGCACAGTCTA
s2_R_235_CAGTCTTGGA	CAAGCAGAAGACGGCATACGAGATCAGTCTTGGAAGGGTCAAGTGCACAGTCTA
s2_R_236_AGTCCTCGGA	CAAGCAGAAGACGGCATACGAGATAGTCCTCGGAAGGGTCAAGTGCACAGTCTA
s2_R_237_CCAGTTACCG	CAAGCAGAAGACGGCATACGAGATCCAGTTACCGAGGGTCAAGTGCACAGTCTA
s2_R_238_CTGTCTTATC	CAAGCAGAAGACGGCATACGAGATCTGTCTTATCAGGGTCAAGTGCACAGTCTA
s2_R_239_AACCGTACTA	CAAGCAGAAGACGGCATACGAGATAACCGTACTAAGGGTCAAGTGCACAGTCTA
s2_R_240_GGTAGTCCGA	CAAGCAGAAGACGGCATACGAGATGGTAGTCCGAAGGGTCAAGTGCACAGTCTA
s2_R_241_CCACATCGGA	CAAGCAGAAGACGGCATACGAGATCCACATCGGAAGGGTCAAGTGCACAGTCTA
s2_R_242_CTACAACGAA	CAAGCAGAAGACGGCATACGAGATCTACAACGAAAGGGTCAAGTGCACAGTCTA
s2_R_243_TCTCCTAAGT	CAAGCAGAAGACGGCATACGAGATTCTCCTAAGTAGGGTCAAGTGCACAGTCTA
s2_R_244_ACGTAAGAGT	CAAGCAGAAGACGGCATACGAGATACGTAAGAGTAGGGTCAAGTGCACAGTCTA
s2_R_245_CATAGGCTAC	CAAGCAGAAGACGGCATACGAGATCATAGGCTACAGGGTCAAGTGCACAGTCTA
s2_R_246_CTACGCCACT	CAAGCAGAAGACGGCATACGAGATCTACGCCACTAGGGTCAAGTGCACAGTCTA
s2_R_247_CTCCTGGTTA	CAAGCAGAAGACGGCATACGAGATCTCCTGGTTAAGGGTCAAGTGCACAGTCTA
s2_R_248_CCGACTTACT	CAAGCAGAAGACGGCATACGAGATCCGACTTACTAGGGTCAAGTGCACAGTCTA
s2_R_249_GTACCGATGT	CAAGCAGAAGACGGCATACGAGATGTACCGATGTAGGGTCAAGTGCACAGTCTA
s2_R_250_ATGGACGTTC	CAAGCAGAAGACGGCATACGAGATATGGACGTTCAGGGTCAAGTGCACAGTCTA
s2_R_251_CTGTAGGAAT	CAAGCAGAAGACGGCATACGAGATCTGTAGGAATAGGGTCAAGTGCACAGTCTA
s2_R_252_CAGTACGATG	CAAGCAGAAGACGGCATACGAGATCAGTACGATGAGGGTCAAGTGCACAGTCTA
s2_R_253_CGCCAATGTC	CAAGCAGAAGACGGCATACGAGATCGCCAATGTCAGGGTCAAGTGCACAGTCTA
s2_R_254_TGTACTAAGC	CAAGCAGAAGACGGCATACGAGATTGTACTAAGCAGGGTCAAGTGCACAGTCTA
s2_R_255_TAGTCGCGTA	CAAGCAGAAGACGGCATACGAGATTAGTCGCGTAAGGGTCAAGTGCACAGTCTA
s2_R_256_AAGATCGGAC	CAAGCAGAAGACGGCATACGAGATAAGATCGGACAGGGTCAAGTGCACAGTCTA
s2_R_257_CCAACACGAT	CAAGCAGAAGACGGCATACGAGATCCAACACGATAGGGTCAAGTGCACAGTCTA
s2_R_258_CCAGTAGCAT	CAAGCAGAAGACGGCATACGAGATCCAGTAGCATAGGGTCAAGTGCACAGTCTA
s2_R_259_AGCGTGTGGT	CAAGCAGAAGACGGCATACGAGATAGCGTGTGGTAGGGTCAAGTGCACAGTCTA
s2_R_260_CTACCTCTTC	CAAGCAGAAGACGGCATACGAGATCTACCTCTTCAGGGTCAAGTGCACAGTCTA
s2_R_261_CTTCCATGAT	CAAGCAGAAGACGGCATACGAGATCTTCCATGATAGGGTCAAGTGCACAGTCTA
s2_R_262_CATCTGGAGT	CAAGCAGAAGACGGCATACGAGATCATCTGGAGTAGGGTCAAGTGCACAGTCTA
s2_R_263_CCTTGCGGAA	CAAGCAGAAGACGGCATACGAGATCCTTGCGGAAAGGGTCAAGTGCACAGTCTA
s2_R_264_CATGTACTCA	CAAGCAGAAGACGGCATACGAGATCATGTACTCAAGGGTCAAGTGCACAGTCTA
s2_R_265_TTGATCGGAT	CAAGCAGAAGACGGCATACGAGATTTGATCGGATAGGGTCAAGTGCACAGTCTA
s2_R_266_ATGGATCTCA	CAAGCAGAAGACGGCATACGAGATATGGATCTCAAGGGTCAAGTGCACAGTCTA
s2_R_267_TTGCCTCAAC	CAAGCAGAAGACGGCATACGAGATTTGCCTCAACAGGGTCAAGTGCACAGTCTA
s2_R_268_CGGTGTCTGA	CAAGCAGAAGACGGCATACGAGATCGGTGTCTGAAGGGTCAAGTGCACAGTCTA
s2_R_269_TTATCGCTGT	CAAGCAGAAGACGGCATACGAGATTTATCGCTGTAGGGTCAAGTGCACAGTCTA
s2_R_270_CCATGATTCA	CAAGCAGAAGACGGCATACGAGATCCATGATTCAAGGGTCAAGTGCACAGTCTA
s2_R_271_CGAGTATATG	CAAGCAGAAGACGGCATACGAGATCGAGTATATGAGGGTCAAGTGCACAGTCTA
s2_R_272_AACTTCGTAC	CAAGCAGAAGACGGCATACGAGATAACTTCGTACAGGGTCAAGTGCACAGTCTA
s2_R_273_CTGGTTACGT	CAAGCAGAAGACGGCATACGAGATCTGGTTACGTAGGGTCAAGTGCACAGTCTA
s2_R_274_GGTCAATCAA	CAAGCAGAAGACGGCATACGAGATGGTCAATCAAAGGGTCAAGTGCACAGTCTA
s2_R_275_ATACCTTGCC	CAAGCAGAAGACGGCATACGAGATATACCTTGCCAGGGTCAAGTGCACAGTCTA
s2_R_276_CACTCCAACT	CAAGCAGAAGACGGCATACGAGATCACTCCAACTAGGGTCAAGTGCACAGTCTA
s2_R_277_CGACGGCTTA	CAAGCAGAAGACGGCATACGAGATCGACGGCTTAAGGGTCAAGTGCACAGTCTA
s2_R_278_AGCGGTGTAT	CAAGCAGAAGACGGCATACGAGATAGCGGTGTATAGGGTCAAGTGCACAGTCTA
s2_R_279_CTACATCTGT	CAAGCAGAAGACGGCATACGAGATCTACATCTGTAGGGTCAAGTGCACAGTCTA
s2_R_280_ACGTCGGATG	CAAGCAGAAGACGGCATACGAGATACGTCGGATGAGGGTCAAGTGCACAGTCTA
s2_R_281_CGTCGTAGTC	CAAGCAGAAGACGGCATACGAGATCGTCGTAGTCAGGGTCAAGTGCACAGTCTA
s2_R_282_CTTAACGATG	CAAGCAGAAGACGGCATACGAGATCTTAACGATGAGGGTCAAGTGCACAGTCTA
s2_R_283_GTACCGACAA	CAAGCAGAAGACGGCATACGAGATGTACCGACAAAGGGTCAAGTGCACAGTCTA
s2_R_284_CCAGTCAATG	CAAGCAGAAGACGGCATACGAGATCCAGTCAATGAGGGTCAAGTGCACAGTCTA
s2_R_285_ACATGCTTGT	CAAGCAGAAGACGGCATACGAGATACATGCTTGTAGGGTCAAGTGCACAGTCTA
s2_R_286_TGTCTGTAAC	CAAGCAGAAGACGGCATACGAGATTGTCTGTAACAGGGTCAAGTGCACAGTCTA
s2_R_287_AAGTCGGTAG	CAAGCAGAAGACGGCATACGAGATAAGTCGGTAGAGGGTCAAGTGCACAGTCTA
s2_R_288_AGCTGTATGT	CAAGCAGAAGACGGCATACGAGATAGCTGTATGTAGGGTCAAGTGCACAGTCTA
s2_R_289_TCAGTGGACG	CAAGCAGAAGACGGCATACGAGATTCAGTGGACGAGGGTCAAGTGCACAGTCTA
s2_R_290_CCTATCGACA	CAAGCAGAAGACGGCATACGAGATCCTATCGACAAGGGTCAAGTGCACAGTCTA
s2_R_291_CATAACACCG	CAAGCAGAAGACGGCATACGAGATCATAACACCGAGGGTCAAGTGCACAGTCTA
s2_R_292_TCCTCACCTG	CAAGCAGAAGACGGCATACGAGATTCCTCACCTGAGGGTCAAGTGCACAGTCTA
s2_R_293_AACGCGTATC	CAAGCAGAAGACGGCATACGAGATAACGCGTATCAGGGTCAAGTGCACAGTCTA
s2_R_294_CCTAAGTATC	CAAGCAGAAGACGGCATACGAGATCCTAAGTATCAGGGTCAAGTGCACAGTCTA
s2_R_295_CGGACTTCAT	CAAGCAGAAGACGGCATACGAGATCGGACTTCATAGGGTCAAGTGCACAGTCTA
s2_R_296_CTTCTAGCAT	CAAGCAGAAGACGGCATACGAGATCTTCTAGCATAGGGTCAAGTGCACAGTCTA
s2_R_297_GGAATCTCTA	CAAGCAGAAGACGGCATACGAGATGGAATCTCTAAGGGTCAAGTGCACAGTCTA
s2_R_298_TCCTACAAGT	CAAGCAGAAGACGGCATACGAGATTCCTACAAGTAGGGTCAAGTGCACAGTCTA
s2_R_299_CTGACGTTAA	CAAGCAGAAGACGGCATACGAGATCTGACGTTAAAGGGTCAAGTGCACAGTCTA
s2_R_300_ATCCAATCTC	CAAGCAGAAGACGGCATACGAGATATCCAATCTCAGGGTCAAGTGCACAGTCTA
s2_R_301_AAGTGGACTC	CAAGCAGAAGACGGCATACGAGATAAGTGGACTCAGGGTCAAGTGCACAGTCTA
s2_R_302_CTCTTATCAC	CAAGCAGAAGACGGCATACGAGATCTCTTATCACAGGGTCAAGTGCACAGTCTA
s2_R_303_GGACAACCGA	CAAGCAGAAGACGGCATACGAGATGGACAACCGAAGGGTCAAGTGCACAGTCTA
s2_R_304_AAGCACGATC	CAAGCAGAAGACGGCATACGAGATAAGCACGATCAGGGTCAAGTGCACAGTCTA
s2_R_305_CCTGTCTTGG	CAAGCAGAAGACGGCATACGAGATCCTGTCTTGGAGGGTCAAGTGCACAGTCTA
s2_R_306_CCGTAGCAAC	CAAGCAGAAGACGGCATACGAGATCCGTAGCAACAGGGTCAAGTGCACAGTCTA
s2_R_307_CTTCAAGCTG	CAAGCAGAAGACGGCATACGAGATCTTCAAGCTGAGGGTCAAGTGCACAGTCTA
s2_R_308_ACACAGACTC	CAAGCAGAAGACGGCATACGAGATACACAGACTCAGGGTCAAGTGCACAGTCTA
s2_R_309_GGACTTAACG	CAAGCAGAAGACGGCATACGAGATGGACTTAACGAGGGTCAAGTGCACAGTCTA
s2_R_310_GACCTTCAGT	CAAGCAGAAGACGGCATACGAGATGACCTTCAGTAGGGTCAAGTGCACAGTCTA
s2_R_311_GTCGCGTAAC	CAAGCAGAAGACGGCATACGAGATGTCGCGTAACAGGGTCAAGTGCACAGTCTA
s2_R_312_TACGGTCTTG	CAAGCAGAAGACGGCATACGAGATTACGGTCTTGAGGGTCAAGTGCACAGTCTA
s2_R_313_GTATTCGGCG	CAAGCAGAAGACGGCATACGAGATGTATTCGGCGAGGGTCAAGTGCACAGTCTA
s2_R_314_CTGAACGAAC	CAAGCAGAAGACGGCATACGAGATCTGAACGAACAGGGTCAAGTGCACAGTCTA
s2_R_315_TATTCGTACC	CAAGCAGAAGACGGCATACGAGATTATTCGTACCAGGGTCAAGTGCACAGTCTA
s2_R_316_CGTCAGGCAA	CAAGCAGAAGACGGCATACGAGATCGTCAGGCAAAGGGTCAAGTGCACAGTCTA
s2_R_317_CTATACGACC	CAAGCAGAAGACGGCATACGAGATCTATACGACCAGGGTCAAGTGCACAGTCTA
s2_R_318_CCACAACGTC	CAAGCAGAAGACGGCATACGAGATCCACAACGTCAGGGTCAAGTGCACAGTCTA
s2_R_319_CATAGCTAGA	CAAGCAGAAGACGGCATACGAGATCATAGCTAGAAGGGTCAAGTGCACAGTCTA
s2_R_320_CCACCTATGC	CAAGCAGAAGACGGCATACGAGATCCACCTATGCAGGGTCAAGTGCACAGTCTA
s2_R_321_ATGTGCTCCT	CAAGCAGAAGACGGCATACGAGATATGTGCTCCTAGGGTCAAGTGCACAGTCTA
s2_R_322_ACTGATGCGA	CAAGCAGAAGACGGCATACGAGATACTGATGCGAAGGGTCAAGTGCACAGTCTA
s2_R_323_GGAGCACGTA	CAAGCAGAAGACGGCATACGAGATGGAGCACGTAAGGGTCAAGTGCACAGTCTA
s2_R_324_GCTTCTAGTC	CAAGCAGAAGACGGCATACGAGATGCTTCTAGTCAGGGTCAAGTGCACAGTCTA
s2_R_325_CAGAGCGGAA	CAAGCAGAAGACGGCATACGAGATCAGAGCGGAAAGGGTCAAGTGCACAGTCTA
s2_R_326_CATGCATTCT	CAAGCAGAAGACGGCATACGAGATCATGCATTCTAGGGTCAAGTGCACAGTCTA
s2_R_327_GGTTGCACTG	CAAGCAGAAGACGGCATACGAGATGGTTGCACTGAGGGTCAAGTGCACAGTCTA
s2_R_328_CACCACCTCT	CAAGCAGAAGACGGCATACGAGATCACCACCTCTAGGGTCAAGTGCACAGTCTA
s2_R_329_AGACATCTCA	CAAGCAGAAGACGGCATACGAGATAGACATCTCAAGGGTCAAGTGCACAGTCTA
s2_R_330_CATTCTCAGA	CAAGCAGAAGACGGCATACGAGATCATTCTCAGAAGGGTCAAGTGCACAGTCTA
s2_R_331_GCTACAGTCT	CAAGCAGAAGACGGCATACGAGATGCTACAGTCTAGGGTCAAGTGCACAGTCTA
s2_R_332_ATCCTCGTCA	CAAGCAGAAGACGGCATACGAGATATCCTCGTCAAGGGTCAAGTGCACAGTCTA
s2_R_333_GTACGTTGTT	CAAGCAGAAGACGGCATACGAGATGTACGTTGTTAGGGTCAAGTGCACAGTCTA
s2_R_334_GATGGTCTCT	CAAGCAGAAGACGGCATACGAGATGATGGTCTCTAGGGTCAAGTGCACAGTCTA
s2_R_335_CATCGCCAAG	CAAGCAGAAGACGGCATACGAGATCATCGCCAAGAGGGTCAAGTGCACAGTCTA
s2_R_336_TCGTACAACA	CAAGCAGAAGACGGCATACGAGATTCGTACAACAAGGGTCAAGTGCACAGTCTA
s2_R_337_ACGTCCAACC	CAAGCAGAAGACGGCATACGAGATACGTCCAACCAGGGTCAAGTGCACAGTCTA
s2_R_338_CCAAGGCATG	CAAGCAGAAGACGGCATACGAGATCCAAGGCATGAGGGTCAAGTGCACAGTCTA
s2_R_339_TGTCAAGCCT	CAAGCAGAAGACGGCATACGAGATTGTCAAGCCTAGGGTCAAGTGCACAGTCTA
s2_R_340_CCAATCTTCG	CAAGCAGAAGACGGCATACGAGATCCAATCTTCGAGGGTCAAGTGCACAGTCTA
s2_R_341_GTCTGTATGG	CAAGCAGAAGACGGCATACGAGATGTCTGTATGGAGGGTCAAGTGCACAGTCTA
s2_R_342_CACAGAGCAG	CAAGCAGAAGACGGCATACGAGATCACAGAGCAGAGGGTCAAGTGCACAGTCTA
s2_R_343_AGGCATGTCG	CAAGCAGAAGACGGCATACGAGATAGGCATGTCGAGGGTCAAGTGCACAGTCTA
s2_R_344_ACACGTAAGG	CAAGCAGAAGACGGCATACGAGATACACGTAAGGAGGGTCAAGTGCACAGTCTA
s2_R_345_TGCACATCGT	CAAGCAGAAGACGGCATACGAGATTGCACATCGTAGGGTCAAGTGCACAGTCTA
s2_R_346_CTTCCGAAGG	CAAGCAGAAGACGGCATACGAGATCTTCCGAAGGAGGGTCAAGTGCACAGTCTA
s2_R_347_CCACACAGCT	CAAGCAGAAGACGGCATACGAGATCCACACAGCTAGGGTCAAGTGCACAGTCTA
s2_R_348_CGCCATAATT	CAAGCAGAAGACGGCATACGAGATCGCCATAATTAGGGTCAAGTGCACAGTCTA
s2_R_349_GGCACGCTAA	CAAGCAGAAGACGGCATACGAGATGGCACGCTAAAGGGTCAAGTGCACAGTCTA
s2_R_350_GCGAATCGTG	CAAGCAGAAGACGGCATACGAGATGCGAATCGTGAGGGTCAAGTGCACAGTCTA
s2_R_351_AGTTCGTTGT	CAAGCAGAAGACGGCATACGAGATAGTTCGTTGTAGGGTCAAGTGCACAGTCTA
s2_R_352_CTTGCTTGGC	CAAGCAGAAGACGGCATACGAGATCTTGCTTGGCAGGGTCAAGTGCACAGTCTA
s2_R_353_TATTCTCTCC	CAAGCAGAAGACGGCATACGAGATTATTCTCTCCAGGGTCAAGTGCACAGTCTA
s2_R_354_CGTATCTCTC	CAAGCAGAAGACGGCATACGAGATCGTATCTCTCAGGGTCAAGTGCACAGTCTA
s2_R_355_TTGTCCAGAT	CAAGCAGAAGACGGCATACGAGATTTGTCCAGATAGGGTCAAGTGCACAGTCTA
s2_R_356_TTGAGTACAC	CAAGCAGAAGACGGCATACGAGATTTGAGTACACAGGGTCAAGTGCACAGTCTA
s2_R_357_CTTGACTCCA	CAAGCAGAAGACGGCATACGAGATCTTGACTCCAAGGGTCAAGTGCACAGTCTA
s2_R_358_CATCTCAACA	CAAGCAGAAGACGGCATACGAGATCATCTCAACAAGGGTCAAGTGCACAGTCTA
s2_R_359_ACCTATAGCT	CAAGCAGAAGACGGCATACGAGATACCTATAGCTAGGGTCAAGTGCACAGTCTA
s2_R_360_AGACATGGAC	CAAGCAGAAGACGGCATACGAGATAGACATGGACAGGGTCAAGTGCACAGTCTA
s2_R_361_TCCGATCTAG	CAAGCAGAAGACGGCATACGAGATTCCGATCTAGAGGGTCAAGTGCACAGTCTA
s2_R_362_GATGTCTCAC	CAAGCAGAAGACGGCATACGAGATGATGTCTCACAGGGTCAAGTGCACAGTCTA
s2_R_363_CCAGGTTGTT	CAAGCAGAAGACGGCATACGAGATCCAGGTTGTTAGGGTCAAGTGCACAGTCTA
s2_R_364_CCTGGACGAT	CAAGCAGAAGACGGCATACGAGATCCTGGACGATAGGGTCAAGTGCACAGTCTA
s2_R_365_CATTCGACTA	CAAGCAGAAGACGGCATACGAGATCATTCGACTAAGGGTCAAGTGCACAGTCTA
s2_R_366_TCCGCGTACT	CAAGCAGAAGACGGCATACGAGATTCCGCGTACTAGGGTCAAGTGCACAGTCTA
s2_R_367_AACAGAGTGT	CAAGCAGAAGACGGCATACGAGATAACAGAGTGTAGGGTCAAGTGCACAGTCTA
s2_R_368_ACTAACGTGT	CAAGCAGAAGACGGCATACGAGATACTAACGTGTAGGGTCAAGTGCACAGTCTA
s2_R_369_CCGTTAGTGA	CAAGCAGAAGACGGCATACGAGATCCGTTAGTGAAGGGTCAAGTGCACAGTCTA
s2_R_370_ACCGACGTTA	CAAGCAGAAGACGGCATACGAGATACCGACGTTAAGGGTCAAGTGCACAGTCTA
s2_R_371_GTACGGAATC	CAAGCAGAAGACGGCATACGAGATGTACGGAATCAGGGTCAAGTGCACAGTCTA
s2_R_372_ATGGCCTTGA	CAAGCAGAAGACGGCATACGAGATATGGCCTTGAAGGGTCAAGTGCACAGTCTA
s2_R_373_CGGAACACGA	CAAGCAGAAGACGGCATACGAGATCGGAACACGAAGGGTCAAGTGCACAGTCTA
s2_R_374_ACTACGGATC	CAAGCAGAAGACGGCATACGAGATACTACGGATCAGGGTCAAGTGCACAGTCTA
s2_R_375_TCAGGTGTAC	CAAGCAGAAGACGGCATACGAGATTCAGGTGTACAGGGTCAAGTGCACAGTCTA
s2_R_376_GTGATTCTTG	CAAGCAGAAGACGGCATACGAGATGTGATTCTTGAGGGTCAAGTGCACAGTCTA
s2_R_377_ATAGGACCAC	CAAGCAGAAGACGGCATACGAGATATAGGACCACAGGGTCAAGTGCACAGTCTA
s2_R_378_ACTCGGAGAG	CAAGCAGAAGACGGCATACGAGATACTCGGAGAGAGGGTCAAGTGCACAGTCTA
s2_R_379_CATCGGAACT	CAAGCAGAAGACGGCATACGAGATCATCGGAACTAGGGTCAAGTGCACAGTCTA
s2_R_380_TCGGCACATC	CAAGCAGAAGACGGCATACGAGATTCGGCACATCAGGGTCAAGTGCACAGTCTA
s2_R_381_ATCCTGCGGT	CAAGCAGAAGACGGCATACGAGATATCCTGCGGTAGGGTCAAGTGCACAGTCTA
s2_R_382_GAACCAATGA	CAAGCAGAAGACGGCATACGAGATGAACCAATGAAGGGTCAAGTGCACAGTCTA
s2_R_383_ACGGATGTTG	CAAGCAGAAGACGGCATACGAGATACGGATGTTGAGGGTCAAGTGCACAGTCTA
s2_R_384_AATCCAACAC	CAAGCAGAAGACGGCATACGAGATAATCCAACACAGGGTCAAGTGCACAGTCTA
s2_R_385_CATCACGTGT	CAAGCAGAAGACGGCATACGAGATCATCACGTGTAGGGTCAAGTGCACAGTCTA
s2_R_386_TCGCACAGAG	CAAGCAGAAGACGGCATACGAGATTCGCACAGAGAGGGTCAAGTGCACAGTCTA
s2_R_387_GACTGAAGTC	CAAGCAGAAGACGGCATACGAGATGACTGAAGTCAGGGTCAAGTGCACAGTCTA
s2_R_388_ACAGTGATCC	CAAGCAGAAGACGGCATACGAGATACAGTGATCCAGGGTCAAGTGCACAGTCTA
s2_R_389_TTGACGTAGA	CAAGCAGAAGACGGCATACGAGATTTGACGTAGAAGGGTCAAGTGCACAGTCTA
s2_R_390_TTCGGCATGA	CAAGCAGAAGACGGCATACGAGATTTCGGCATGAAGGGTCAAGTGCACAGTCTA
s2_R_391_CATCTTCGGT	CAAGCAGAAGACGGCATACGAGATCATCTTCGGTAGGGTCAAGTGCACAGTCTA
s2_R_392_ATTCACGTAC	CAAGCAGAAGACGGCATACGAGATATTCACGTACAGGGTCAAGTGCACAGTCTA
s2_R_393_GTTCGCGTCA	CAAGCAGAAGACGGCATACGAGATGTTCGCGTCAAGGGTCAAGTGCACAGTCTA
s2_R_394_AGAACGTGCC	CAAGCAGAAGACGGCATACGAGATAGAACGTGCCAGGGTCAAGTGCACAGTCTA
s2_R_395_TTGGTCACTT	CAAGCAGAAGACGGCATACGAGATTTGGTCACTTAGGGTCAAGTGCACAGTCTA
s2_R_396_CAGGTAAGAT	CAAGCAGAAGACGGCATACGAGATCAGGTAAGATAGGGTCAAGTGCACAGTCTA
s2_R_397_TGGTCATCCT	CAAGCAGAAGACGGCATACGAGATTGGTCATCCTAGGGTCAAGTGCACAGTCTA
s2_R_398_TCGGAATTGA	CAAGCAGAAGACGGCATACGAGATTCGGAATTGAAGGGTCAAGTGCACAGTCTA
s2_R_399_TAGTGGCTGG	CAAGCAGAAGACGGCATACGAGATTAGTGGCTGGAGGGTCAAGTGCACAGTCTA
s2_R_400_GGTGAGTACT	CAAGCAGAAGACGGCATACGAGATGGTGAGTACTAGGGTCAAGTGCACAGTCTA
s2_R_401_CCGTACTGAG	CAAGCAGAAGACGGCATACGAGATCCGTACTGAGAGGGTCAAGTGCACAGTCTA
s2_R_402_ATTGAGCGTA	CAAGCAGAAGACGGCATACGAGATATTGAGCGTAAGGGTCAAGTGCACAGTCTA
s2_R_403_CTAATGGTTC	CAAGCAGAAGACGGCATACGAGATCTAATGGTTCAGGGTCAAGTGCACAGTCTA
s2_R_404_CTACATGGAT	CAAGCAGAAGACGGCATACGAGATCTACATGGATAGGGTCAAGTGCACAGTCTA
s2_R_405_CTATTCACTG	CAAGCAGAAGACGGCATACGAGATCTATTCACTGAGGGTCAAGTGCACAGTCTA
s2_R_406_GCGTTCAGAT	CAAGCAGAAGACGGCATACGAGATGCGTTCAGATAGGGTCAAGTGCACAGTCTA
s2_R_407_TAGACTGTCG	CAAGCAGAAGACGGCATACGAGATTAGACTGTCGAGGGTCAAGTGCACAGTCTA
s2_R_408_CCAATCTCAA	CAAGCAGAAGACGGCATACGAGATCCAATCTCAAAGGGTCAAGTGCACAGTCTA
s2_R_409_TTCCGAACAA	CAAGCAGAAGACGGCATACGAGATTTCCGAACAAAGGGTCAAGTGCACAGTCTA
s2_R_410_AGAGGTGCAG	CAAGCAGAAGACGGCATACGAGATAGAGGTGCAGAGGGTCAAGTGCACAGTCTA
s2_R_411_GGAGATCCTG	CAAGCAGAAGACGGCATACGAGATGGAGATCCTGAGGGTCAAGTGCACAGTCTA
s2_R_412_GTCCGTGTTA	CAAGCAGAAGACGGCATACGAGATGTCCGTGTTAAGGGTCAAGTGCACAGTCTA
s2_R_413_ACTTAGACAC	CAAGCAGAAGACGGCATACGAGATACTTAGACACAGGGTCAAGTGCACAGTCTA
s2_R_414_GGCTTGATCC	CAAGCAGAAGACGGCATACGAGATGGCTTGATCCAGGGTCAAGTGCACAGTCTA
s2_R_415_AATTCTGCGG	CAAGCAGAAGACGGCATACGAGATAATTCTGCGGAGGGTCAAGTGCACAGTCTA
s2_R_416_TTCATGATGG	CAAGCAGAAGACGGCATACGAGATTTCATGATGGAGGGTCAAGTGCACAGTCTA
s2_R_417_CCTACCTTCC	CAAGCAGAAGACGGCATACGAGATCCTACCTTCCAGGGTCAAGTGCACAGTCTA
s2_R_418_CCACGGATAC	CAAGCAGAAGACGGCATACGAGATCCACGGATACAGGGTCAAGTGCACAGTCTA
s2_R_419_CTTCCAGTAA	CAAGCAGAAGACGGCATACGAGATCTTCCAGTAAAGGGTCAAGTGCACAGTCTA
s2_R_420_CTTACAACAG	CAAGCAGAAGACGGCATACGAGATCTTACAACAGAGGGTCAAGTGCACAGTCTA
s2_R_421_TCTCTTGAAG	CAAGCAGAAGACGGCATACGAGATTCTCTTGAAGAGGGTCAAGTGCACAGTCTA
s2_R_422_AGTCCAGGAT	CAAGCAGAAGACGGCATACGAGATAGTCCAGGATAGGGTCAAGTGCACAGTCTA
s2_R_423_AGGTTCCGTG	CAAGCAGAAGACGGCATACGAGATAGGTTCCGTGAGGGTCAAGTGCACAGTCTA
s2_R_424_TCGTCACTGT	CAAGCAGAAGACGGCATACGAGATTCGTCACTGTAGGGTCAAGTGCACAGTCTA
s2_R_425_CCACTTCGTT	CAAGCAGAAGACGGCATACGAGATCCACTTCGTTAGGGTCAAGTGCACAGTCTA
s2_R_426_ATCCGGAAGC	CAAGCAGAAGACGGCATACGAGATATCCGGAAGCAGGGTCAAGTGCACAGTCTA
s2_R_427_TCTCCATTCA	CAAGCAGAAGACGGCATACGAGATTCTCCATTCAAGGGTCAAGTGCACAGTCTA
s2_R_428_CACCACCGAA	CAAGCAGAAGACGGCATACGAGATCACCACCGAAAGGGTCAAGTGCACAGTCTA
s2_R_429_CGAATTGGCT	CAAGCAGAAGACGGCATACGAGATCGAATTGGCTAGGGTCAAGTGCACAGTCTA
s2_R_430_CCTGTCGGAT	CAAGCAGAAGACGGCATACGAGATCCTGTCGGATAGGGTCAAGTGCACAGTCTA
s2_R_431_GCTTGTACTA	CAAGCAGAAGACGGCATACGAGATGCTTGTACTAAGGGTCAAGTGCACAGTCTA
s2_R_432_TACGATAGGT	CAAGCAGAAGACGGCATACGAGATTACGATAGGTAGGGTCAAGTGCACAGTCTA
s2_R_433_AGAGTAGCAC	CAAGCAGAAGACGGCATACGAGATAGAGTAGCACAGGGTCAAGTGCACAGTCTA
s2_R_434_CCGAGGATAG	CAAGCAGAAGACGGCATACGAGATCCGAGGATAGAGGGTCAAGTGCACAGTCTA
s2_R_435_CCGAGAAGAA	CAAGCAGAAGACGGCATACGAGATCCGAGAAGAAAGGGTCAAGTGCACAGTCTA
s2_R_436_CCGATAGGAG	CAAGCAGAAGACGGCATACGAGATCCGATAGGAGAGGGTCAAGTGCACAGTCTA
s2_R_437_CCTATACCAT	CAAGCAGAAGACGGCATACGAGATCCTATACCATAGGGTCAAGTGCACAGTCTA
s2_R_438_CCACTAGATG	CAAGCAGAAGACGGCATACGAGATCCACTAGATGAGGGTCAAGTGCACAGTCTA
s2_R_439_AGTTGTGATC	CAAGCAGAAGACGGCATACGAGATAGTTGTGATCAGGGTCAAGTGCACAGTCTA
s2_R_440_CTAGTAAGAC	CAAGCAGAAGACGGCATACGAGATCTAGTAAGACAGGGTCAAGTGCACAGTCTA
s2_R_441_TATGCATGTC	CAAGCAGAAGACGGCATACGAGATTATGCATGTCAGGGTCAAGTGCACAGTCTA
s2_R_442_GCGTATACAA	CAAGCAGAAGACGGCATACGAGATGCGTATACAAAGGGTCAAGTGCACAGTCTA
s2_R_443_ACGAGTCCGA	CAAGCAGAAGACGGCATACGAGATACGAGTCCGAAGGGTCAAGTGCACAGTCTA
s2_R_444_CAATCTAGCG	CAAGCAGAAGACGGCATACGAGATCAATCTAGCGAGGGTCAAGTGCACAGTCTA
s2_R_445_ACCTTCCGGT	CAAGCAGAAGACGGCATACGAGATACCTTCCGGTAGGGTCAAGTGCACAGTCTA
s2_R_446_CCTGCCAGAA	CAAGCAGAAGACGGCATACGAGATCCTGCCAGAAAGGGTCAAGTGCACAGTCTA
s2_R_447_CAGGTATGTC	CAAGCAGAAGACGGCATACGAGATCAGGTATGTCAGGGTCAAGTGCACAGTCTA
s2_R_448_AGAGAATCTC	CAAGCAGAAGACGGCATACGAGATAGAGAATCTCAGGGTCAAGTGCACAGTCTA
s2_R_449_CTCCGGTATC	CAAGCAGAAGACGGCATACGAGATCTCCGGTATCAGGGTCAAGTGCACAGTCTA
s2_R_450_CTTCGGTAAG	CAAGCAGAAGACGGCATACGAGATCTTCGGTAAGAGGGTCAAGTGCACAGTCTA
s2_R_451_CGTCGGTTCT	CAAGCAGAAGACGGCATACGAGATCGTCGGTTCTAGGGTCAAGTGCACAGTCTA
s2_R_452_CTAATCGGTA	CAAGCAGAAGACGGCATACGAGATCTAATCGGTAAGGGTCAAGTGCACAGTCTA
s2_R_453_GTGGACGCTT	CAAGCAGAAGACGGCATACGAGATGTGGACGCTTAGGGTCAAGTGCACAGTCTA
s2_R_454_CGTGTCGGTA	CAAGCAGAAGACGGCATACGAGATCGTGTCGGTAAGGGTCAAGTGCACAGTCTA
s2_R_455_TCACGTCTGG	CAAGCAGAAGACGGCATACGAGATTCACGTCTGGAGGGTCAAGTGCACAGTCTA
s2_R_456_CCGACCTGAT	CAAGCAGAAGACGGCATACGAGATCCGACCTGATAGGGTCAAGTGCACAGTCTA
s2_R_457_AATCGACCTA	CAAGCAGAAGACGGCATACGAGATAATCGACCTAAGGGTCAAGTGCACAGTCTA
s2_R_458_GTACGCTTCT	CAAGCAGAAGACGGCATACGAGATGTACGCTTCTAGGGTCAAGTGCACAGTCTA
s2_R_459_TACTCTGTGG	CAAGCAGAAGACGGCATACGAGATTACTCTGTGGAGGGTCAAGTGCACAGTCTA
s2_R_460_ACTTCATCTC	CAAGCAGAAGACGGCATACGAGATACTTCATCTCAGGGTCAAGTGCACAGTCTA
s2_R_461_CCATTGGTTA	CAAGCAGAAGACGGCATACGAGATCCATTGGTTAAGGGTCAAGTGCACAGTCTA
s2_R_462_ACCGAAGTGT	CAAGCAGAAGACGGCATACGAGATACCGAAGTGTAGGGTCAAGTGCACAGTCTA
s2_R_463_TACATCGTTG	CAAGCAGAAGACGGCATACGAGATTACATCGTTGAGGGTCAAGTGCACAGTCTA
s2_R_464_GTGTCTAACG	CAAGCAGAAGACGGCATACGAGATGTGTCTAACGAGGGTCAAGTGCACAGTCTA
s2_R_465_TCCATGTTCG	CAAGCAGAAGACGGCATACGAGATTCCATGTTCGAGGGTCAAGTGCACAGTCTA
s2_R_466_TACTAGCTGT	CAAGCAGAAGACGGCATACGAGATTACTAGCTGTAGGGTCAAGTGCACAGTCTA
s2_R_467_ACGACACTTC	CAAGCAGAAGACGGCATACGAGATACGACACTTCAGGGTCAAGTGCACAGTCTA
s2_R_468_CATGAGTGCC	CAAGCAGAAGACGGCATACGAGATCATGAGTGCCAGGGTCAAGTGCACAGTCTA
s2_R_469_TCGTAGTACC	CAAGCAGAAGACGGCATACGAGATTCGTAGTACCAGGGTCAAGTGCACAGTCTA
s2_R_470_CTTCTCAAGT	CAAGCAGAAGACGGCATACGAGATCTTCTCAAGTAGGGTCAAGTGCACAGTCTA
s2_R_471_GGTAGGCCAT	CAAGCAGAAGACGGCATACGAGATGGTAGGCCATAGGGTCAAGTGCACAGTCTA
s2_R_472_TCATCCGGCT	CAAGCAGAAGACGGCATACGAGATTCATCCGGCTAGGGTCAAGTGCACAGTCTA
s2_R_473_GGACGATAGT	CAAGCAGAAGACGGCATACGAGATGGACGATAGTAGGGTCAAGTGCACAGTCTA
s2_R_474_CAACGGAGTT	CAAGCAGAAGACGGCATACGAGATCAACGGAGTTAGGGTCAAGTGCACAGTCTA
s2_R_475_CTATTGGACT	CAAGCAGAAGACGGCATACGAGATCTATTGGACTAGGGTCAAGTGCACAGTCTA
s2_R_476_CAAGCTCCGA	CAAGCAGAAGACGGCATACGAGATCAAGCTCCGAAGGGTCAAGTGCACAGTCTA
s2_R_477_CCAACTCCTC	CAAGCAGAAGACGGCATACGAGATCCAACTCCTCAGGGTCAAGTGCACAGTCTA
s2_R_478_TGCGACGACA	CAAGCAGAAGACGGCATACGAGATTGCGACGACAAGGGTCAAGTGCACAGTCTA
s2_R_479_AGAACCGTAG	CAAGCAGAAGACGGCATACGAGATAGAACCGTAGAGGGTCAAGTGCACAGTCTA
s2_R_480_GGTTCAATGA	CAAGCAGAAGACGGCATACGAGATGGTTCAATGAAGGGTCAAGTGCACAGTCTA
s2_R_481_ACCAACCGTT	CAAGCAGAAGACGGCATACGAGATACCAACCGTTAGGGTCAAGTGCACAGTCTA
s2_R_482_CCTCATATCA	CAAGCAGAAGACGGCATACGAGATCCTCATATCAAGGGTCAAGTGCACAGTCTA
s2_R_483_GTAAGAGCAT	CAAGCAGAAGACGGCATACGAGATGTAAGAGCATAGGGTCAAGTGCACAGTCTA
s2_R_484_CCATGCAATT	CAAGCAGAAGACGGCATACGAGATCCATGCAATTAGGGTCAAGTGCACAGTCTA
s2_R_485_CAGGCTACAA	CAAGCAGAAGACGGCATACGAGATCAGGCTACAAAGGGTCAAGTGCACAGTCTA
s2_R_486_CTACAAGGCC	CAAGCAGAAGACGGCATACGAGATCTACAAGGCCAGGGTCAAGTGCACAGTCTA
s2_R_487_CTACTGAGAG	CAAGCAGAAGACGGCATACGAGATCTACTGAGAGAGGGTCAAGTGCACAGTCTA
s2_R_488_TACGGCAGTT	CAAGCAGAAGACGGCATACGAGATTACGGCAGTTAGGGTCAAGTGCACAGTCTA
s2_R_489_TCGACTTCGT	CAAGCAGAAGACGGCATACGAGATTCGACTTCGTAGGGTCAAGTGCACAGTCTA
s2_R_490_CTACCTTACT	CAAGCAGAAGACGGCATACGAGATCTACCTTACTAGGGTCAAGTGCACAGTCTA
s2_R_491_GGCCTAAGAG	CAAGCAGAAGACGGCATACGAGATGGCCTAAGAGAGGGTCAAGTGCACAGTCTA
s2_R_492_TGAAGCGGAT	CAAGCAGAAGACGGCATACGAGATTGAAGCGGATAGGGTCAAGTGCACAGTCTA
s2_R_493_CTTGCTAACT	CAAGCAGAAGACGGCATACGAGATCTTGCTAACTAGGGTCAAGTGCACAGTCTA
s2_R_494_TGCTGACGGT	CAAGCAGAAGACGGCATACGAGATTGCTGACGGTAGGGTCAAGTGCACAGTCTA
s2_R_495_AGCGGTAAGG	CAAGCAGAAGACGGCATACGAGATAGCGGTAAGGAGGGTCAAGTGCACAGTCTA
s2_R_496_GGTTCGTGAT	CAAGCAGAAGACGGCATACGAGATGGTTCGTGATAGGGTCAAGTGCACAGTCTA
s2_R_497_ACAACAACCT	CAAGCAGAAGACGGCATACGAGATACAACAACCTAGGGTCAAGTGCACAGTCTA
s2_R_498_AGTGGCCTCA	CAAGCAGAAGACGGCATACGAGATAGTGGCCTCAAGGGTCAAGTGCACAGTCTA
s2_R_499_CATGGTGCAT	CAAGCAGAAGACGGCATACGAGATCATGGTGCATAGGGTCAAGTGCACAGTCTA
s2_R_500_TGGAACGATC	CAAGCAGAAGACGGCATACGAGATTGGAACGATCAGGGTCAAGTGCACAGTCTA
s2_R_501_ATGCGTGGAC	CAAGCAGAAGACGGCATACGAGATATGCGTGGACAGGGTCAAGTGCACAGTCTA
s2_R_502_TGGTTGTCGT	CAAGCAGAAGACGGCATACGAGATTGGTTGTCGTAGGGTCAAGTGCACAGTCTA
s2_R_503_TAAGTCGTGG	CAAGCAGAAGACGGCATACGAGATTAAGTCGTGGAGGGTCAAGTGCACAGTCTA
s2_R_504_CTAGGACTCT	CAAGCAGAAGACGGCATACGAGATCTAGGACTCTAGGGTCAAGTGCACAGTCTA
s2_R_505_CATGTAACAC	CAAGCAGAAGACGGCATACGAGATCATGTAACACAGGGTCAAGTGCACAGTCTA
s2_R_506_TGCAGACGTA	CAAGCAGAAGACGGCATACGAGATTGCAGACGTAAGGGTCAAGTGCACAGTCTA
s2_R_507_GGTACGGTAG	CAAGCAGAAGACGGCATACGAGATGGTACGGTAGAGGGTCAAGTGCACAGTCTA
s2_R_508_ACGGAATTCT	CAAGCAGAAGACGGCATACGAGATACGGAATTCTAGGGTCAAGTGCACAGTCTA
s2_R_509_GGTCACGATC	CAAGCAGAAGACGGCATACGAGATGGTCACGATCAGGGTCAAGTGCACAGTCTA
s2_R_510_TAGTCATCTC	CAAGCAGAAGACGGCATACGAGATTAGTCATCTCAGGGTCAAGTGCACAGTCTA
s2_R_511_CTAAGCAGAA	CAAGCAGAAGACGGCATACGAGATCTAAGCAGAAAGGGTCAAGTGCACAGTCTA
s2_R_512_GTGACGACTA	CAAGCAGAAGACGGCATACGAGATGTGACGACTAAGGGTCAAGTGCACAGTCTA
s2_R_513_CCTTGTGAGG	CAAGCAGAAGACGGCATACGAGATCCTTGTGAGGAGGGTCAAGTGCACAGTCTA
s2_R_514_TGTACTGCGG	CAAGCAGAAGACGGCATACGAGATTGTACTGCGGAGGGTCAAGTGCACAGTCTA
s2_R_515_CTACGGTTCG	CAAGCAGAAGACGGCATACGAGATCTACGGTTCGAGGGTCAAGTGCACAGTCTA
s2_R_516_ACCTGAGCAG	CAAGCAGAAGACGGCATACGAGATACCTGAGCAGAGGGTCAAGTGCACAGTCTA
s2_R_517_TTCGTAGAAC	CAAGCAGAAGACGGCATACGAGATTTCGTAGAACAGGGTCAAGTGCACAGTCTA
s2_R_518_AGGACGAAGA	CAAGCAGAAGACGGCATACGAGATAGGACGAAGAAGGGTCAAGTGCACAGTCTA
s2_R_519_CAATTCTTGG	CAAGCAGAAGACGGCATACGAGATCAATTCTTGGAGGGTCAAGTGCACAGTCTA
s2_R_520_CAAGAATGGC	CAAGCAGAAGACGGCATACGAGATCAAGAATGGCAGGGTCAAGTGCACAGTCTA
s2_R_521_CTTAAGGCAT	CAAGCAGAAGACGGCATACGAGATCTTAAGGCATAGGGTCAAGTGCACAGTCTA
s2_R_522_CGACCTCTGA	CAAGCAGAAGACGGCATACGAGATCGACCTCTGAAGGGTCAAGTGCACAGTCTA
s2_R_523_GCATCGTAAG	CAAGCAGAAGACGGCATACGAGATGCATCGTAAGAGGGTCAAGTGCACAGTCTA
s2_R_524_AGTATCCAAC	CAAGCAGAAGACGGCATACGAGATAGTATCCAACAGGGTCAAGTGCACAGTCTA
s2_R_525_ACAACCGAGT	CAAGCAGAAGACGGCATACGAGATACAACCGAGTAGGGTCAAGTGCACAGTCTA
s2_R_526_ATCAGCTCAG	CAAGCAGAAGACGGCATACGAGATATCAGCTCAGAGGGTCAAGTGCACAGTCTA
s2_R_527_CTTGCGTTCC	CAAGCAGAAGACGGCATACGAGATCTTGCGTTCCAGGGTCAAGTGCACAGTCTA
s2_R_528_GCTTGCTCCT	CAAGCAGAAGACGGCATACGAGATGCTTGCTCCTAGGGTCAAGTGCACAGTCTA
s2_R_529_GATCCATGGT	CAAGCAGAAGACGGCATACGAGATGATCCATGGTAGGGTCAAGTGCACAGTCTA
s2_R_530_CCGACAGATT	CAAGCAGAAGACGGCATACGAGATCCGACAGATTAGGGTCAAGTGCACAGTCTA
s2_R_531_AACCGTGCCT	CAAGCAGAAGACGGCATACGAGATAACCGTGCCTAGGGTCAAGTGCACAGTCTA
s2_R_532_GCATTCGGAC	CAAGCAGAAGACGGCATACGAGATGCATTCGGACAGGGTCAAGTGCACAGTCTA
s2_R_533_GCTTGTCGGT	CAAGCAGAAGACGGCATACGAGATGCTTGTCGGTAGGGTCAAGTGCACAGTCTA
s2_R_534_ATGACTCCTC	CAAGCAGAAGACGGCATACGAGATATGACTCCTCAGGGTCAAGTGCACAGTCTA
s2_R_535_CAGGAGAGAA	CAAGCAGAAGACGGCATACGAGATCAGGAGAGAAAGGGTCAAGTGCACAGTCTA
s2_R_536_GCGTCCGTAA	CAAGCAGAAGACGGCATACGAGATGCGTCCGTAAAGGGTCAAGTGCACAGTCTA
s2_R_537_TCTGTCCTAC	CAAGCAGAAGACGGCATACGAGATTCTGTCCTACAGGGTCAAGTGCACAGTCTA
s2_R_538_TCGAGCGTTG	CAAGCAGAAGACGGCATACGAGATTCGAGCGTTGAGGGTCAAGTGCACAGTCTA
s2_R_539_TCGAGGAACT	CAAGCAGAAGACGGCATACGAGATTCGAGGAACTAGGGTCAAGTGCACAGTCTA
s2_R_540_TCGACGATGT	CAAGCAGAAGACGGCATACGAGATTCGACGATGTAGGGTCAAGTGCACAGTCTA
s2_R_541_TCGAGAGATC	CAAGCAGAAGACGGCATACGAGATTCGAGAGATCAGGGTCAAGTGCACAGTCTA
s2_R_542_TCGCCATGAT	CAAGCAGAAGACGGCATACGAGATTCGCCATGATAGGGTCAAGTGCACAGTCTA
s2_R_543_GTCTCAATCA	CAAGCAGAAGACGGCATACGAGATGTCTCAATCAAGGGTCAAGTGCACAGTCTA
s2_R_544_GATCTGAGGA	CAAGCAGAAGACGGCATACGAGATGATCTGAGGAAGGGTCAAGTGCACAGTCTA
s2_R_545_ACGCCAACAG	CAAGCAGAAGACGGCATACGAGATACGCCAACAGAGGGTCAAGTGCACAGTCTA
s2_R_546_GTCCAGATTC	CAAGCAGAAGACGGCATACGAGATGTCCAGATTCAGGGTCAAGTGCACAGTCTA
s2_R_547_ATCCGACGAA	CAAGCAGAAGACGGCATACGAGATATCCGACGAAAGGGTCAAGTGCACAGTCTA
s2_R_548_CCAATATCTC	CAAGCAGAAGACGGCATACGAGATCCAATATCTCAGGGTCAAGTGCACAGTCTA
s2_R_549_GTTAGTCGTC	CAAGCAGAAGACGGCATACGAGATGTTAGTCGTCAGGGTCAAGTGCACAGTCTA
s2_R_550_GGTGCGAATG	CAAGCAGAAGACGGCATACGAGATGGTGCGAATGAGGGTCAAGTGCACAGTCTA
s2_R_551_GTAGTAGTAC	CAAGCAGAAGACGGCATACGAGATGTAGTAGTACAGGGTCAAGTGCACAGTCTA
s2_R_552_CCTCCGAGAT	CAAGCAGAAGACGGCATACGAGATCCTCCGAGATAGGGTCAAGTGCACAGTCTA
s2_R_553_AACGATCAGG	CAAGCAGAAGACGGCATACGAGATAACGATCAGGAGGGTCAAGTGCACAGTCTA
s2_R_554_CAGGATATGA	CAAGCAGAAGACGGCATACGAGATCAGGATATGAAGGGTCAAGTGCACAGTCTA
s2_R_555_TCTGGCCAAT	CAAGCAGAAGACGGCATACGAGATTCTGGCCAATAGGGTCAAGTGCACAGTCTA
s2_R_556_TGTGTCGGAG	CAAGCAGAAGACGGCATACGAGATTGTGTCGGAGAGGGTCAAGTGCACAGTCTA
s2_R_557_CCGTATAAGG	CAAGCAGAAGACGGCATACGAGATCCGTATAAGGAGGGTCAAGTGCACAGTCTA
s2_R_558_GCGTAGAGTA	CAAGCAGAAGACGGCATACGAGATGCGTAGAGTAAGGGTCAAGTGCACAGTCTA
s2_R_559_ACGCTATGTT	CAAGCAGAAGACGGCATACGAGATACGCTATGTTAGGGTCAAGTGCACAGTCTA
s2_R_560_CTTGACACGT	CAAGCAGAAGACGGCATACGAGATCTTGACACGTAGGGTCAAGTGCACAGTCTA
s2_R_561_CGTATCAGGA	CAAGCAGAAGACGGCATACGAGATCGTATCAGGAAGGGTCAAGTGCACAGTCTA
s2_R_562_GGTCATCTTC	CAAGCAGAAGACGGCATACGAGATGGTCATCTTCAGGGTCAAGTGCACAGTCTA
s2_R_563_TAGCACGGTT	CAAGCAGAAGACGGCATACGAGATTAGCACGGTTAGGGTCAAGTGCACAGTCTA
s2_R_564_TCACGCCATT	CAAGCAGAAGACGGCATACGAGATTCACGCCATTAGGGTCAAGTGCACAGTCTA
s2_R_565_CCGACCATAC	CAAGCAGAAGACGGCATACGAGATCCGACCATACAGGGTCAAGTGCACAGTCTA
s2_R_566_GACTCTCACA	CAAGCAGAAGACGGCATACGAGATGACTCTCACAAGGGTCAAGTGCACAGTCTA
s2_R_567_CCAGAGTCTT	CAAGCAGAAGACGGCATACGAGATCCAGAGTCTTAGGGTCAAGTGCACAGTCTA
s2_R_568_GTGCCATTGC	CAAGCAGAAGACGGCATACGAGATGTGCCATTGCAGGGTCAAGTGCACAGTCTA
s2_R_569_ATCCGAGATC	CAAGCAGAAGACGGCATACGAGATATCCGAGATCAGGGTCAAGTGCACAGTCTA
s2_R_570_GTCTATCATG	CAAGCAGAAGACGGCATACGAGATGTCTATCATGAGGGTCAAGTGCACAGTCTA
s2_R_571_ACTCCGGTAA	CAAGCAGAAGACGGCATACGAGATACTCCGGTAAAGGGTCAAGTGCACAGTCTA
s2_R_572_CGACCATTCT	CAAGCAGAAGACGGCATACGAGATCGACCATTCTAGGGTCAAGTGCACAGTCTA
s2_R_573_GATCTTGCCT	CAAGCAGAAGACGGCATACGAGATGATCTTGCCTAGGGTCAAGTGCACAGTCTA
s2_R_574_CAGACAACAC	CAAGCAGAAGACGGCATACGAGATCAGACAACACAGGGTCAAGTGCACAGTCTA
s2_R_575_CATACGTCAG	CAAGCAGAAGACGGCATACGAGATCATACGTCAGAGGGTCAAGTGCACAGTCTA
s2_R_576_AACGTCCGAC	CAAGCAGAAGACGGCATACGAGATAACGTCCGACAGGGTCAAGTGCACAGTCTA
s2_R_577_CTAATGTCAG	CAAGCAGAAGACGGCATACGAGATCTAATGTCAGAGGGTCAAGTGCACAGTCTA
s2_R_578_AGATGTGTCG	CAAGCAGAAGACGGCATACGAGATAGATGTGTCGAGGGTCAAGTGCACAGTCTA
s2_R_579_TCGTCATAAC	CAAGCAGAAGACGGCATACGAGATTCGTCATAACAGGGTCAAGTGCACAGTCTA
s2_R_580_TCGTCCTCCA	CAAGCAGAAGACGGCATACGAGATTCGTCCTCCAAGGGTCAAGTGCACAGTCTA
s2_R_581_ACGTCGATAT	CAAGCAGAAGACGGCATACGAGATACGTCGATATAGGGTCAAGTGCACAGTCTA
s2_R_582_CACTGACTGG	CAAGCAGAAGACGGCATACGAGATCACTGACTGGAGGGTCAAGTGCACAGTCTA
s2_R_583_TTGGTGTCCG	CAAGCAGAAGACGGCATACGAGATTTGGTGTCCGAGGGTCAAGTGCACAGTCTA
s2_R_584_TGGTTCTCCG	CAAGCAGAAGACGGCATACGAGATTGGTTCTCCGAGGGTCAAGTGCACAGTCTA
s2_R_585_GTAAGCTCAA	CAAGCAGAAGACGGCATACGAGATGTAAGCTCAAAGGGTCAAGTGCACAGTCTA
s2_R_586_TCTGGAGAAG	CAAGCAGAAGACGGCATACGAGATTCTGGAGAAGAGGGTCAAGTGCACAGTCTA
s2_R_587_GGAACCAGGT	CAAGCAGAAGACGGCATACGAGATGGAACCAGGTAGGGTCAAGTGCACAGTCTA
s2_R_588_CATTCCATGG	CAAGCAGAAGACGGCATACGAGATCATTCCATGGAGGGTCAAGTGCACAGTCTA
s2_R_589_AGAATCGTGT	CAAGCAGAAGACGGCATACGAGATAGAATCGTGTAGGGTCAAGTGCACAGTCTA
s2_R_590_GATGCCTAAT	CAAGCAGAAGACGGCATACGAGATGATGCCTAATAGGGTCAAGTGCACAGTCTA
s2_R_591_AGGTTGCTAT	CAAGCAGAAGACGGCATACGAGATAGGTTGCTATAGGGTCAAGTGCACAGTCTA
s2_R_592_GTTCGACTTA	CAAGCAGAAGACGGCATACGAGATGTTCGACTTAAGGGTCAAGTGCACAGTCTA
s2_R_593_CCAAGATCCG	CAAGCAGAAGACGGCATACGAGATCCAAGATCCGAGGGTCAAGTGCACAGTCTA
s2_R_594_ACGTAAGGAC	CAAGCAGAAGACGGCATACGAGATACGTAAGGACAGGGTCAAGTGCACAGTCTA
s2_R_595_TGTCTAGCAC	CAAGCAGAAGACGGCATACGAGATTGTCTAGCACAGGGTCAAGTGCACAGTCTA
s2_R_596_CATGACTTAG	CAAGCAGAAGACGGCATACGAGATCATGACTTAGAGGGTCAAGTGCACAGTCTA
s2_R_597_CGGAGTAAGA	CAAGCAGAAGACGGCATACGAGATCGGAGTAAGAAGGGTCAAGTGCACAGTCTA
s2_R_598_CGGTTGGTGT	CAAGCAGAAGACGGCATACGAGATCGGTTGGTGTAGGGTCAAGTGCACAGTCTA
s2_R_599_CGGTATTAGA	CAAGCAGAAGACGGCATACGAGATCGGTATTAGAAGGGTCAAGTGCACAGTCTA
s2_R_600_CGGATTGAAC	CAAGCAGAAGACGGCATACGAGATCGGATTGAACAGGGTCAAGTGCACAGTCTA
s2_R_601_CCGACTGTTC	CAAGCAGAAGACGGCATACGAGATCCGACTGTTCAGGGTCAAGTGCACAGTCTA
s2_R_602_ACACACTAGT	CAAGCAGAAGACGGCATACGAGATACACACTAGTAGGGTCAAGTGCACAGTCTA
s2_R_603_CCTTCAGTGG	CAAGCAGAAGACGGCATACGAGATCCTTCAGTGGAGGGTCAAGTGCACAGTCTA
s2_R_604_AGAGCGACAC	CAAGCAGAAGACGGCATACGAGATAGAGCGACACAGGGTCAAGTGCACAGTCTA
s2_R_605_CCGTATAGAC	CAAGCAGAAGACGGCATACGAGATCCGTATAGACAGGGTCAAGTGCACAGTCTA
s2_R_606_GAGCATGAAC	CAAGCAGAAGACGGCATACGAGATGAGCATGAACAGGGTCAAGTGCACAGTCTA
s2_R_607_GAACGCCAAT	CAAGCAGAAGACGGCATACGAGATGAACGCCAATAGGGTCAAGTGCACAGTCTA
s2_R_608_TGCGTGTTGC	CAAGCAGAAGACGGCATACGAGATTGCGTGTTGCAGGGTCAAGTGCACAGTCTA
s2_R_609_GGTTGGTCAC	CAAGCAGAAGACGGCATACGAGATGGTTGGTCACAGGGTCAAGTGCACAGTCTA
s2_R_610_ATACGTGCCA	CAAGCAGAAGACGGCATACGAGATATACGTGCCAAGGGTCAAGTGCACAGTCTA
s2_R_611_CTTACGGAGC	CAAGCAGAAGACGGCATACGAGATCTTACGGAGCAGGGTCAAGTGCACAGTCTA
s2_R_612_TCCACAACAC	CAAGCAGAAGACGGCATACGAGATTCCACAACACAGGGTCAAGTGCACAGTCTA
s2_R_613_GATCTAGGCG	CAAGCAGAAGACGGCATACGAGATGATCTAGGCGAGGGTCAAGTGCACAGTCTA
s2_R_614_GATCCGACAG	CAAGCAGAAGACGGCATACGAGATGATCCGACAGAGGGTCAAGTGCACAGTCTA
s2_R_615_GAACCGATTG	CAAGCAGAAGACGGCATACGAGATGAACCGATTGAGGGTCAAGTGCACAGTCTA
s2_R_616_GATTCGAACA	CAAGCAGAAGACGGCATACGAGATGATTCGAACAAGGGTCAAGTGCACAGTCTA
s2_R_617_AGATCCTCGT	CAAGCAGAAGACGGCATACGAGATAGATCCTCGTAGGGTCAAGTGCACAGTCTA
s2_R_618_CATGGAGCCA	CAAGCAGAAGACGGCATACGAGATCATGGAGCCAAGGGTCAAGTGCACAGTCTA
s2_R_619_CTTGCGCCAT	CAAGCAGAAGACGGCATACGAGATCTTGCGCCATAGGGTCAAGTGCACAGTCTA
s2_R_620_ATAGGTATCG	CAAGCAGAAGACGGCATACGAGATATAGGTATCGAGGGTCAAGTGCACAGTCTA
s2_R_621_ACGCCTTACG	CAAGCAGAAGACGGCATACGAGATACGCCTTACGAGGGTCAAGTGCACAGTCTA
s2_R_622_GACACTACCT	CAAGCAGAAGACGGCATACGAGATGACACTACCTAGGGTCAAGTGCACAGTCTA
s2_R_623_TGCTTGAATG	CAAGCAGAAGACGGCATACGAGATTGCTTGAATGAGGGTCAAGTGCACAGTCTA
s2_R_624_AGTGGCTTAC	CAAGCAGAAGACGGCATACGAGATAGTGGCTTACAGGGTCAAGTGCACAGTCTA
s2_R_625_TTCGGTTGAC	CAAGCAGAAGACGGCATACGAGATTTCGGTTGACAGGGTCAAGTGCACAGTCTA
s2_R_626_TGTGGATCGT	CAAGCAGAAGACGGCATACGAGATTGTGGATCGTAGGGTCAAGTGCACAGTCTA
s2_R_627_CTACTACACA	CAAGCAGAAGACGGCATACGAGATCTACTACACAAGGGTCAAGTGCACAGTCTA
s2_R_628_TTGTCCACTG	CAAGCAGAAGACGGCATACGAGATTTGTCCACTGAGGGTCAAGTGCACAGTCTA
s2_R_629_AAGTAACCGA	CAAGCAGAAGACGGCATACGAGATAAGTAACCGAAGGGTCAAGTGCACAGTCTA
s2_R_630_CCGTGCTAAT	CAAGCAGAAGACGGCATACGAGATCCGTGCTAATAGGGTCAAGTGCACAGTCTA
s2_R_631_CATGTTCGAA	CAAGCAGAAGACGGCATACGAGATCATGTTCGAAAGGGTCAAGTGCACAGTCTA
s2_R_632_GAGTTGTCAT	CAAGCAGAAGACGGCATACGAGATGAGTTGTCATAGGGTCAAGTGCACAGTCTA
s2_R_633_TCGGTATCCA	CAAGCAGAAGACGGCATACGAGATTCGGTATCCAAGGGTCAAGTGCACAGTCTA
s2_R_634_TACTCCTATC	CAAGCAGAAGACGGCATACGAGATTACTCCTATCAGGGTCAAGTGCACAGTCTA
s2_R_635_AGGTGTAGCT	CAAGCAGAAGACGGCATACGAGATAGGTGTAGCTAGGGTCAAGTGCACAGTCTA
s2_R_636_AAGGTTCTGG	CAAGCAGAAGACGGCATACGAGATAAGGTTCTGGAGGGTCAAGTGCACAGTCTA
s2_R_637_TCGGTAAGGA	CAAGCAGAAGACGGCATACGAGATTCGGTAAGGAAGGGTCAAGTGCACAGTCTA
s2_R_638_TGAAGGAGAG	CAAGCAGAAGACGGCATACGAGATTGAAGGAGAGAGGGTCAAGTGCACAGTCTA
s2_R_639_AGTGATGTAG	CAAGCAGAAGACGGCATACGAGATAGTGATGTAGAGGGTCAAGTGCACAGTCTA
s2_R_640_AATGGATGGT	CAAGCAGAAGACGGCATACGAGATAATGGATGGTAGGGTCAAGTGCACAGTCTA
s2_R_641_TCCACAGCTT	CAAGCAGAAGACGGCATACGAGATTCCACAGCTTAGGGTCAAGTGCACAGTCTA
s2_R_642_CCAAGGTAGT	CAAGCAGAAGACGGCATACGAGATCCAAGGTAGTAGGGTCAAGTGCACAGTCTA
s2_R_643_AGGTTACGGT	CAAGCAGAAGACGGCATACGAGATAGGTTACGGTAGGGTCAAGTGCACAGTCTA
s2_R_644_ACCTCCTGTT	CAAGCAGAAGACGGCATACGAGATACCTCCTGTTAGGGTCAAGTGCACAGTCTA
s2_R_645_GTGGCAATGT	CAAGCAGAAGACGGCATACGAGATGTGGCAATGTAGGGTCAAGTGCACAGTCTA
s2_R_646_GAGTTAGTAG	CAAGCAGAAGACGGCATACGAGATGAGTTAGTAGAGGGTCAAGTGCACAGTCTA
s2_R_647_GTCTAGATGT	CAAGCAGAAGACGGCATACGAGATGTCTAGATGTAGGGTCAAGTGCACAGTCTA
s2_R_648_ACGGACAGTA	CAAGCAGAAGACGGCATACGAGATACGGACAGTAAGGGTCAAGTGCACAGTCTA
s2_R_649_AGCATGTTGA	CAAGCAGAAGACGGCATACGAGATAGCATGTTGAAGGGTCAAGTGCACAGTCTA
s2_R_650_CATCCTATGT	CAAGCAGAAGACGGCATACGAGATCATCCTATGTAGGGTCAAGTGCACAGTCTA
s2_R_651_AGTAGTTGGT	CAAGCAGAAGACGGCATACGAGATAGTAGTTGGTAGGGTCAAGTGCACAGTCTA
s2_R_652_TCATGGTGGT	CAAGCAGAAGACGGCATACGAGATTCATGGTGGTAGGGTCAAGTGCACAGTCTA
s2_R_653_AAGGACTATG	CAAGCAGAAGACGGCATACGAGATAAGGACTATGAGGGTCAAGTGCACAGTCTA
s2_R_654_GTATAGGTGA	CAAGCAGAAGACGGCATACGAGATGTATAGGTGAAGGGTCAAGTGCACAGTCTA
s2_R_655_TAGGATGTCT	CAAGCAGAAGACGGCATACGAGATTAGGATGTCTAGGGTCAAGTGCACAGTCTA
s2_R_656_TGCTTCGGAT	CAAGCAGAAGACGGCATACGAGATTGCTTCGGATAGGGTCAAGTGCACAGTCTA
s2_R_657_TGCGAATGTT	CAAGCAGAAGACGGCATACGAGATTGCGAATGTTAGGGTCAAGTGCACAGTCTA
s2_R_658_GGTCGGTAAT	CAAGCAGAAGACGGCATACGAGATGGTCGGTAATAGGGTCAAGTGCACAGTCTA
s2_R_659_CAACTACTGA	CAAGCAGAAGACGGCATACGAGATCAACTACTGAAGGGTCAAGTGCACAGTCTA
s2_R_660_ACAAGGATGG	CAAGCAGAAGACGGCATACGAGATACAAGGATGGAGGGTCAAGTGCACAGTCTA
s2_R_661_TTCACCATGT	CAAGCAGAAGACGGCATACGAGATTTCACCATGTAGGGTCAAGTGCACAGTCTA
s2_R_662_TTAGCGATGA	CAAGCAGAAGACGGCATACGAGATTTAGCGATGAAGGGTCAAGTGCACAGTCTA
s2_R_663_TGGAGGTAAT	CAAGCAGAAGACGGCATACGAGATTGGAGGTAATAGGGTCAAGTGCACAGTCTA
s2_R_664_CAACACGACA	CAAGCAGAAGACGGCATACGAGATCAACACGACAAGGGTCAAGTGCACAGTCTA
s2_R_665_GTGGTTGGTG	CAAGCAGAAGACGGCATACGAGATGTGGTTGGTGAGGGTCAAGTGCACAGTCTA
s2_R_666_CATGTGGTAT	CAAGCAGAAGACGGCATACGAGATCATGTGGTATAGGGTCAAGTGCACAGTCTA
s2_R_667_AGCGGTTACA	CAAGCAGAAGACGGCATACGAGATAGCGGTTACAAGGGTCAAGTGCACAGTCTA
s2_R_668_CCGCCTAAGA	CAAGCAGAAGACGGCATACGAGATCCGCCTAAGAAGGGTCAAGTGCACAGTCTA
s2_R_669_TTGCGAGGAT	CAAGCAGAAGACGGCATACGAGATTTGCGAGGATAGGGTCAAGTGCACAGTCTA
s2_R_670_GGTTCACAGT	CAAGCAGAAGACGGCATACGAGATGGTTCACAGTAGGGTCAAGTGCACAGTCTA
s2_R_671_AACCAGAGGA	CAAGCAGAAGACGGCATACGAGATAACCAGAGGAAGGGTCAAGTGCACAGTCTA
s2_R_672_CAACAGGCTT	CAAGCAGAAGACGGCATACGAGATCAACAGGCTTAGGGTCAAGTGCACAGTCTA
s2_R_673_AAGTCCTGGT	CAAGCAGAAGACGGCATACGAGATAAGTCCTGGTAGGGTCAAGTGCACAGTCTA
s2_R_674_GGAATGGAGT	CAAGCAGAAGACGGCATACGAGATGGAATGGAGTAGGGTCAAGTGCACAGTCTA
s2_R_675_GGTGATAAGA	CAAGCAGAAGACGGCATACGAGATGGTGATAAGAAGGGTCAAGTGCACAGTCTA
s2_R_676_CCACCTACAG	CAAGCAGAAGACGGCATACGAGATCCACCTACAGAGGGTCAAGTGCACAGTCTA
s2_R_677_ACTGTTGTGT	CAAGCAGAAGACGGCATACGAGATACTGTTGTGTAGGGTCAAGTGCACAGTCTA
s2_R_678_AAGCCAATCC	CAAGCAGAAGACGGCATACGAGATAAGCCAATCCAGGGTCAAGTGCACAGTCTA
s2_R_679_ACATTGCGTT	CAAGCAGAAGACGGCATACGAGATACATTGCGTTAGGGTCAAGTGCACAGTCTA
s2_R_680_ACGAGGAGTC	CAAGCAGAAGACGGCATACGAGATACGAGGAGTCAGGGTCAAGTGCACAGTCTA
s2_R_681_GTTCACAACT	CAAGCAGAAGACGGCATACGAGATGTTCACAACTAGGGTCAAGTGCACAGTCTA
s2_R_682_GAATGTTGGT	CAAGCAGAAGACGGCATACGAGATGAATGTTGGTAGGGTCAAGTGCACAGTCTA
s2_R_683_AGCAATGAGT	CAAGCAGAAGACGGCATACGAGATAGCAATGAGTAGGGTCAAGTGCACAGTCTA
s2_R_684_TCGGTTATAG	CAAGCAGAAGACGGCATACGAGATTCGGTTATAGAGGGTCAAGTGCACAGTCTA
s2_R_685_GTAGCGATAG	CAAGCAGAAGACGGCATACGAGATGTAGCGATAGAGGGTCAAGTGCACAGTCTA
s2_R_686_TCGCCTAATG	CAAGCAGAAGACGGCATACGAGATTCGCCTAATGAGGGTCAAGTGCACAGTCTA
s2_R_687_CCTTCTTACC	CAAGCAGAAGACGGCATACGAGATCCTTCTTACCAGGGTCAAGTGCACAGTCTA
s2_R_688_GTGTTCCAAT	CAAGCAGAAGACGGCATACGAGATGTGTTCCAATAGGGTCAAGTGCACAGTCTA
s2_R_689_CATCATAGAG	CAAGCAGAAGACGGCATACGAGATCATCATAGAGAGGGTCAAGTGCACAGTCTA
s2_R_690_GGAAGTCGAT	CAAGCAGAAGACGGCATACGAGATGGAAGTCGATAGGGTCAAGTGCACAGTCTA
s2_R_691_TGGCTGGATC	CAAGCAGAAGACGGCATACGAGATTGGCTGGATCAGGGTCAAGTGCACAGTCTA
s2_R_692_TCAACCATGA	CAAGCAGAAGACGGCATACGAGATTCAACCATGAAGGGTCAAGTGCACAGTCTA
s2_R_693_CCAAGTGATA	CAAGCAGAAGACGGCATACGAGATCCAAGTGATAAGGGTCAAGTGCACAGTCTA
s2_R_694_GGTAGTGTAT	CAAGCAGAAGACGGCATACGAGATGGTAGTGTATAGGGTCAAGTGCACAGTCTA
s2_R_695_AATGTTCCAG	CAAGCAGAAGACGGCATACGAGATAATGTTCCAGAGGGTCAAGTGCACAGTCTA
s2_R_696_CATAAGCGGT	CAAGCAGAAGACGGCATACGAGATCATAAGCGGTAGGGTCAAGTGCACAGTCTA
s2_R_697_CACATTCACT	CAAGCAGAAGACGGCATACGAGATCACATTCACTAGGGTCAAGTGCACAGTCTA
s2_R_698_AAGTCAATGG	CAAGCAGAAGACGGCATACGAGATAAGTCAATGGAGGGTCAAGTGCACAGTCTA
s2_R_699_CAGTAACAAG	CAAGCAGAAGACGGCATACGAGATCAGTAACAAGAGGGTCAAGTGCACAGTCTA
s2_R_700_TGGAGTTCAA	CAAGCAGAAGACGGCATACGAGATTGGAGTTCAAAGGGTCAAGTGCACAGTCTA
s2_R_701_ATACAGTTGG	CAAGCAGAAGACGGCATACGAGATATACAGTTGGAGGGTCAAGTGCACAGTCTA
s2_R_702_CAAGAGTAGA	CAAGCAGAAGACGGCATACGAGATCAAGAGTAGAAGGGTCAAGTGCACAGTCTA
s2_R_703_GTAGAACTGG	CAAGCAGAAGACGGCATACGAGATGTAGAACTGGAGGGTCAAGTGCACAGTCTA
s2_R_704_AATCGGTTAC	CAAGCAGAAGACGGCATACGAGATAATCGGTTACAGGGTCAAGTGCACAGTCTA
s2_R_705_CAGATGGAGG	CAAGCAGAAGACGGCATACGAGATCAGATGGAGGAGGGTCAAGTGCACAGTCTA
s2_R_706_TGGTATCATG	CAAGCAGAAGACGGCATACGAGATTGGTATCATGAGGGTCAAGTGCACAGTCTA
s2_R_707_ACCGAACCAA	CAAGCAGAAGACGGCATACGAGATACCGAACCAAAGGGTCAAGTGCACAGTCTA
s2_R_708_AGATTGCGAA	CAAGCAGAAGACGGCATACGAGATAGATTGCGAAAGGGTCAAGTGCACAGTCTA
s2_R_709_CGGATATACG	CAAGCAGAAGACGGCATACGAGATCGGATATACGAGGGTCAAGTGCACAGTCTA
s2_R_710_TGTGTCTAGA	CAAGCAGAAGACGGCATACGAGATTGTGTCTAGAAGGGTCAAGTGCACAGTCTA
s2_R_711_CCTGAAGGAA	CAAGCAGAAGACGGCATACGAGATCCTGAAGGAAAGGGTCAAGTGCACAGTCTA
s2_R_712_GGTATGTACA	CAAGCAGAAGACGGCATACGAGATGGTATGTACAAGGGTCAAGTGCACAGTCTA
s2_R_713_CCAGCCAGTT	CAAGCAGAAGACGGCATACGAGATCCAGCCAGTTAGGGTCAAGTGCACAGTCTA
s2_R_714_CATTCGGATG	CAAGCAGAAGACGGCATACGAGATCATTCGGATGAGGGTCAAGTGCACAGTCTA
s2_R_715_GCGACGATTC	CAAGCAGAAGACGGCATACGAGATGCGACGATTCAGGGTCAAGTGCACAGTCTA
s2_R_716_TTGTCCTCGT	CAAGCAGAAGACGGCATACGAGATTTGTCCTCGTAGGGTCAAGTGCACAGTCTA
s2_R_717_TCCAGTGTGT	CAAGCAGAAGACGGCATACGAGATTCCAGTGTGTAGGGTCAAGTGCACAGTCTA
s2_R_718_AGTAGTGCCT	CAAGCAGAAGACGGCATACGAGATAGTAGTGCCTAGGGTCAAGTGCACAGTCTA
s2_R_719_CACCGTTGAT	CAAGCAGAAGACGGCATACGAGATCACCGTTGATAGGGTCAAGTGCACAGTCTA
s2_R_720_TGCCAGATGT	CAAGCAGAAGACGGCATACGAGATTGCCAGATGTAGGGTCAAGTGCACAGTCTA
s2_R_721_CAAGTCGCCA	CAAGCAGAAGACGGCATACGAGATCAAGTCGCCAAGGGTCAAGTGCACAGTCTA
s2_R_722_TGCGTCTCTC	CAAGCAGAAGACGGCATACGAGATTGCGTCTCTCAGGGTCAAGTGCACAGTCTA
s2_R_723_CCGTACGCTT	CAAGCAGAAGACGGCATACGAGATCCGTACGCTTAGGGTCAAGTGCACAGTCTA
s2_R_724_CCGAATACCT	CAAGCAGAAGACGGCATACGAGATCCGAATACCTAGGGTCAAGTGCACAGTCTA
s2_R_725_TGCTCGTCAT	CAAGCAGAAGACGGCATACGAGATTGCTCGTCATAGGGTCAAGTGCACAGTCTA
s2_R_726_AGAAGCGATA	CAAGCAGAAGACGGCATACGAGATAGAAGCGATAAGGGTCAAGTGCACAGTCTA
s2_R_727_TGCTGTGTAA	CAAGCAGAAGACGGCATACGAGATTGCTGTGTAAAGGGTCAAGTGCACAGTCTA
s2_R_728_ACTGACTCGT	CAAGCAGAAGACGGCATACGAGATACTGACTCGTAGGGTCAAGTGCACAGTCTA
s2_R_729_GTGTATGTGG	CAAGCAGAAGACGGCATACGAGATGTGTATGTGGAGGGTCAAGTGCACAGTCTA
s2_R_730_AGCTTCCTCC	CAAGCAGAAGACGGCATACGAGATAGCTTCCTCCAGGGTCAAGTGCACAGTCTA
s2_R_731_TCGCGACGTT	CAAGCAGAAGACGGCATACGAGATTCGCGACGTTAGGGTCAAGTGCACAGTCTA
s2_R_732_ATCCGTTGTC	CAAGCAGAAGACGGCATACGAGATATCCGTTGTCAGGGTCAAGTGCACAGTCTA
s2_R_733_ATGAGGAATG	CAAGCAGAAGACGGCATACGAGATATGAGGAATGAGGGTCAAGTGCACAGTCTA
s2_R_734_TGAGTGAGAT	CAAGCAGAAGACGGCATACGAGATTGAGTGAGATAGGGTCAAGTGCACAGTCTA
s2_R_735_GATACTCCAC	CAAGCAGAAGACGGCATACGAGATGATACTCCACAGGGTCAAGTGCACAGTCTA
s2_R_736_ACAATGGACT	CAAGCAGAAGACGGCATACGAGATACAATGGACTAGGGTCAAGTGCACAGTCTA
s2_R_737_CCGTTCCATT	CAAGCAGAAGACGGCATACGAGATCCGTTCCATTAGGGTCAAGTGCACAGTCTA
s2_R_738_GGTCAAGTAG	CAAGCAGAAGACGGCATACGAGATGGTCAAGTAGAGGGTCAAGTGCACAGTCTA
s2_R_739_GTAAGATTGG	CAAGCAGAAGACGGCATACGAGATGTAAGATTGGAGGGTCAAGTGCACAGTCTA
s2_R_740_GCTTCTCCAG	CAAGCAGAAGACGGCATACGAGATGCTTCTCCAGAGGGTCAAGTGCACAGTCTA
s2_R_741_ACGACGCCTA	CAAGCAGAAGACGGCATACGAGATACGACGCCTAAGGGTCAAGTGCACAGTCTA
s2_R_742_GTTAGGAAGG	CAAGCAGAAGACGGCATACGAGATGTTAGGAAGGAGGGTCAAGTGCACAGTCTA
s2_R_743_CAACTTCCAG	CAAGCAGAAGACGGCATACGAGATCAACTTCCAGAGGGTCAAGTGCACAGTCTA
s2_R_744_CAGTCCTCAT	CAAGCAGAAGACGGCATACGAGATCAGTCCTCATAGGGTCAAGTGCACAGTCTA
s2_R_745_GTAGGTATGC	CAAGCAGAAGACGGCATACGAGATGTAGGTATGCAGGGTCAAGTGCACAGTCTA
s2_R_746_TCGCCACACA	CAAGCAGAAGACGGCATACGAGATTCGCCACACAAGGGTCAAGTGCACAGTCTA
s2_R_747_CCATAGACGT	CAAGCAGAAGACGGCATACGAGATCCATAGACGTAGGGTCAAGTGCACAGTCTA
s2_R_748_GTCAGGCTAC	CAAGCAGAAGACGGCATACGAGATGTCAGGCTACAGGGTCAAGTGCACAGTCTA
s2_R_749_CAGGCACTAC	CAAGCAGAAGACGGCATACGAGATCAGGCACTACAGGGTCAAGTGCACAGTCTA
s2_R_750_CAGAGGTGTT	CAAGCAGAAGACGGCATACGAGATCAGAGGTGTTAGGGTCAAGTGCACAGTCTA
s2_R_751_TCAGTGTCAA	CAAGCAGAAGACGGCATACGAGATTCAGTGTCAAAGGGTCAAGTGCACAGTCTA
s2_R_752_CCGCCATAGT	CAAGCAGAAGACGGCATACGAGATCCGCCATAGTAGGGTCAAGTGCACAGTCTA
s2_R_753_GGCTATTGGT	CAAGCAGAAGACGGCATACGAGATGGCTATTGGTAGGGTCAAGTGCACAGTCTA
s2_R_754_GGTGAATTGA	CAAGCAGAAGACGGCATACGAGATGGTGAATTGAAGGGTCAAGTGCACAGTCTA
s2_R_755_CCACAGCTCA	CAAGCAGAAGACGGCATACGAGATCCACAGCTCAAGGGTCAAGTGCACAGTCTA
s2_R_756_ACTCTGGCAC	CAAGCAGAAGACGGCATACGAGATACTCTGGCACAGGGTCAAGTGCACAGTCTA
s2_R_757_CTATTCGTCA	CAAGCAGAAGACGGCATACGAGATCTATTCGTCAAGGGTCAAGTGCACAGTCTA
s2_R_758_CTCAGGCCTT	CAAGCAGAAGACGGCATACGAGATCTCAGGCCTTAGGGTCAAGTGCACAGTCTA
s2_R_759_TGGTAGGCTC	CAAGCAGAAGACGGCATACGAGATTGGTAGGCTCAGGGTCAAGTGCACAGTCTA
s2_R_760_AACCTGCTCA	CAAGCAGAAGACGGCATACGAGATAACCTGCTCAAGGGTCAAGTGCACAGTCTA
s2_R_761_AACTGAGGAA	CAAGCAGAAGACGGCATACGAGATAACTGAGGAAAGGGTCAAGTGCACAGTCTA
s2_R_762_ATAGAGCGAT	CAAGCAGAAGACGGCATACGAGATATAGAGCGATAGGGTCAAGTGCACAGTCTA
s2_R_763_ACCTTCCTTG	CAAGCAGAAGACGGCATACGAGATACCTTCCTTGAGGGTCAAGTGCACAGTCTA
s2_R_764_GATCGTTCTG	CAAGCAGAAGACGGCATACGAGATGATCGTTCTGAGGGTCAAGTGCACAGTCTA
s2_R_765_CAAGCGGTGT	CAAGCAGAAGACGGCATACGAGATCAAGCGGTGTAGGGTCAAGTGCACAGTCTA
s2_R_766_TCAGCGTAGC	CAAGCAGAAGACGGCATACGAGATTCAGCGTAGCAGGGTCAAGTGCACAGTCTA
s2_R_767_ACCATCAGAT	CAAGCAGAAGACGGCATACGAGATACCATCAGATAGGGTCAAGTGCACAGTCTA
s2_R_768_ACGGAATAAC	CAAGCAGAAGACGGCATACGAGATACGGAATAACAGGGTCAAGTGCACAGTCTA
s2_R_769_AGTCAACCAC	CAAGCAGAAGACGGCATACGAGATAGTCAACCACAGGGTCAAGTGCACAGTCTA
s2_R_770_GGTCTATGAC	CAAGCAGAAGACGGCATACGAGATGGTCTATGACAGGGTCAAGTGCACAGTCTA
s2_R_771_CGGAAGATAC	CAAGCAGAAGACGGCATACGAGATCGGAAGATACAGGGTCAAGTGCACAGTCTA
s2_R_772_CGATGCTAGT	CAAGCAGAAGACGGCATACGAGATCGATGCTAGTAGGGTCAAGTGCACAGTCTA
s2_R_773_GTTAACTGGT	CAAGCAGAAGACGGCATACGAGATGTTAACTGGTAGGGTCAAGTGCACAGTCTA
s2_R_774_TACCGCCAGT	CAAGCAGAAGACGGCATACGAGATTACCGCCAGTAGGGTCAAGTGCACAGTCTA
s2_R_775_GAGGCGTTGT	CAAGCAGAAGACGGCATACGAGATGAGGCGTTGTAGGGTCAAGTGCACAGTCTA
s2_R_776_AGCTTACCAC	CAAGCAGAAGACGGCATACGAGATAGCTTACCACAGGGTCAAGTGCACAGTCTA
s2_R_777_CGCTGTATCG	CAAGCAGAAGACGGCATACGAGATCGCTGTATCGAGGGTCAAGTGCACAGTCTA
s2_R_778_AGTGCTGTGA	CAAGCAGAAGACGGCATACGAGATAGTGCTGTGAAGGGTCAAGTGCACAGTCTA
s2_R_779_GTCGTTGAGC	CAAGCAGAAGACGGCATACGAGATGTCGTTGAGCAGGGTCAAGTGCACAGTCTA
s2_R_780_ACGGAAGCTC	CAAGCAGAAGACGGCATACGAGATACGGAAGCTCAGGGTCAAGTGCACAGTCTA
s2_R_781_CCATTAATCC	CAAGCAGAAGACGGCATACGAGATCCATTAATCCAGGGTCAAGTGCACAGTCTA
s2_R_782_CTTCCACCGA	CAAGCAGAAGACGGCATACGAGATCTTCCACCGAAGGGTCAAGTGCACAGTCTA
s2_R_783_TACGGAGTAC	CAAGCAGAAGACGGCATACGAGATTACGGAGTACAGGGTCAAGTGCACAGTCTA
s2_R_784_TCACTACTCT	CAAGCAGAAGACGGCATACGAGATTCACTACTCTAGGGTCAAGTGCACAGTCTA
s2_R_785_GTAGCACGAT	CAAGCAGAAGACGGCATACGAGATGTAGCACGATAGGGTCAAGTGCACAGTCTA
s2_R_786_TTGCCAGCTT	CAAGCAGAAGACGGCATACGAGATTTGCCAGCTTAGGGTCAAGTGCACAGTCTA
s2_R_787_CTAACGGCAC	CAAGCAGAAGACGGCATACGAGATCTAACGGCACAGGGTCAAGTGCACAGTCTA
s2_R_788_CAACGATTGT	CAAGCAGAAGACGGCATACGAGATCAACGATTGTAGGGTCAAGTGCACAGTCTA
s2_R_789_AGACTAAGGT	CAAGCAGAAGACGGCATACGAGATAGACTAAGGTAGGGTCAAGTGCACAGTCTA
s2_R_790_AGGCAACACA	CAAGCAGAAGACGGCATACGAGATAGGCAACACAAGGGTCAAGTGCACAGTCTA
s2_R_791_AGAACGGCAT	CAAGCAGAAGACGGCATACGAGATAGAACGGCATAGGGTCAAGTGCACAGTCTA
s2_R_792_ATCAGATGGT	CAAGCAGAAGACGGCATACGAGATATCAGATGGTAGGGTCAAGTGCACAGTCTA
s2_R_793_AATCTCACTC	CAAGCAGAAGACGGCATACGAGATAATCTCACTCAGGGTCAAGTGCACAGTCTA
s2_R_794_TACGCGTCGT	CAAGCAGAAGACGGCATACGAGATTACGCGTCGTAGGGTCAAGTGCACAGTCTA
s2_R_795_GATAGCAATG	CAAGCAGAAGACGGCATACGAGATGATAGCAATGAGGGTCAAGTGCACAGTCTA
s2_R_796_AAGCAGACAT	CAAGCAGAAGACGGCATACGAGATAAGCAGACATAGGGTCAAGTGCACAGTCTA
s2_R_797_ACTGGAATCA	CAAGCAGAAGACGGCATACGAGATACTGGAATCAAGGGTCAAGTGCACAGTCTA
s2_R_798_TTGGCTTCTT	CAAGCAGAAGACGGCATACGAGATTTGGCTTCTTAGGGTCAAGTGCACAGTCTA
s2_R_799_TCCACCGAGA	CAAGCAGAAGACGGCATACGAGATTCCACCGAGAAGGGTCAAGTGCACAGTCTA
s2_R_800_TCTGAGCGAT	CAAGCAGAAGACGGCATACGAGATTCTGAGCGATAGGGTCAAGTGCACAGTCTA
s2_R_801_CCGAGACATA	CAAGCAGAAGACGGCATACGAGATCCGAGACATAAGGGTCAAGTGCACAGTCTA
s2_R_802_GACTCCTGAT	CAAGCAGAAGACGGCATACGAGATGACTCCTGATAGGGTCAAGTGCACAGTCTA
s2_R_803_ATGGTTAGTC	CAAGCAGAAGACGGCATACGAGATATGGTTAGTCAGGGTCAAGTGCACAGTCTA
s2_R_804_GATCCATAAC	CAAGCAGAAGACGGCATACGAGATGATCCATAACAGGGTCAAGTGCACAGTCTA
s2_R_805_GAGCCTGCAA	CAAGCAGAAGACGGCATACGAGATGAGCCTGCAAAGGGTCAAGTGCACAGTCTA
s2_R_806_GTGATGGCTC	CAAGCAGAAGACGGCATACGAGATGTGATGGCTCAGGGTCAAGTGCACAGTCTA
s2_R_807_GATCACCACA	CAAGCAGAAGACGGCATACGAGATGATCACCACAAGGGTCAAGTGCACAGTCTA
s2_R_808_ACCGACTAAT	CAAGCAGAAGACGGCATACGAGATACCGACTAATAGGGTCAAGTGCACAGTCTA
s2_R_809_ACTACATTGC	CAAGCAGAAGACGGCATACGAGATACTACATTGCAGGGTCAAGTGCACAGTCTA
s2_R_810_ATCACTCTCC	CAAGCAGAAGACGGCATACGAGATATCACTCTCCAGGGTCAAGTGCACAGTCTA
s2_R_811_TACGTGTAGA	CAAGCAGAAGACGGCATACGAGATTACGTGTAGAAGGGTCAAGTGCACAGTCTA
s2_R_812_ATTCCTTGGT	CAAGCAGAAGACGGCATACGAGATATTCCTTGGTAGGGTCAAGTGCACAGTCTA
s2_R_813_CGCCTCTATA	CAAGCAGAAGACGGCATACGAGATCGCCTCTATAAGGGTCAAGTGCACAGTCTA
s2_R_814_AGATCTTCAG	CAAGCAGAAGACGGCATACGAGATAGATCTTCAGAGGGTCAAGTGCACAGTCTA
s2_R_815_GAGATCGAAT	CAAGCAGAAGACGGCATACGAGATGAGATCGAATAGGGTCAAGTGCACAGTCTA
s2_R_816_GGATTACGTG	CAAGCAGAAGACGGCATACGAGATGGATTACGTGAGGGTCAAGTGCACAGTCTA
s2_R_817_ACCAATCACG	CAAGCAGAAGACGGCATACGAGATACCAATCACGAGGGTCAAGTGCACAGTCTA
s2_R_818_GACCACGTTG	CAAGCAGAAGACGGCATACGAGATGACCACGTTGAGGGTCAAGTGCACAGTCTA
s2_R_819_CTAGAACACC	CAAGCAGAAGACGGCATACGAGATCTAGAACACCAGGGTCAAGTGCACAGTCTA
s2_R_820_CTTCGGCACA	CAAGCAGAAGACGGCATACGAGATCTTCGGCACAAGGGTCAAGTGCACAGTCTA
s2_R_821_GATGGAACTC	CAAGCAGAAGACGGCATACGAGATGATGGAACTCAGGGTCAAGTGCACAGTCTA
s2_R_822_TCGTGGAGTG	CAAGCAGAAGACGGCATACGAGATTCGTGGAGTGAGGGTCAAGTGCACAGTCTA
s2_R_823_AGTTGGCAGT	CAAGCAGAAGACGGCATACGAGATAGTTGGCAGTAGGGTCAAGTGCACAGTCTA
s2_R_824_CCGAAGAAGT	CAAGCAGAAGACGGCATACGAGATCCGAAGAAGTAGGGTCAAGTGCACAGTCTA
s2_R_825_TCGCGTAGGT	CAAGCAGAAGACGGCATACGAGATTCGCGTAGGTAGGGTCAAGTGCACAGTCTA
s2_R_826_TCCTTGCGAC	CAAGCAGAAGACGGCATACGAGATTCCTTGCGACAGGGTCAAGTGCACAGTCTA
s2_R_827_AACTCCTCAC	CAAGCAGAAGACGGCATACGAGATAACTCCTCACAGGGTCAAGTGCACAGTCTA
s2_R_828_GTCAGTGACT	CAAGCAGAAGACGGCATACGAGATGTCAGTGACTAGGGTCAAGTGCACAGTCTA
s2_R_829_CATAGAGAGG	CAAGCAGAAGACGGCATACGAGATCATAGAGAGGAGGGTCAAGTGCACAGTCTA
s2_R_830_CTACTTCGGC	CAAGCAGAAGACGGCATACGAGATCTACTTCGGCAGGGTCAAGTGCACAGTCTA
s2_R_831_TTGAAGCGTT	CAAGCAGAAGACGGCATACGAGATTTGAAGCGTTAGGGTCAAGTGCACAGTCTA
s2_R_832_GTGCGGAGTT	CAAGCAGAAGACGGCATACGAGATGTGCGGAGTTAGGGTCAAGTGCACAGTCTA
s2_R_833_CCACAATAGA	CAAGCAGAAGACGGCATACGAGATCCACAATAGAAGGGTCAAGTGCACAGTCTA
s2_R_834_ATGCTAGAGA	CAAGCAGAAGACGGCATACGAGATATGCTAGAGAAGGGTCAAGTGCACAGTCTA
s2_R_835_AAGGTCACAC	CAAGCAGAAGACGGCATACGAGATAAGGTCACACAGGGTCAAGTGCACAGTCTA
s2_R_836_TGTGGTAGTT	CAAGCAGAAGACGGCATACGAGATTGTGGTAGTTAGGGTCAAGTGCACAGTCTA
s2_R_837_TTCGGACTAA	CAAGCAGAAGACGGCATACGAGATTTCGGACTAAAGGGTCAAGTGCACAGTCTA
s2_R_838_CAGACTCGTT	CAAGCAGAAGACGGCATACGAGATCAGACTCGTTAGGGTCAAGTGCACAGTCTA
s2_R_839_CCACAAGTAT	CAAGCAGAAGACGGCATACGAGATCCACAAGTATAGGGTCAAGTGCACAGTCTA
s2_R_840_ATAACTGGTC	CAAGCAGAAGACGGCATACGAGATATAACTGGTCAGGGTCAAGTGCACAGTCTA
s2_R_841_TATTGGTGTC	CAAGCAGAAGACGGCATACGAGATTATTGGTGTCAGGGTCAAGTGCACAGTCTA
s2_R_842_AGATTGTGGC	CAAGCAGAAGACGGCATACGAGATAGATTGTGGCAGGGTCAAGTGCACAGTCTA
s2_R_843_TTCTTCACGT	CAAGCAGAAGACGGCATACGAGATTTCTTCACGTAGGGTCAAGTGCACAGTCTA
s2_R_844_ACTCCATGGA	CAAGCAGAAGACGGCATACGAGATACTCCATGGAAGGGTCAAGTGCACAGTCTA
s2_R_845_AGCGATAGGA	CAAGCAGAAGACGGCATACGAGATAGCGATAGGAAGGGTCAAGTGCACAGTCTA
s2_R_846_TTGTTCGACG	CAAGCAGAAGACGGCATACGAGATTTGTTCGACGAGGGTCAAGTGCACAGTCTA
s2_R_847_TCTACGTGAA	CAAGCAGAAGACGGCATACGAGATTCTACGTGAAAGGGTCAAGTGCACAGTCTA
s2_R_848_GAACGAGCTG	CAAGCAGAAGACGGCATACGAGATGAACGAGCTGAGGGTCAAGTGCACAGTCTA
s2_R_849_TTGGACCGAG	CAAGCAGAAGACGGCATACGAGATTTGGACCGAGAGGGTCAAGTGCACAGTCTA
s2_R_850_ACGAGTGATG	CAAGCAGAAGACGGCATACGAGATACGAGTGATGAGGGTCAAGTGCACAGTCTA
s2_R_851_TTCAGAGATG	CAAGCAGAAGACGGCATACGAGATTTCAGAGATGAGGGTCAAGTGCACAGTCTA
s2_R_852_ATAGTGAGGT	CAAGCAGAAGACGGCATACGAGATATAGTGAGGTAGGGTCAAGTGCACAGTCTA
s2_R_853_CCATCCATTC	CAAGCAGAAGACGGCATACGAGATCCATCCATTCAGGGTCAAGTGCACAGTCTA
s2_R_854_CATCGCGTTC	CAAGCAGAAGACGGCATACGAGATCATCGCGTTCAGGGTCAAGTGCACAGTCTA
s2_R_855_CTCATCGTGC	CAAGCAGAAGACGGCATACGAGATCTCATCGTGCAGGGTCAAGTGCACAGTCTA
s2_R_856_GAAGTCTTCG	CAAGCAGAAGACGGCATACGAGATGAAGTCTTCGAGGGTCAAGTGCACAGTCTA
s2_R_857_AGTCAGGTGT	CAAGCAGAAGACGGCATACGAGATAGTCAGGTGTAGGGTCAAGTGCACAGTCTA
s2_R_858_TTAGACACTC	CAAGCAGAAGACGGCATACGAGATTTAGACACTCAGGGTCAAGTGCACAGTCTA
s2_R_859_TGCGTGGTCA	CAAGCAGAAGACGGCATACGAGATTGCGTGGTCAAGGGTCAAGTGCACAGTCTA
s2_R_860_CGGAAGACTG	CAAGCAGAAGACGGCATACGAGATCGGAAGACTGAGGGTCAAGTGCACAGTCTA
s2_R_861_CTGTCCACAA	CAAGCAGAAGACGGCATACGAGATCTGTCCACAAAGGGTCAAGTGCACAGTCTA
s2_R_862_CTGAACGGCT	CAAGCAGAAGACGGCATACGAGATCTGAACGGCTAGGGTCAAGTGCACAGTCTA
s2_R_863_GGAGTCGACA	CAAGCAGAAGACGGCATACGAGATGGAGTCGACAAGGGTCAAGTGCACAGTCTA
s2_R_864_CTTCGTGACT	CAAGCAGAAGACGGCATACGAGATCTTCGTGACTAGGGTCAAGTGCACAGTCTA
s2_R_865_GAACTTGTGT	CAAGCAGAAGACGGCATACGAGATGAACTTGTGTAGGGTCAAGTGCACAGTCTA
s2_R_866_ATACCGAGCT	CAAGCAGAAGACGGCATACGAGATATACCGAGCTAGGGTCAAGTGCACAGTCTA
s2_R_867_ACGCCTGGTT	CAAGCAGAAGACGGCATACGAGATACGCCTGGTTAGGGTCAAGTGCACAGTCTA
s2_R_868_AAGCCATACA	CAAGCAGAAGACGGCATACGAGATAAGCCATACAAGGGTCAAGTGCACAGTCTA
s2_R_869_GCGAACTGTC	CAAGCAGAAGACGGCATACGAGATGCGAACTGTCAGGGTCAAGTGCACAGTCTA
s2_R_870_ACTACGATAG	CAAGCAGAAGACGGCATACGAGATACTACGATAGAGGGTCAAGTGCACAGTCTA
s2_R_871_GGTGTGGTAA	CAAGCAGAAGACGGCATACGAGATGGTGTGGTAAAGGGTCAAGTGCACAGTCTA
s2_R_872_GTGAGTTGAT	CAAGCAGAAGACGGCATACGAGATGTGAGTTGATAGGGTCAAGTGCACAGTCTA
s2_R_873_CACGGACTTC	CAAGCAGAAGACGGCATACGAGATCACGGACTTCAGGGTCAAGTGCACAGTCTA
s2_R_874_TTACGTGATG	CAAGCAGAAGACGGCATACGAGATTTACGTGATGAGGGTCAAGTGCACAGTCTA
s2_R_875_GATAGCCAGT	CAAGCAGAAGACGGCATACGAGATGATAGCCAGTAGGGTCAAGTGCACAGTCTA
s2_R_876_TCGGCCTAGT	CAAGCAGAAGACGGCATACGAGATTCGGCCTAGTAGGGTCAAGTGCACAGTCTA
s2_R_877_TCCGTGCGTA	CAAGCAGAAGACGGCATACGAGATTCCGTGCGTAAGGGTCAAGTGCACAGTCTA
s2_R_878_AACGTGACAA	CAAGCAGAAGACGGCATACGAGATAACGTGACAAAGGGTCAAGTGCACAGTCTA
s2_R_879_AGCGTCATTA	CAAGCAGAAGACGGCATACGAGATAGCGTCATTAAGGGTCAAGTGCACAGTCTA
s2_R_880_ACCTCAATAG	CAAGCAGAAGACGGCATACGAGATACCTCAATAGAGGGTCAAGTGCACAGTCTA
s2_R_881_GAGACCAAGT	CAAGCAGAAGACGGCATACGAGATGAGACCAAGTAGGGTCAAGTGCACAGTCTA
s2_R_882_GGTGACTGAC	CAAGCAGAAGACGGCATACGAGATGGTGACTGACAGGGTCAAGTGCACAGTCTA
s2_R_883_GAGGACATTA	CAAGCAGAAGACGGCATACGAGATGAGGACATTAAGGGTCAAGTGCACAGTCTA
s2_R_884_CGAGCTATCC	CAAGCAGAAGACGGCATACGAGATCGAGCTATCCAGGGTCAAGTGCACAGTCTA
s2_R_885_GTCATGAATC	CAAGCAGAAGACGGCATACGAGATGTCATGAATCAGGGTCAAGTGCACAGTCTA
s2_R_886_CCTCACAAGC	CAAGCAGAAGACGGCATACGAGATCCTCACAAGCAGGGTCAAGTGCACAGTCTA
s2_R_887_CTGATGTACT	CAAGCAGAAGACGGCATACGAGATCTGATGTACTAGGGTCAAGTGCACAGTCTA
s2_R_888_TGGATAGGAC	CAAGCAGAAGACGGCATACGAGATTGGATAGGACAGGGTCAAGTGCACAGTCTA
s2_R_889_TGGAATCGGC	CAAGCAGAAGACGGCATACGAGATTGGAATCGGCAGGGTCAAGTGCACAGTCTA
s2_R_890_ACAGCCAGAG	CAAGCAGAAGACGGCATACGAGATACAGCCAGAGAGGGTCAAGTGCACAGTCTA
s2_R_891_ATATGGTGAG	CAAGCAGAAGACGGCATACGAGATATATGGTGAGAGGGTCAAGTGCACAGTCTA
s2_R_892_GGAGTGATAC	CAAGCAGAAGACGGCATACGAGATGGAGTGATACAGGGTCAAGTGCACAGTCTA
s2_R_893_GGTGAAGAGT	CAAGCAGAAGACGGCATACGAGATGGTGAAGAGTAGGGTCAAGTGCACAGTCTA
s2_R_894_CTGTTGGTAA	CAAGCAGAAGACGGCATACGAGATCTGTTGGTAAAGGGTCAAGTGCACAGTCTA
s2_R_895_ATTGTCGCTT	CAAGCAGAAGACGGCATACGAGATATTGTCGCTTAGGGTCAAGTGCACAGTCTA
s2_R_896_CTGAACCATT	CAAGCAGAAGACGGCATACGAGATCTGAACCATTAGGGTCAAGTGCACAGTCTA
s2_R_897_TTCGCGTTAA	CAAGCAGAAGACGGCATACGAGATTTCGCGTTAAAGGGTCAAGTGCACAGTCTA
s2_R_898_CATACGGTGA	CAAGCAGAAGACGGCATACGAGATCATACGGTGAAGGGTCAAGTGCACAGTCTA
s2_R_899_TTCCATTGGC	CAAGCAGAAGACGGCATACGAGATTTCCATTGGCAGGGTCAAGTGCACAGTCTA
s2_R_900_AACCTAGACC	CAAGCAGAAGACGGCATACGAGATAACCTAGACCAGGGTCAAGTGCACAGTCTA
s2_R_901_GAGTGGAACG	CAAGCAGAAGACGGCATACGAGATGAGTGGAACGAGGGTCAAGTGCACAGTCTA
s2_R_902_CTTCCGGTGT	CAAGCAGAAGACGGCATACGAGATCTTCCGGTGTAGGGTCAAGTGCACAGTCTA
s2_R_903_GGTTGAAGAC	CAAGCAGAAGACGGCATACGAGATGGTTGAAGACAGGGTCAAGTGCACAGTCTA
s2_R_904_CACATTGTAC	CAAGCAGAAGACGGCATACGAGATCACATTGTACAGGGTCAAGTGCACAGTCTA
s2_R_905_TAGGACTTGG	CAAGCAGAAGACGGCATACGAGATTAGGACTTGGAGGGTCAAGTGCACAGTCTA
s2_R_906_TCCGGTTCGA	CAAGCAGAAGACGGCATACGAGATTCCGGTTCGAAGGGTCAAGTGCACAGTCTA
s2_R_907_AGTATTCGCC	CAAGCAGAAGACGGCATACGAGATAGTATTCGCCAGGGTCAAGTGCACAGTCTA
s2_R_908_ACTCCAGACA	CAAGCAGAAGACGGCATACGAGATACTCCAGACAAGGGTCAAGTGCACAGTCTA
s2_R_909_CGACACCTAT	CAAGCAGAAGACGGCATACGAGATCGACACCTATAGGGTCAAGTGCACAGTCTA
s2_R_910_ATCATCCTTC	CAAGCAGAAGACGGCATACGAGATATCATCCTTCAGGGTCAAGTGCACAGTCTA
s2_R_911_GGAGAAGTAA	CAAGCAGAAGACGGCATACGAGATGGAGAAGTAAAGGGTCAAGTGCACAGTCTA
s2_R_912_AGTCTCGCCA	CAAGCAGAAGACGGCATACGAGATAGTCTCGCCAAGGGTCAAGTGCACAGTCTA
s2_R_913_AGTCTACGGC	CAAGCAGAAGACGGCATACGAGATAGTCTACGGCAGGGTCAAGTGCACAGTCTA
s2_R_914_CGACCGTAAG	CAAGCAGAAGACGGCATACGAGATCGACCGTAAGAGGGTCAAGTGCACAGTCTA
s2_R_915_ACCGCCTTAA	CAAGCAGAAGACGGCATACGAGATACCGCCTTAAAGGGTCAAGTGCACAGTCTA
s2_R_916_CAACAGATGG	CAAGCAGAAGACGGCATACGAGATCAACAGATGGAGGGTCAAGTGCACAGTCTA
s2_R_917_AGGTATAAGC	CAAGCAGAAGACGGCATACGAGATAGGTATAAGCAGGGTCAAGTGCACAGTCTA
s2_R_918_AAGCGAGGAG	CAAGCAGAAGACGGCATACGAGATAAGCGAGGAGAGGGTCAAGTGCACAGTCTA
s2_R_919_AGGCTATAGG	CAAGCAGAAGACGGCATACGAGATAGGCTATAGGAGGGTCAAGTGCACAGTCTA
s2_R_920_ACATCTCTCA	CAAGCAGAAGACGGCATACGAGATACATCTCTCAAGGGTCAAGTGCACAGTCTA
s2_R_921_CACGTAGACT	CAAGCAGAAGACGGCATACGAGATCACGTAGACTAGGGTCAAGTGCACAGTCTA
s2_R_922_CCAAGGACAA	CAAGCAGAAGACGGCATACGAGATCCAAGGACAAAGGGTCAAGTGCACAGTCTA
s2_R_923_ATCACACGTT	CAAGCAGAAGACGGCATACGAGATATCACACGTTAGGGTCAAGTGCACAGTCTA
s2_R_924_TTACGACGGT	CAAGCAGAAGACGGCATACGAGATTTACGACGGTAGGGTCAAGTGCACAGTCTA
s2_R_925_GGATTCGCTT	CAAGCAGAAGACGGCATACGAGATGGATTCGCTTAGGGTCAAGTGCACAGTCTA
s2_R_926_AACTCAGTCA	CAAGCAGAAGACGGCATACGAGATAACTCAGTCAAGGGTCAAGTGCACAGTCTA
s2_R_927_ATTGCCTAGT	CAAGCAGAAGACGGCATACGAGATATTGCCTAGTAGGGTCAAGTGCACAGTCTA
s2_R_928_CGTCTGATCA	CAAGCAGAAGACGGCATACGAGATCGTCTGATCAAGGGTCAAGTGCACAGTCTA
s2_R_929_CTATCAGTCC	CAAGCAGAAGACGGCATACGAGATCTATCAGTCCAGGGTCAAGTGCACAGTCTA
s2_R_930_AGTCCGAGTA	CAAGCAGAAGACGGCATACGAGATAGTCCGAGTAAGGGTCAAGTGCACAGTCTA
s2_R_931_GAATTGGAAC	CAAGCAGAAGACGGCATACGAGATGAATTGGAACAGGGTCAAGTGCACAGTCTA
s2_R_932_ACTCACAGGT	CAAGCAGAAGACGGCATACGAGATACTCACAGGTAGGGTCAAGTGCACAGTCTA
s2_R_933_CCAGTGCTAG	CAAGCAGAAGACGGCATACGAGATCCAGTGCTAGAGGGTCAAGTGCACAGTCTA
s2_R_934_GTTGATGACT	CAAGCAGAAGACGGCATACGAGATGTTGATGACTAGGGTCAAGTGCACAGTCTA
s2_R_935_AAGGTTCGCT	CAAGCAGAAGACGGCATACGAGATAAGGTTCGCTAGGGTCAAGTGCACAGTCTA
s2_R_936_ACCACATTCA	CAAGCAGAAGACGGCATACGAGATACCACATTCAAGGGTCAAGTGCACAGTCTA
s2_R_937_CTGAACTCTC	CAAGCAGAAGACGGCATACGAGATCTGAACTCTCAGGGTCAAGTGCACAGTCTA
s2_R_938_AACCATTGAC	CAAGCAGAAGACGGCATACGAGATAACCATTGACAGGGTCAAGTGCACAGTCTA
s2_R_939_TGTTCCAGCT	CAAGCAGAAGACGGCATACGAGATTGTTCCAGCTAGGGTCAAGTGCACAGTCTA
s2_R_940_ACAGCTATTG	CAAGCAGAAGACGGCATACGAGATACAGCTATTGAGGGTCAAGTGCACAGTCTA
s2_R_941_CAATCGTTGA	CAAGCAGAAGACGGCATACGAGATCAATCGTTGAAGGGTCAAGTGCACAGTCTA
s2_R_942_CCTCACTTAT	CAAGCAGAAGACGGCATACGAGATCCTCACTTATAGGGTCAAGTGCACAGTCTA
s2_R_943_CTAGTCGCAC	CAAGCAGAAGACGGCATACGAGATCTAGTCGCACAGGGTCAAGTGCACAGTCTA
s2_R_944_CACCTCTCAC	CAAGCAGAAGACGGCATACGAGATCACCTCTCACAGGGTCAAGTGCACAGTCTA
s2_R_945_TAGTGTAAGC	CAAGCAGAAGACGGCATACGAGATTAGTGTAAGCAGGGTCAAGTGCACAGTCTA
s2_R_946_TGTAGAAGCG	CAAGCAGAAGACGGCATACGAGATTGTAGAAGCGAGGGTCAAGTGCACAGTCTA
s2_R_947_AGAAGTGGAA	CAAGCAGAAGACGGCATACGAGATAGAAGTGGAAAGGGTCAAGTGCACAGTCTA
s2_R_948_AGGTCTCATA	CAAGCAGAAGACGGCATACGAGATAGGTCTCATAAGGGTCAAGTGCACAGTCTA
s2_R_949_GATAATGGAG	CAAGCAGAAGACGGCATACGAGATGATAATGGAGAGGGTCAAGTGCACAGTCTA
s2_R_950_ATCGCCATCG	CAAGCAGAAGACGGCATACGAGATATCGCCATCGAGGGTCAAGTGCACAGTCTA
s2_R_951_GAGGTTGCTC	CAAGCAGAAGACGGCATACGAGATGAGGTTGCTCAGGGTCAAGTGCACAGTCTA
s2_R_952_TATGCGACTC	CAAGCAGAAGACGGCATACGAGATTATGCGACTCAGGGTCAAGTGCACAGTCTA
s2_R_953_TCCTTAAGCC	CAAGCAGAAGACGGCATACGAGATTCCTTAAGCCAGGGTCAAGTGCACAGTCTA
s2_R_954_GCAATGCGGT	CAAGCAGAAGACGGCATACGAGATGCAATGCGGTAGGGTCAAGTGCACAGTCTA
s2_R_955_AAGGTGTTCC	CAAGCAGAAGACGGCATACGAGATAAGGTGTTCCAGGGTCAAGTGCACAGTCTA
s2_R_956_AGAGTGAAGG	CAAGCAGAAGACGGCATACGAGATAGAGTGAAGGAGGGTCAAGTGCACAGTCTA
s2_R_957_CAACATCATC	CAAGCAGAAGACGGCATACGAGATCAACATCATCAGGGTCAAGTGCACAGTCTA
s2_R_958_GATGTCGGAA	CAAGCAGAAGACGGCATACGAGATGATGTCGGAAAGGGTCAAGTGCACAGTCTA
s2_R_959_TTAACGTGTC	CAAGCAGAAGACGGCATACGAGATTTAACGTGTCAGGGTCAAGTGCACAGTCTA
s2_R_960_AGCTAAGACT	CAAGCAGAAGACGGCATACGAGATAGCTAAGACTAGGGTCAAGTGCACAGTCTA
s2_R_961_GACTATGAGG	CAAGCAGAAGACGGCATACGAGATGACTATGAGGAGGGTCAAGTGCACAGTCTA
s2_R_962_CGATAAGTGT	CAAGCAGAAGACGGCATACGAGATCGATAAGTGTAGGGTCAAGTGCACAGTCTA
s2_R_963_CGACTTATGT	CAAGCAGAAGACGGCATACGAGATCGACTTATGTAGGGTCAAGTGCACAGTCTA
s2_R_964_TAGGCTAGAC	CAAGCAGAAGACGGCATACGAGATTAGGCTAGACAGGGTCAAGTGCACAGTCTA
s2_R_965_AGTCGAAGTT	CAAGCAGAAGACGGCATACGAGATAGTCGAAGTTAGGGTCAAGTGCACAGTCTA
s2_R_966_ACACGACAAG	CAAGCAGAAGACGGCATACGAGATACACGACAAGAGGGTCAAGTGCACAGTCTA
s2_R_967_TGCAAGTCCG	CAAGCAGAAGACGGCATACGAGATTGCAAGTCCGAGGGTCAAGTGCACAGTCTA
s2_R_968_TTATCGCCAA	CAAGCAGAAGACGGCATACGAGATTTATCGCCAAAGGGTCAAGTGCACAGTCTA
s2_R_969_ATCTAGGACC	CAAGCAGAAGACGGCATACGAGATATCTAGGACCAGGGTCAAGTGCACAGTCTA
s2_R_970_TTCGCATCTC	CAAGCAGAAGACGGCATACGAGATTTCGCATCTCAGGGTCAAGTGCACAGTCTA
s2_R_971_CGAAGTATGG	CAAGCAGAAGACGGCATACGAGATCGAAGTATGGAGGGTCAAGTGCACAGTCTA
s2_R_972_GGACGACGAA	CAAGCAGAAGACGGCATACGAGATGGACGACGAAAGGGTCAAGTGCACAGTCTA
s2_R_973_ATCTGGTCTG	CAAGCAGAAGACGGCATACGAGATATCTGGTCTGAGGGTCAAGTGCACAGTCTA
s2_R_974_GAGTTCGGTA	CAAGCAGAAGACGGCATACGAGATGAGTTCGGTAAGGGTCAAGTGCACAGTCTA
s2_R_975_CACTATCTTC	CAAGCAGAAGACGGCATACGAGATCACTATCTTCAGGGTCAAGTGCACAGTCTA
s2_R_976_CTATTCCTAC	CAAGCAGAAGACGGCATACGAGATCTATTCCTACAGGGTCAAGTGCACAGTCTA
s2_R_977_GTCAACAGCT	CAAGCAGAAGACGGCATACGAGATGTCAACAGCTAGGGTCAAGTGCACAGTCTA
s2_R_978_GTATTGCCTT	CAAGCAGAAGACGGCATACGAGATGTATTGCCTTAGGGTCAAGTGCACAGTCTA
s2_R_979_ACTGCGAGCT	CAAGCAGAAGACGGCATACGAGATACTGCGAGCTAGGGTCAAGTGCACAGTCTA
s2_R_980_ATGAGTCAGC	CAAGCAGAAGACGGCATACGAGATATGAGTCAGCAGGGTCAAGTGCACAGTCTA
s2_R_981_AGCATCCATT	CAAGCAGAAGACGGCATACGAGATAGCATCCATTAGGGTCAAGTGCACAGTCTA
s2_R_982_CTTAGTGCTG	CAAGCAGAAGACGGCATACGAGATCTTAGTGCTGAGGGTCAAGTGCACAGTCTA
s2_R_983_AGGTCGACAA	CAAGCAGAAGACGGCATACGAGATAGGTCGACAAAGGGTCAAGTGCACAGTCTA
s2_R_984_GTGTAAGCAC	CAAGCAGAAGACGGCATACGAGATGTGTAAGCACAGGGTCAAGTGCACAGTCTA
s2_R_985_AGGCATCCTA	CAAGCAGAAGACGGCATACGAGATAGGCATCCTAAGGGTCAAGTGCACAGTCTA
s2_R_986_AGTCCACCGT	CAAGCAGAAGACGGCATACGAGATAGTCCACCGTAGGGTCAAGTGCACAGTCTA
s2_R_987_CACACACCGT	CAAGCAGAAGACGGCATACGAGATCACACACCGTAGGGTCAAGTGCACAGTCTA
s2_R_988_AGCATGTACC	CAAGCAGAAGACGGCATACGAGATAGCATGTACCAGGGTCAAGTGCACAGTCTA
s2_R_989_GTCGCATCAT	CAAGCAGAAGACGGCATACGAGATGTCGCATCATAGGGTCAAGTGCACAGTCTA
s2_R_990_CGCAAGAGCT	CAAGCAGAAGACGGCATACGAGATCGCAAGAGCTAGGGTCAAGTGCACAGTCTA
s2_R_991_TATAGTGAGC	CAAGCAGAAGACGGCATACGAGATTATAGTGAGCAGGGTCAAGTGCACAGTCTA
s2_R_992_CGATGTGAGA	CAAGCAGAAGACGGCATACGAGATCGATGTGAGAAGGGTCAAGTGCACAGTCTA
s2_R_993_ACACGTTACT	CAAGCAGAAGACGGCATACGAGATACACGTTACTAGGGTCAAGTGCACAGTCTA
s2_R_994_CTTGGACATT	CAAGCAGAAGACGGCATACGAGATCTTGGACATTAGGGTCAAGTGCACAGTCTA
s2_R_995_CTGTGAGTGT	CAAGCAGAAGACGGCATACGAGATCTGTGAGTGTAGGGTCAAGTGCACAGTCTA
s2_R_996_CCTCTGTGAA	CAAGCAGAAGACGGCATACGAGATCCTCTGTGAAAGGGTCAAGTGCACAGTCTA
s2_R_997_ACGCTAATAC	CAAGCAGAAGACGGCATACGAGATACGCTAATACAGGGTCAAGTGCACAGTCTA
s2_R_998_CGGAGACAAG	CAAGCAGAAGACGGCATACGAGATCGGAGACAAGAGGGTCAAGTGCACAGTCTA
s2_R_999_GCTATCCTAG	CAAGCAGAAGACGGCATACGAGATGCTATCCTAGAGGGTCAAGTGCACAGTCTA
s2_R_1000_TAAGGACGTT	CAAGCAGAAGACGGCATACGAGATTAAGGACGTTAGGGTCAAGTGCACAGTCTA
s2_R_1001_CCACTTACGA	CAAGCAGAAGACGGCATACGAGATCCACTTACGAAGGGTCAAGTGCACAGTCTA
s2_R_1002_CGTCGAGAGT	CAAGCAGAAGACGGCATACGAGATCGTCGAGAGTAGGGTCAAGTGCACAGTCTA
s2_R_1003_AGCTAGGCAG	CAAGCAGAAGACGGCATACGAGATAGCTAGGCAGAGGGTCAAGTGCACAGTCTA
s2_R_1004_AGTATTCCGT	CAAGCAGAAGACGGCATACGAGATAGTATTCCGTAGGGTCAAGTGCACAGTCTA
s2_R_1005_AAGCTAGGTC	CAAGCAGAAGACGGCATACGAGATAAGCTAGGTCAGGGTCAAGTGCACAGTCTA
s2_R_1006_AACCTCCAGA	CAAGCAGAAGACGGCATACGAGATAACCTCCAGAAGGGTCAAGTGCACAGTCTA
s2_R_1007_GAGACGTATT	CAAGCAGAAGACGGCATACGAGATGAGACGTATTAGGGTCAAGTGCACAGTCTA
s2_R_1008_CGTGATCCAA	CAAGCAGAAGACGGCATACGAGATCGTGATCCAAAGGGTCAAGTGCACAGTCTA
s2_R_1009_CCACGACCTT	CAAGCAGAAGACGGCATACGAGATCCACGACCTTAGGGTCAAGTGCACAGTCTA
s2_R_1010_GTAGGTCATA	CAAGCAGAAGACGGCATACGAGATGTAGGTCATAAGGGTCAAGTGCACAGTCTA
s2_R_1011_GCACACGAAG	CAAGCAGAAGACGGCATACGAGATGCACACGAAGAGGGTCAAGTGCACAGTCTA
s2_R_1012_GTCAAGCATT	CAAGCAGAAGACGGCATACGAGATGTCAAGCATTAGGGTCAAGTGCACAGTCTA
s2_R_1013_ATGATGGACC	CAAGCAGAAGACGGCATACGAGATATGATGGACCAGGGTCAAGTGCACAGTCTA
s2_R_1014_GGAACTATAC	CAAGCAGAAGACGGCATACGAGATGGAACTATACAGGGTCAAGTGCACAGTCTA
s2_R_1015_TGAAGAGTGG	CAAGCAGAAGACGGCATACGAGATTGAAGAGTGGAGGGTCAAGTGCACAGTCTA
s2_R_1016_AAGCTGGTAT	CAAGCAGAAGACGGCATACGAGATAAGCTGGTATAGGGTCAAGTGCACAGTCTA
s2_R_1017_ACACTGTACA	CAAGCAGAAGACGGCATACGAGATACACTGTACAAGGGTCAAGTGCACAGTCTA
s2_R_1018_GAATGCCATA	CAAGCAGAAGACGGCATACGAGATGAATGCCATAAGGGTCAAGTGCACAGTCTA
s2_R_1019_ACAGAGGTCT	CAAGCAGAAGACGGCATACGAGATACAGAGGTCTAGGGTCAAGTGCACAGTCTA
s2_R_1020_GCTTGCTGAC	CAAGCAGAAGACGGCATACGAGATGCTTGCTGACAGGGTCAAGTGCACAGTCTA
s2_R_1021_CAGTAGTAGG	CAAGCAGAAGACGGCATACGAGATCAGTAGTAGGAGGGTCAAGTGCACAGTCTA
s2_R_1022_CGTCACGAAT	CAAGCAGAAGACGGCATACGAGATCGTCACGAATAGGGTCAAGTGCACAGTCTA
s2_R_1023_CTAGATGCTC	CAAGCAGAAGACGGCATACGAGATCTAGATGCTCAGGGTCAAGTGCACAGTCTA
s2_R_1024_TAGTCCGTGT	CAAGCAGAAGACGGCATACGAGATTAGTCCGTGTAGGGTCAAGTGCACAGTCTA
s2_R_1025_TCCGGAGCAT	CAAGCAGAAGACGGCATACGAGATTCCGGAGCATAGGGTCAAGTGCACAGTCTA
s2_R_1026_TGTCTACGTT	CAAGCAGAAGACGGCATACGAGATTGTCTACGTTAGGGTCAAGTGCACAGTCTA
s2_R_1027_ACACACTCTA	CAAGCAGAAGACGGCATACGAGATACACACTCTAAGGGTCAAGTGCACAGTCTA
s2_R_1028_CGTCATGTGA	CAAGCAGAAGACGGCATACGAGATCGTCATGTGAAGGGTCAAGTGCACAGTCTA
s2_R_1029_CGACAGTACA	CAAGCAGAAGACGGCATACGAGATCGACAGTACAAGGGTCAAGTGCACAGTCTA
s2_R_1030_CACCAATCCT	CAAGCAGAAGACGGCATACGAGATCACCAATCCTAGGGTCAAGTGCACAGTCTA
s2_R_1031_GAAGAAGTTC	CAAGCAGAAGACGGCATACGAGATGAAGAAGTTCAGGGTCAAGTGCACAGTCTA
s2_R_1032_GTCGATCGAG	CAAGCAGAAGACGGCATACGAGATGTCGATCGAGAGGGTCAAGTGCACAGTCTA
s2_R_1033_GGATCTAACC	CAAGCAGAAGACGGCATACGAGATGGATCTAACCAGGGTCAAGTGCACAGTCTA
s2_R_1034_ACGACAGGAT	CAAGCAGAAGACGGCATACGAGATACGACAGGATAGGGTCAAGTGCACAGTCTA
s2_R_1035_GTCTCCATGC	CAAGCAGAAGACGGCATACGAGATGTCTCCATGCAGGGTCAAGTGCACAGTCTA
s2_R_1036_GTCAACTACA	CAAGCAGAAGACGGCATACGAGATGTCAACTACAAGGGTCAAGTGCACAGTCTA
s2_R_1037_GATCGGTGAA	CAAGCAGAAGACGGCATACGAGATGATCGGTGAAAGGGTCAAGTGCACAGTCTA
s2_R_1038_ATCGCTAACA	CAAGCAGAAGACGGCATACGAGATATCGCTAACAAGGGTCAAGTGCACAGTCTA
s2_R_1039_AGAGTCCGTT	CAAGCAGAAGACGGCATACGAGATAGAGTCCGTTAGGGTCAAGTGCACAGTCTA
s2_R_1040_GGTAATTCTC	CAAGCAGAAGACGGCATACGAGATGGTAATTCTCAGGGTCAAGTGCACAGTCTA
s2_R_1041_TCATCGTCGA	CAAGCAGAAGACGGCATACGAGATTCATCGTCGAAGGGTCAAGTGCACAGTCTA
s2_R_1042_ACACGTCATC	CAAGCAGAAGACGGCATACGAGATACACGTCATCAGGGTCAAGTGCACAGTCTA
s2_R_1043_GTCCACTAGT	CAAGCAGAAGACGGCATACGAGATGTCCACTAGTAGGGTCAAGTGCACAGTCTA
s2_R_1044_AGCTCTGCAT	CAAGCAGAAGACGGCATACGAGATAGCTCTGCATAGGGTCAAGTGCACAGTCTA
s2_R_1045_TGACTCGAGT	CAAGCAGAAGACGGCATACGAGATTGACTCGAGTAGGGTCAAGTGCACAGTCTA
s2_R_1046_GCGTGCTATG	CAAGCAGAAGACGGCATACGAGATGCGTGCTATGAGGGTCAAGTGCACAGTCTA
s2_R_1047_TTCGACCATC	CAAGCAGAAGACGGCATACGAGATTTCGACCATCAGGGTCAAGTGCACAGTCTA
s2_R_1048_CGAACTTATC	CAAGCAGAAGACGGCATACGAGATCGAACTTATCAGGGTCAAGTGCACAGTCTA
s2_R_1049_AGCATTCTGG	CAAGCAGAAGACGGCATACGAGATAGCATTCTGGAGGGTCAAGTGCACAGTCTA
s2_R_1050_ACGAGACTCT	CAAGCAGAAGACGGCATACGAGATACGAGACTCTAGGGTCAAGTGCACAGTCTA
s2_R_1051_ATCCGTCTGA	CAAGCAGAAGACGGCATACGAGATATCCGTCTGAAGGGTCAAGTGCACAGTCTA
s2_R_1052_GCTACACCGT	CAAGCAGAAGACGGCATACGAGATGCTACACCGTAGGGTCAAGTGCACAGTCTA
s2_R_1053_CCGCATATAG	CAAGCAGAAGACGGCATACGAGATCCGCATATAGAGGGTCAAGTGCACAGTCTA
s2_R_1054_CTAAGAGCTA	CAAGCAGAAGACGGCATACGAGATCTAAGAGCTAAGGGTCAAGTGCACAGTCTA
s2_R_1055_TCTAAGCTCA	CAAGCAGAAGACGGCATACGAGATTCTAAGCTCAAGGGTCAAGTGCACAGTCTA
s2_R_1056_CGATTACAGC	CAAGCAGAAGACGGCATACGAGATCGATTACAGCAGGGTCAAGTGCACAGTCTA
s2_R_1057_AAGTCAGCTA	CAAGCAGAAGACGGCATACGAGATAAGTCAGCTAAGGGTCAAGTGCACAGTCTA
s2_R_1058_CTCAACTAGC	CAAGCAGAAGACGGCATACGAGATCTCAACTAGCAGGGTCAAGTGCACAGTCTA
s2_R_1059_ACGGTGAGAG	CAAGCAGAAGACGGCATACGAGATACGGTGAGAGAGGGTCAAGTGCACAGTCTA
s2_R_1060_GGTAGACGGT	CAAGCAGAAGACGGCATACGAGATGGTAGACGGTAGGGTCAAGTGCACAGTCTA
s2_R_1061_CATAAGTTGC	CAAGCAGAAGACGGCATACGAGATCATAAGTTGCAGGGTCAAGTGCACAGTCTA
s2_R_1062_TAAGCACGGC	CAAGCAGAAGACGGCATACGAGATTAAGCACGGCAGGGTCAAGTGCACAGTCTA
s2_R_1063_CAGAGGCTCA	CAAGCAGAAGACGGCATACGAGATCAGAGGCTCAAGGGTCAAGTGCACAGTCTA
s2_R_1064_CGATCGGTAT	CAAGCAGAAGACGGCATACGAGATCGATCGGTATAGGGTCAAGTGCACAGTCTA
s2_R_1065_CGTTCTGTGT	CAAGCAGAAGACGGCATACGAGATCGTTCTGTGTAGGGTCAAGTGCACAGTCTA
s2_R_1066_TCACACACAT	CAAGCAGAAGACGGCATACGAGATTCACACACATAGGGTCAAGTGCACAGTCTA
s2_R_1067_AATAGGAGGA	CAAGCAGAAGACGGCATACGAGATAATAGGAGGAAGGGTCAAGTGCACAGTCTA
s2_R_1068_TAAGCACACT	CAAGCAGAAGACGGCATACGAGATTAAGCACACTAGGGTCAAGTGCACAGTCTA
s2_R_1069_GAAGCCACTG	CAAGCAGAAGACGGCATACGAGATGAAGCCACTGAGGGTCAAGTGCACAGTCTA
s2_R_1070_GCTAGAATAG	CAAGCAGAAGACGGCATACGAGATGCTAGAATAGAGGGTCAAGTGCACAGTCTA
s2_R_1071_AAGTGAAGCC	CAAGCAGAAGACGGCATACGAGATAAGTGAAGCCAGGGTCAAGTGCACAGTCTA
s2_R_1072_AAGGAGGACT	CAAGCAGAAGACGGCATACGAGATAAGGAGGACTAGGGTCAAGTGCACAGTCTA
s2_R_1073_ATGCTAAGCC	CAAGCAGAAGACGGCATACGAGATATGCTAAGCCAGGGTCAAGTGCACAGTCTA
s2_R_1074_ATTGTCAAGG	CAAGCAGAAGACGGCATACGAGATATTGTCAAGGAGGGTCAAGTGCACAGTCTA
s2_R_1075_ACGATTAAGG	CAAGCAGAAGACGGCATACGAGATACGATTAAGGAGGGTCAAGTGCACAGTCTA
s2_R_1076_ACGAGTATAC	CAAGCAGAAGACGGCATACGAGATACGAGTATACAGGGTCAAGTGCACAGTCTA
s2_R_1077_GCGAGAACTA	CAAGCAGAAGACGGCATACGAGATGCGAGAACTAAGGGTCAAGTGCACAGTCTA
s2_R_1078_AAGCATCATG	CAAGCAGAAGACGGCATACGAGATAAGCATCATGAGGGTCAAGTGCACAGTCTA
s2_R_1079_TGCAACCTAC	CAAGCAGAAGACGGCATACGAGATTGCAACCTACAGGGTCAAGTGCACAGTCTA
s2_R_1080_TTAGAGCTTC	CAAGCAGAAGACGGCATACGAGATTTAGAGCTTCAGGGTCAAGTGCACAGTCTA
s2_R_1081_CCAGAGTTAA	CAAGCAGAAGACGGCATACGAGATCCAGAGTTAAAGGGTCAAGTGCACAGTCTA
s2_R_1082_TGTGATATGC	CAAGCAGAAGACGGCATACGAGATTGTGATATGCAGGGTCAAGTGCACAGTCTA
s2_R_1083_AGCTTACTGA	CAAGCAGAAGACGGCATACGAGATAGCTTACTGAAGGGTCAAGTGCACAGTCTA
s2_R_1084_GGATAAGCAG	CAAGCAGAAGACGGCATACGAGATGGATAAGCAGAGGGTCAAGTGCACAGTCTA
s2_R_1085_GCTACGTAGG	CAAGCAGAAGACGGCATACGAGATGCTACGTAGGAGGGTCAAGTGCACAGTCTA
s2_R_1086_CGATAGAGTC	CAAGCAGAAGACGGCATACGAGATCGATAGAGTCAGGGTCAAGTGCACAGTCTA
s2_R_1087_GAGGAATCAA	CAAGCAGAAGACGGCATACGAGATGAGGAATCAAAGGGTCAAGTGCACAGTCTA
s2_R_1088_ACAATGCTCA	CAAGCAGAAGACGGCATACGAGATACAATGCTCAAGGGTCAAGTGCACAGTCTA
s2_R_1089_ACACAAGGAG	CAAGCAGAAGACGGCATACGAGATACACAAGGAGAGGGTCAAGTGCACAGTCTA
s2_R_1090_AGCTTAAGGC	CAAGCAGAAGACGGCATACGAGATAGCTTAAGGCAGGGTCAAGTGCACAGTCTA
s2_R_1091_CGTCCATCAG	CAAGCAGAAGACGGCATACGAGATCGTCCATCAGAGGGTCAAGTGCACAGTCTA
s2_R_1092_AATCAGCTTC	CAAGCAGAAGACGGCATACGAGATAATCAGCTTCAGGGTCAAGTGCACAGTCTA
s2_R_1093_ATAGTTCCTG	CAAGCAGAAGACGGCATACGAGATATAGTTCCTGAGGGTCAAGTGCACAGTCTA
s2_R_1094_AGTAGGATCA	CAAGCAGAAGACGGCATACGAGATAGTAGGATCAAGGGTCAAGTGCACAGTCTA
s2_R_1095_CGACTCTTCA	CAAGCAGAAGACGGCATACGAGATCGACTCTTCAAGGGTCAAGTGCACAGTCTA
s2_R_1096_ATGTACCACT	CAAGCAGAAGACGGCATACGAGATATGTACCACTAGGGTCAAGTGCACAGTCTA
s2_R_1097_CACCATGCGT	CAAGCAGAAGACGGCATACGAGATCACCATGCGTAGGGTCAAGTGCACAGTCTA
s2_R_1098_GTTACTCCTT	CAAGCAGAAGACGGCATACGAGATGTTACTCCTTAGGGTCAAGTGCACAGTCTA
s2_R_1099_GCAACCTGAG	CAAGCAGAAGACGGCATACGAGATGCAACCTGAGAGGGTCAAGTGCACAGTCTA
s2_R_1100_ACGAATTACC	CAAGCAGAAGACGGCATACGAGATACGAATTACCAGGGTCAAGTGCACAGTCTA
s2_R_1101_GTTGAAGCTC	CAAGCAGAAGACGGCATACGAGATGTTGAAGCTCAGGGTCAAGTGCACAGTCTA
s2_R_1102_TCAGCTACAC	CAAGCAGAAGACGGCATACGAGATTCAGCTACACAGGGTCAAGTGCACAGTCTA
s2_R_1103_CGTTCCTTAT	CAAGCAGAAGACGGCATACGAGATCGTTCCTTATAGGGTCAAGTGCACAGTCTA
s2_R_1104_GACCAAGACT	CAAGCAGAAGACGGCATACGAGATGACCAAGACTAGGGTCAAGTGCACAGTCTA
s2_R_1105_CTTACTAGGA	CAAGCAGAAGACGGCATACGAGATCTTACTAGGAAGGGTCAAGTGCACAGTCTA
s2_R_1106_TAACGCTGTT	CAAGCAGAAGACGGCATACGAGATTAACGCTGTTAGGGTCAAGTGCACAGTCTA
s2_R_1107_ATCTTAGCCA	CAAGCAGAAGACGGCATACGAGATATCTTAGCCAAGGGTCAAGTGCACAGTCTA
s2_R_1108_TACACACTAC	CAAGCAGAAGACGGCATACGAGATTACACACTACAGGGTCAAGTGCACAGTCTA
s2_R_1109_ACGCTGCTTC	CAAGCAGAAGACGGCATACGAGATACGCTGCTTCAGGGTCAAGTGCACAGTCTA
s2_R_1110_CTGAGAACAT	CAAGCAGAAGACGGCATACGAGATCTGAGAACATAGGGTCAAGTGCACAGTCTA
s2_R_1111_GACCATGATA	CAAGCAGAAGACGGCATACGAGATGACCATGATAAGGGTCAAGTGCACAGTCTA
s2_R_1112_TGCATGGATA	CAAGCAGAAGACGGCATACGAGATTGCATGGATAAGGGTCAAGTGCACAGTCTA
s2_R_1113_GCGTGTGATA	CAAGCAGAAGACGGCATACGAGATGCGTGTGATAAGGGTCAAGTGCACAGTCTA
s2_R_1114_CACCACAATG	CAAGCAGAAGACGGCATACGAGATCACCACAATGAGGGTCAAGTGCACAGTCTA
s2_R_1115_GCAACTCTAT	CAAGCAGAAGACGGCATACGAGATGCAACTCTATAGGGTCAAGTGCACAGTCTA
s2_R_1116_GACTACTTAC	CAAGCAGAAGACGGCATACGAGATGACTACTTACAGGGTCAAGTGCACAGTCTA
s2_R_1117_TAGGCAACTA	CAAGCAGAAGACGGCATACGAGATTAGGCAACTAAGGGTCAAGTGCACAGTCTA
s2_R_1118_GACACTATGC	CAAGCAGAAGACGGCATACGAGATGACACTATGCAGGGTCAAGTGCACAGTCTA
s2_R_1119_AACGTGCTAT	CAAGCAGAAGACGGCATACGAGATAACGTGCTATAGGGTCAAGTGCACAGTCTA
s2_R_1120_CAAGGACGAC	CAAGCAGAAGACGGCATACGAGATCAAGGACGACAGGGTCAAGTGCACAGTCTA
s2_R_1121_CATTCATCCA	CAAGCAGAAGACGGCATACGAGATCATTCATCCAAGGGTCAAGTGCACAGTCTA
s2_R_1122_TGGCTATTGC	CAAGCAGAAGACGGCATACGAGATTGGCTATTGCAGGGTCAAGTGCACAGTCTA
s2_R_1123_CATCTACCTT	CAAGCAGAAGACGGCATACGAGATCATCTACCTTAGGGTCAAGTGCACAGTCTA
s2_R_1124_CGCAAGAATA	CAAGCAGAAGACGGCATACGAGATCGCAAGAATAAGGGTCAAGTGCACAGTCTA
s2_R_1125_CAGGTCTAAT	CAAGCAGAAGACGGCATACGAGATCAGGTCTAATAGGGTCAAGTGCACAGTCTA
s2_R_1126_AGACCATGTT	CAAGCAGAAGACGGCATACGAGATAGACCATGTTAGGGTCAAGTGCACAGTCTA
s2_R_1127_ACAGCAGAAC	CAAGCAGAAGACGGCATACGAGATACAGCAGAACAGGGTCAAGTGCACAGTCTA
s2_R_1128_AGAGTCACTC	CAAGCAGAAGACGGCATACGAGATAGAGTCACTCAGGGTCAAGTGCACAGTCTA
s2_R_1129_TTGCTTCTGG	CAAGCAGAAGACGGCATACGAGATTTGCTTCTGGAGGGTCAAGTGCACAGTCTA
s2_R_1130_TGGATGACAT	CAAGCAGAAGACGGCATACGAGATTGGATGACATAGGGTCAAGTGCACAGTCTA
s2_R_1131_ACTTGTCCAC	CAAGCAGAAGACGGCATACGAGATACTTGTCCACAGGGTCAAGTGCACAGTCTA
s2_R_1132_AAGAAGCCAC	CAAGCAGAAGACGGCATACGAGATAAGAAGCCACAGGGTCAAGTGCACAGTCTA
s2_R_1133_TTCAGTCCTA	CAAGCAGAAGACGGCATACGAGATTTCAGTCCTAAGGGTCAAGTGCACAGTCTA
s2_R_1134_TGGTAGACGA	CAAGCAGAAGACGGCATACGAGATTGGTAGACGAAGGGTCAAGTGCACAGTCTA
s2_R_1135_CCAGATAAGA	CAAGCAGAAGACGGCATACGAGATCCAGATAAGAAGGGTCAAGTGCACAGTCTA
s2_R_1136_TACTCGGTTA	CAAGCAGAAGACGGCATACGAGATTACTCGGTTAAGGGTCAAGTGCACAGTCTA
s2_R_1137_TCTTGGCTAC	CAAGCAGAAGACGGCATACGAGATTCTTGGCTACAGGGTCAAGTGCACAGTCTA
s2_R_1138_ACAGTTCTGA	CAAGCAGAAGACGGCATACGAGATACAGTTCTGAAGGGTCAAGTGCACAGTCTA
s2_R_1139_GTCGGCCATT	CAAGCAGAAGACGGCATACGAGATGTCGGCCATTAGGGTCAAGTGCACAGTCTA
s2_R_1140_CGTTCGAGTT	CAAGCAGAAGACGGCATACGAGATCGTTCGAGTTAGGGTCAAGTGCACAGTCTA
s2_R_1141_GTCACACATA	CAAGCAGAAGACGGCATACGAGATGTCACACATAAGGGTCAAGTGCACAGTCTA
s2_R_1142_CACAAGGAAT	CAAGCAGAAGACGGCATACGAGATCACAAGGAATAGGGTCAAGTGCACAGTCTA
s2_R_1143_AGAGCTGATT	CAAGCAGAAGACGGCATACGAGATAGAGCTGATTAGGGTCAAGTGCACAGTCTA
s2_R_1144_ATGCGATAGT	CAAGCAGAAGACGGCATACGAGATATGCGATAGTAGGGTCAAGTGCACAGTCTA
s2_R_1145_CGTTAGAAGT	CAAGCAGAAGACGGCATACGAGATCGTTAGAAGTAGGGTCAAGTGCACAGTCTA
s2_R_1146_TAGGAACTCC	CAAGCAGAAGACGGCATACGAGATTAGGAACTCCAGGGTCAAGTGCACAGTCTA
s2_R_1147_CCTTAACAGC	CAAGCAGAAGACGGCATACGAGATCCTTAACAGCAGGGTCAAGTGCACAGTCTA
s2_R_1148_CAACGAAGAG	CAAGCAGAAGACGGCATACGAGATCAACGAAGAGAGGGTCAAGTGCACAGTCTA
s2_R_1149_TAAGCGACAG	CAAGCAGAAGACGGCATACGAGATTAAGCGACAGAGGGTCAAGTGCACAGTCTA
s2_R_1150_CAAGAGGCAA	CAAGCAGAAGACGGCATACGAGATCAAGAGGCAAAGGGTCAAGTGCACAGTCTA
s2_R_1151_TGGAGGCCTT	CAAGCAGAAGACGGCATACGAGATTGGAGGCCTTAGGGTCAAGTGCACAGTCTA
s2_R_1152_GAGTCAAGAA	CAAGCAGAAGACGGCATACGAGATGAGTCAAGAAAGGGTCAAGTGCACAGTCTA
s2_R_1153_GTAACTACTG	CAAGCAGAAGACGGCATACGAGATGTAACTACTGAGGGTCAAGTGCACAGTCTA
s2_R_1154_CAACCGATAT	CAAGCAGAAGACGGCATACGAGATCAACCGATATAGGGTCAAGTGCACAGTCTA
s2_R_1155_CAGGTCATGG	CAAGCAGAAGACGGCATACGAGATCAGGTCATGGAGGGTCAAGTGCACAGTCTA
s2_R_1156_ATGCATGACA	CAAGCAGAAGACGGCATACGAGATATGCATGACAAGGGTCAAGTGCACAGTCTA
s2_R_1157_GGTAAGTCGG	CAAGCAGAAGACGGCATACGAGATGGTAAGTCGGAGGGTCAAGTGCACAGTCTA
s2_R_1158_ACAATAAGGC	CAAGCAGAAGACGGCATACGAGATACAATAAGGCAGGGTCAAGTGCACAGTCTA
s2_R_1159_GGAGAGCACA	CAAGCAGAAGACGGCATACGAGATGGAGAGCACAAGGGTCAAGTGCACAGTCTA
s2_R_1160_GAGAGGTGAC	CAAGCAGAAGACGGCATACGAGATGAGAGGTGACAGGGTCAAGTGCACAGTCTA
s2_R_1161_TGTAGACAAC	CAAGCAGAAGACGGCATACGAGATTGTAGACAACAGGGTCAAGTGCACAGTCTA
s2_R_1162_CGGATAGTTC	CAAGCAGAAGACGGCATACGAGATCGGATAGTTCAGGGTCAAGTGCACAGTCTA
s2_R_1163_AGGTCATCGA	CAAGCAGAAGACGGCATACGAGATAGGTCATCGAAGGGTCAAGTGCACAGTCTA
s2_R_1164_CCAAGGCTCT	CAAGCAGAAGACGGCATACGAGATCCAAGGCTCTAGGGTCAAGTGCACAGTCTA
s2_R_1165_CACTAGGTGG	CAAGCAGAAGACGGCATACGAGATCACTAGGTGGAGGGTCAAGTGCACAGTCTA
s2_R_1166_GTCAACCAAG	CAAGCAGAAGACGGCATACGAGATGTCAACCAAGAGGGTCAAGTGCACAGTCTA
s2_R_1167_GTCCAACGTG	CAAGCAGAAGACGGCATACGAGATGTCCAACGTGAGGGTCAAGTGCACAGTCTA
s2_R_1168_ACCTACCTGA	CAAGCAGAAGACGGCATACGAGATACCTACCTGAAGGGTCAAGTGCACAGTCTA
s2_R_1169_TGGTTACTGG	CAAGCAGAAGACGGCATACGAGATTGGTTACTGGAGGGTCAAGTGCACAGTCTA
s2_R_1170_CTAGTTAACC	CAAGCAGAAGACGGCATACGAGATCTAGTTAACCAGGGTCAAGTGCACAGTCTA
s2_R_1171_AGTGCATATC	CAAGCAGAAGACGGCATACGAGATAGTGCATATCAGGGTCAAGTGCACAGTCTA
s2_R_1172_CGTACGTAAC	CAAGCAGAAGACGGCATACGAGATCGTACGTAACAGGGTCAAGTGCACAGTCTA
s2_R_1173_GTCAGCTAAT	CAAGCAGAAGACGGCATACGAGATGTCAGCTAATAGGGTCAAGTGCACAGTCTA
s2_R_1174_TACGTCTGAT	CAAGCAGAAGACGGCATACGAGATTACGTCTGATAGGGTCAAGTGCACAGTCTA
s2_R_1175_GCATAACATG	CAAGCAGAAGACGGCATACGAGATGCATAACATGAGGGTCAAGTGCACAGTCTA
s2_R_1176_CAACCAACGT	CAAGCAGAAGACGGCATACGAGATCAACCAACGTAGGGTCAAGTGCACAGTCTA
s2_R_1177_GTCATACTGA	CAAGCAGAAGACGGCATACGAGATGTCATACTGAAGGGTCAAGTGCACAGTCTA
s2_R_1178_GTTAAGTAGC	CAAGCAGAAGACGGCATACGAGATGTTAAGTAGCAGGGTCAAGTGCACAGTCTA
s2_R_1179_CTTCAGCTAC	CAAGCAGAAGACGGCATACGAGATCTTCAGCTACAGGGTCAAGTGCACAGTCTA
s2_R_1180_TTAGAAGTCC	CAAGCAGAAGACGGCATACGAGATTTAGAAGTCCAGGGTCAAGTGCACAGTCTA
s2_R_1181_GCTTGCAATC	CAAGCAGAAGACGGCATACGAGATGCTTGCAATCAGGGTCAAGTGCACAGTCTA
s2_R_1182_AACTGAACTG	CAAGCAGAAGACGGCATACGAGATAACTGAACTGAGGGTCAAGTGCACAGTCTA
s2_R_1183_GTGAGGTCGA	CAAGCAGAAGACGGCATACGAGATGTGAGGTCGAAGGGTCAAGTGCACAGTCTA
s2_R_1184_GTTACACCAA	CAAGCAGAAGACGGCATACGAGATGTTACACCAAAGGGTCAAGTGCACAGTCTA
s2_R_1185_CGAGAATAGT	CAAGCAGAAGACGGCATACGAGATCGAGAATAGTAGGGTCAAGTGCACAGTCTA
s2_R_1186_ACTCAAGCTT	CAAGCAGAAGACGGCATACGAGATACTCAAGCTTAGGGTCAAGTGCACAGTCTA
s2_R_1187_CAACGACATA	CAAGCAGAAGACGGCATACGAGATCAACGACATAAGGGTCAAGTGCACAGTCTA
s2_R_1188_GTGAACGTCG	CAAGCAGAAGACGGCATACGAGATGTGAACGTCGAGGGTCAAGTGCACAGTCTA
s2_R_1189_AGAAGCATTC	CAAGCAGAAGACGGCATACGAGATAGAAGCATTCAGGGTCAAGTGCACAGTCTA
s2_R_1190_GACATGGAAG	CAAGCAGAAGACGGCATACGAGATGACATGGAAGAGGGTCAAGTGCACAGTCTA
s2_R_1191_CTTAGCGAGT	CAAGCAGAAGACGGCATACGAGATCTTAGCGAGTAGGGTCAAGTGCACAGTCTA
s2_R_1192_CGTGATAGCT	CAAGCAGAAGACGGCATACGAGATCGTGATAGCTAGGGTCAAGTGCACAGTCTA
s2_R_1193_CGTGAGTTGG	CAAGCAGAAGACGGCATACGAGATCGTGAGTTGGAGGGTCAAGTGCACAGTCTA
s2_R_1194_TCATAACGGC	CAAGCAGAAGACGGCATACGAGATTCATAACGGCAGGGTCAAGTGCACAGTCTA
s2_R_1195_CACGGACACA	CAAGCAGAAGACGGCATACGAGATCACGGACACAAGGGTCAAGTGCACAGTCTA
s2_R_1196_GTTGGCCTAA	CAAGCAGAAGACGGCATACGAGATGTTGGCCTAAAGGGTCAAGTGCACAGTCTA
s2_R_1197_GTCCTCAAGA	CAAGCAGAAGACGGCATACGAGATGTCCTCAAGAAGGGTCAAGTGCACAGTCTA
s2_R_1198_AAGTCGCATC	CAAGCAGAAGACGGCATACGAGATAAGTCGCATCAGGGTCAAGTGCACAGTCTA
s2_R_1199_TCCAACGAAG	CAAGCAGAAGACGGCATACGAGATTCCAACGAAGAGGGTCAAGTGCACAGTCTA
s2_R_1200_TCACGAAGAC	CAAGCAGAAGACGGCATACGAGATTCACGAAGACAGGGTCAAGTGCACAGTCTA
s2_R_1201_TCCTATCAGG	CAAGCAGAAGACGGCATACGAGATTCCTATCAGGAGGGTCAAGTGCACAGTCTA
s2_R_1202_CTCTCCGAAC	CAAGCAGAAGACGGCATACGAGATCTCTCCGAACAGGGTCAAGTGCACAGTCTA
s2_R_1203_AACAAGACTG	CAAGCAGAAGACGGCATACGAGATAACAAGACTGAGGGTCAAGTGCACAGTCTA
s2_R_1204_CGAGAATTCC	CAAGCAGAAGACGGCATACGAGATCGAGAATTCCAGGGTCAAGTGCACAGTCTA
s2_R_1205_GTACTATGCT	CAAGCAGAAGACGGCATACGAGATGTACTATGCTAGGGTCAAGTGCACAGTCTA
s2_R_1206_AAGCGCCTGA	CAAGCAGAAGACGGCATACGAGATAAGCGCCTGAAGGGTCAAGTGCACAGTCTA
s2_R_1207_CTGGTGTTAG	CAAGCAGAAGACGGCATACGAGATCTGGTGTTAGAGGGTCAAGTGCACAGTCTA
s2_R_1208_CTGGTGAAGG	CAAGCAGAAGACGGCATACGAGATCTGGTGAAGGAGGGTCAAGTGCACAGTCTA
s2_R_1209_TCCACAGTGG	CAAGCAGAAGACGGCATACGAGATTCCACAGTGGAGGGTCAAGTGCACAGTCTA
s2_R_1210_GTACTAGTTG	CAAGCAGAAGACGGCATACGAGATGTACTAGTTGAGGGTCAAGTGCACAGTCTA
s2_R_1211_GTTCCACATT	CAAGCAGAAGACGGCATACGAGATGTTCCACATTAGGGTCAAGTGCACAGTCTA
s2_R_1212_TCCAACAGCG	CAAGCAGAAGACGGCATACGAGATTCCAACAGCGAGGGTCAAGTGCACAGTCTA
s2_R_1213_GACAAGATAG	CAAGCAGAAGACGGCATACGAGATGACAAGATAGAGGGTCAAGTGCACAGTCTA
s2_R_1214_TGGCCTACAT	CAAGCAGAAGACGGCATACGAGATTGGCCTACATAGGGTCAAGTGCACAGTCTA
s2_R_1215_GTAACTTCAC	CAAGCAGAAGACGGCATACGAGATGTAACTTCACAGGGTCAAGTGCACAGTCTA
s2_R_1216_ACATCCGAAG	CAAGCAGAAGACGGCATACGAGATACATCCGAAGAGGGTCAAGTGCACAGTCTA
s2_R_1217_CCTAACCACC	CAAGCAGAAGACGGCATACGAGATCCTAACCACCAGGGTCAAGTGCACAGTCTA
s2_R_1218_ACCTTACACC	CAAGCAGAAGACGGCATACGAGATACCTTACACCAGGGTCAAGTGCACAGTCTA
s2_R_1219_ACATGCGTCC	CAAGCAGAAGACGGCATACGAGATACATGCGTCCAGGGTCAAGTGCACAGTCTA
s2_R_1220_GCTAACAAGT	CAAGCAGAAGACGGCATACGAGATGCTAACAAGTAGGGTCAAGTGCACAGTCTA
s2_R_1221_GAAGGCAAGG	CAAGCAGAAGACGGCATACGAGATGAAGGCAAGGAGGGTCAAGTGCACAGTCTA
s2_R_1222_TATCCAGTTG	CAAGCAGAAGACGGCATACGAGATTATCCAGTTGAGGGTCAAGTGCACAGTCTA
s2_R_1223_TAACCAGACA	CAAGCAGAAGACGGCATACGAGATTAACCAGACAAGGGTCAAGTGCACAGTCTA
s2_R_1224_GTGACCAGAG	CAAGCAGAAGACGGCATACGAGATGTGACCAGAGAGGGTCAAGTGCACAGTCTA
s2_R_1225_AACGTAGCGA	CAAGCAGAAGACGGCATACGAGATAACGTAGCGAAGGGTCAAGTGCACAGTCTA
s2_R_1226_AAGACAAGAG	CAAGCAGAAGACGGCATACGAGATAAGACAAGAGAGGGTCAAGTGCACAGTCTA
s2_R_1227_AGTTGCTCTT	CAAGCAGAAGACGGCATACGAGATAGTTGCTCTTAGGGTCAAGTGCACAGTCTA
s2_R_1228_GCAAGCAAGC	CAAGCAGAAGACGGCATACGAGATGCAAGCAAGCAGGGTCAAGTGCACAGTCTA
s2_R_1229_TTGCGCCAGA	CAAGCAGAAGACGGCATACGAGATTTGCGCCAGAAGGGTCAAGTGCACAGTCTA
s2_R_1230_GCGTGCCTTA	CAAGCAGAAGACGGCATACGAGATGCGTGCCTTAAGGGTCAAGTGCACAGTCTA
s2_R_1231_ATACAAGCAC	CAAGCAGAAGACGGCATACGAGATATACAAGCACAGGGTCAAGTGCACAGTCTA
s2_R_1232_AGCACGTATA	CAAGCAGAAGACGGCATACGAGATAGCACGTATAAGGGTCAAGTGCACAGTCTA
s2_R_1233_TTCGTAGCCT	CAAGCAGAAGACGGCATACGAGATTTCGTAGCCTAGGGTCAAGTGCACAGTCTA
s2_R_1234_TCACATCCTG	CAAGCAGAAGACGGCATACGAGATTCACATCCTGAGGGTCAAGTGCACAGTCTA
s2_R_1235_TAGCGTGACT	CAAGCAGAAGACGGCATACGAGATTAGCGTGACTAGGGTCAAGTGCACAGTCTA
s2_R_1236_TAATGACAGG	CAAGCAGAAGACGGCATACGAGATTAATGACAGGAGGGTCAAGTGCACAGTCTA
s2_R_1237_TTAATCCGGT	CAAGCAGAAGACGGCATACGAGATTTAATCCGGTAGGGTCAAGTGCACAGTCTA
s2_R_1238_ACGACCGATA	CAAGCAGAAGACGGCATACGAGATACGACCGATAAGGGTCAAGTGCACAGTCTA
s2_R_1239_TTGGTTGCGG	CAAGCAGAAGACGGCATACGAGATTTGGTTGCGGAGGGTCAAGTGCACAGTCTA
s2_R_1240_GACAAGCACA	CAAGCAGAAGACGGCATACGAGATGACAAGCACAAGGGTCAAGTGCACAGTCTA
s2_R_1241_ATCAACAGAG	CAAGCAGAAGACGGCATACGAGATATCAACAGAGAGGGTCAAGTGCACAGTCTA
s2_R_1242_ATGCACATGG	CAAGCAGAAGACGGCATACGAGATATGCACATGGAGGGTCAAGTGCACAGTCTA
s2_R_1243_TTGAAGTGGC	CAAGCAGAAGACGGCATACGAGATTTGAAGTGGCAGGGTCAAGTGCACAGTCTA
s2_R_1244_CGTACACTAA	CAAGCAGAAGACGGCATACGAGATCGTACACTAAAGGGTCAAGTGCACAGTCTA
s2_R_1245_GTCTAAGGTC	CAAGCAGAAGACGGCATACGAGATGTCTAAGGTCAGGGTCAAGTGCACAGTCTA
s2_R_1246_TACGATCACC	CAAGCAGAAGACGGCATACGAGATTACGATCACCAGGGTCAAGTGCACAGTCTA
s2_R_1247_GATCATAAGG	CAAGCAGAAGACGGCATACGAGATGATCATAAGGAGGGTCAAGTGCACAGTCTA
s2_R_1248_GCAATAGCTT	CAAGCAGAAGACGGCATACGAGATGCAATAGCTTAGGGTCAAGTGCACAGTCTA
s2_R_1249_GAAGCAGAGT	CAAGCAGAAGACGGCATACGAGATGAAGCAGAGTAGGGTCAAGTGCACAGTCTA
s2_R_1250_GCTAATCAGG	CAAGCAGAAGACGGCATACGAGATGCTAATCAGGAGGGTCAAGTGCACAGTCTA
s2_R_1251_TCCATGCCAG	CAAGCAGAAGACGGCATACGAGATTCCATGCCAGAGGGTCAAGTGCACAGTCTA
s2_R_1252_CTCCTGTCTT	CAAGCAGAAGACGGCATACGAGATCTCCTGTCTTAGGGTCAAGTGCACAGTCTA
s2_R_1253_CTTCTCTTGC	CAAGCAGAAGACGGCATACGAGATCTTCTCTTGCAGGGTCAAGTGCACAGTCTA
s2_R_1254_CGTGCAGTAT	CAAGCAGAAGACGGCATACGAGATCGTGCAGTATAGGGTCAAGTGCACAGTCTA
s2_R_1255_GAAGAGCAAC	CAAGCAGAAGACGGCATACGAGATGAAGAGCAACAGGGTCAAGTGCACAGTCTA
s2_R_1256_CAGTAATCCG	CAAGCAGAAGACGGCATACGAGATCAGTAATCCGAGGGTCAAGTGCACAGTCTA
s2_R_1257_TCGCCAACGT	CAAGCAGAAGACGGCATACGAGATTCGCCAACGTAGGGTCAAGTGCACAGTCTA
s2_R_1258_GTAGCCAGAA	CAAGCAGAAGACGGCATACGAGATGTAGCCAGAAAGGGTCAAGTGCACAGTCTA
s2_R_1259_CACGCTCATA	CAAGCAGAAGACGGCATACGAGATCACGCTCATAAGGGTCAAGTGCACAGTCTA
s2_R_1260_AGTCTATCCT	CAAGCAGAAGACGGCATACGAGATAGTCTATCCTAGGGTCAAGTGCACAGTCTA
s2_R_1261_CTCCAAGCAA	CAAGCAGAAGACGGCATACGAGATCTCCAAGCAAAGGGTCAAGTGCACAGTCTA
s2_R_1262_AAGGCGACTG	CAAGCAGAAGACGGCATACGAGATAAGGCGACTGAGGGTCAAGTGCACAGTCTA
s2_R_1263_GCTACTAACT	CAAGCAGAAGACGGCATACGAGATGCTACTAACTAGGGTCAAGTGCACAGTCTA
s2_R_1264_ATTGCAGAAG	CAAGCAGAAGACGGCATACGAGATATTGCAGAAGAGGGTCAAGTGCACAGTCTA
s2_R_1265_ACTATCCAGG	CAAGCAGAAGACGGCATACGAGATACTATCCAGGAGGGTCAAGTGCACAGTCTA
s2_R_1266_TAGCTTCACC	CAAGCAGAAGACGGCATACGAGATTAGCTTCACCAGGGTCAAGTGCACAGTCTA
s2_R_1267_GTGGAGCTAA	CAAGCAGAAGACGGCATACGAGATGTGGAGCTAAAGGGTCAAGTGCACAGTCTA
s2_R_1268_GCAGAGCCAT	CAAGCAGAAGACGGCATACGAGATGCAGAGCCATAGGGTCAAGTGCACAGTCTA
s2_R_1269_ACTGGCATGC	CAAGCAGAAGACGGCATACGAGATACTGGCATGCAGGGTCAAGTGCACAGTCTA
s2_R_1270_CTGTCCATCT	CAAGCAGAAGACGGCATACGAGATCTGTCCATCTAGGGTCAAGTGCACAGTCTA
s2_R_1271_CGATACGCAC	CAAGCAGAAGACGGCATACGAGATCGATACGCACAGGGTCAAGTGCACAGTCTA
s2_R_1272_ATGATAGCAG	CAAGCAGAAGACGGCATACGAGATATGATAGCAGAGGGTCAAGTGCACAGTCTA
s2_R_1273_CATTAGAACC	CAAGCAGAAGACGGCATACGAGATCATTAGAACCAGGGTCAAGTGCACAGTCTA
s2_R_1274_ATGCAAGGTT	CAAGCAGAAGACGGCATACGAGATATGCAAGGTTAGGGTCAAGTGCACAGTCTA
s2_R_1275_GATTCATTCC	CAAGCAGAAGACGGCATACGAGATGATTCATTCCAGGGTCAAGTGCACAGTCTA
s2_R_1276_TCGTTGACAC	CAAGCAGAAGACGGCATACGAGATTCGTTGACACAGGGTCAAGTGCACAGTCTA
s2_R_1277_GTTGAGCAAT	CAAGCAGAAGACGGCATACGAGATGTTGAGCAATAGGGTCAAGTGCACAGTCTA
s2_R_1278_GATGCTTCTC	CAAGCAGAAGACGGCATACGAGATGATGCTTCTCAGGGTCAAGTGCACAGTCTA
s2_R_1279_ACACTCTTGC	CAAGCAGAAGACGGCATACGAGATACACTCTTGCAGGGTCAAGTGCACAGTCTA
s2_R_1280_GAGGAATTGC	CAAGCAGAAGACGGCATACGAGATGAGGAATTGCAGGGTCAAGTGCACAGTCTA
s2_R_1281_AGCAACGAAC	CAAGCAGAAGACGGCATACGAGATAGCAACGAACAGGGTCAAGTGCACAGTCTA
s2_R_1282_AGCTTCTACA	CAAGCAGAAGACGGCATACGAGATAGCTTCTACAAGGGTCAAGTGCACAGTCTA
s2_R_1283_ACCTACTGGC	CAAGCAGAAGACGGCATACGAGATACCTACTGGCAGGGTCAAGTGCACAGTCTA
s2_R_1284_CCTAGCAATA	CAAGCAGAAGACGGCATACGAGATCCTAGCAATAAGGGTCAAGTGCACAGTCTA
s2_R_1285_TAAGTTCCAC	CAAGCAGAAGACGGCATACGAGATTAAGTTCCACAGGGTCAAGTGCACAGTCTA
s2_R_1286_GTCTTCACTA	CAAGCAGAAGACGGCATACGAGATGTCTTCACTAAGGGTCAAGTGCACAGTCTA
s2_R_1287_ACCTCTCGGA	CAAGCAGAAGACGGCATACGAGATACCTCTCGGAAGGGTCAAGTGCACAGTCTA
s2_R_1288_GCATACAGCG	CAAGCAGAAGACGGCATACGAGATGCATACAGCGAGGGTCAAGTGCACAGTCTA
s2_R_1289_TGTTGGCGTA	CAAGCAGAAGACGGCATACGAGATTGTTGGCGTAAGGGTCAAGTGCACAGTCTA
s2_R_1290_GCAAGAGTCG	CAAGCAGAAGACGGCATACGAGATGCAAGAGTCGAGGGTCAAGTGCACAGTCTA
s2_R_1291_CATGAAGTAC	CAAGCAGAAGACGGCATACGAGATCATGAAGTACAGGGTCAAGTGCACAGTCTA
s2_R_1292_TCTCAGGCTC	CAAGCAGAAGACGGCATACGAGATTCTCAGGCTCAGGGTCAAGTGCACAGTCTA
s2_R_1293_GGAGGAACAT	CAAGCAGAAGACGGCATACGAGATGGAGGAACATAGGGTCAAGTGCACAGTCTA
s2_R_1294_CCTTACGAAC	CAAGCAGAAGACGGCATACGAGATCCTTACGAACAGGGTCAAGTGCACAGTCTA
s2_R_1295_CGTATAAGCC	CAAGCAGAAGACGGCATACGAGATCGTATAAGCCAGGGTCAAGTGCACAGTCTA
s2_R_1296_TGTTAACGCT	CAAGCAGAAGACGGCATACGAGATTGTTAACGCTAGGGTCAAGTGCACAGTCTA
s2_R_1297_ACGATTGCAT	CAAGCAGAAGACGGCATACGAGATACGATTGCATAGGGTCAAGTGCACAGTCTA
s2_R_1298_AGGTGCAAGT	CAAGCAGAAGACGGCATACGAGATAGGTGCAAGTAGGGTCAAGTGCACAGTCTA
s2_R_1299_ATAATCCACC	CAAGCAGAAGACGGCATACGAGATATAATCCACCAGGGTCAAGTGCACAGTCTA
s2_R_1300_GTTACACGGC	CAAGCAGAAGACGGCATACGAGATGTTACACGGCAGGGTCAAGTGCACAGTCTA
s2_R_1301_CATTACTGAC	CAAGCAGAAGACGGCATACGAGATCATTACTGACAGGGTCAAGTGCACAGTCTA
s2_R_1302_CGACAAGTCG	CAAGCAGAAGACGGCATACGAGATCGACAAGTCGAGGGTCAAGTGCACAGTCTA
s2_R_1303_CTTGTCCATA	CAAGCAGAAGACGGCATACGAGATCTTGTCCATAAGGGTCAAGTGCACAGTCTA
s2_R_1304_GCAACACAGG	CAAGCAGAAGACGGCATACGAGATGCAACACAGGAGGGTCAAGTGCACAGTCTA
s2_R_1305_GACTAAGCTG	CAAGCAGAAGACGGCATACGAGATGACTAAGCTGAGGGTCAAGTGCACAGTCTA
s2_R_1306_TGGTGCTATA	CAAGCAGAAGACGGCATACGAGATTGGTGCTATAAGGGTCAAGTGCACAGTCTA
s2_R_1307_AGCAGAACAC	CAAGCAGAAGACGGCATACGAGATAGCAGAACACAGGGTCAAGTGCACAGTCTA
s2_R_1308_CATGTGCCTA	CAAGCAGAAGACGGCATACGAGATCATGTGCCTAAGGGTCAAGTGCACAGTCTA
s2_R_1309_GGTAACAGCG	CAAGCAGAAGACGGCATACGAGATGGTAACAGCGAGGGTCAAGTGCACAGTCTA
s2_R_1310_AACCTCATCC	CAAGCAGAAGACGGCATACGAGATAACCTCATCCAGGGTCAAGTGCACAGTCTA
s2_R_1311_TCGTGCTGTT	CAAGCAGAAGACGGCATACGAGATTCGTGCTGTTAGGGTCAAGTGCACAGTCTA
s2_R_1312_TACGCTGAAG	CAAGCAGAAGACGGCATACGAGATTACGCTGAAGAGGGTCAAGTGCACAGTCTA
s2_R_1313_AAGACTCCAG	CAAGCAGAAGACGGCATACGAGATAAGACTCCAGAGGGTCAAGTGCACAGTCTA
s2_R_1314_TCCTGCTCAA	CAAGCAGAAGACGGCATACGAGATTCCTGCTCAAAGGGTCAAGTGCACAGTCTA
s2_R_1315_AGAAGGTGAT	CAAGCAGAAGACGGCATACGAGATAGAAGGTGATAGGGTCAAGTGCACAGTCTA
s2_R_1316_AAGTAAGGCT	CAAGCAGAAGACGGCATACGAGATAAGTAAGGCTAGGGTCAAGTGCACAGTCTA
s2_R_1317_GACGGTGAGT	CAAGCAGAAGACGGCATACGAGATGACGGTGAGTAGGGTCAAGTGCACAGTCTA
s2_R_1318_GTAGCTTGAG	CAAGCAGAAGACGGCATACGAGATGTAGCTTGAGAGGGTCAAGTGCACAGTCTA
s2_R_1319_GACCTTGCAC	CAAGCAGAAGACGGCATACGAGATGACCTTGCACAGGGTCAAGTGCACAGTCTA
s2_R_1320_TAGGATGGAA	CAAGCAGAAGACGGCATACGAGATTAGGATGGAAAGGGTCAAGTGCACAGTCTA
s2_R_1321_CCTCGACTCT	CAAGCAGAAGACGGCATACGAGATCCTCGACTCTAGGGTCAAGTGCACAGTCTA
s2_R_1322_TACAGCATGC	CAAGCAGAAGACGGCATACGAGATTACAGCATGCAGGGTCAAGTGCACAGTCTA
s2_R_1323_CAATAGCTCC	CAAGCAGAAGACGGCATACGAGATCAATAGCTCCAGGGTCAAGTGCACAGTCTA
s2_R_1324_TCATGGCTCA	CAAGCAGAAGACGGCATACGAGATTCATGGCTCAAGGGTCAAGTGCACAGTCTA
s2_R_1325_AGCCAGAATC	CAAGCAGAAGACGGCATACGAGATAGCCAGAATCAGGGTCAAGTGCACAGTCTA
s2_R_1326_AACCGAGCAC	CAAGCAGAAGACGGCATACGAGATAACCGAGCACAGGGTCAAGTGCACAGTCTA
s2_R_1327_ACCAGAGATA	CAAGCAGAAGACGGCATACGAGATACCAGAGATAAGGGTCAAGTGCACAGTCTA
s2_R_1328_CTGACGCATA	CAAGCAGAAGACGGCATACGAGATCTGACGCATAAGGGTCAAGTGCACAGTCTA
s2_R_1329_TACTGTCAAC	CAAGCAGAAGACGGCATACGAGATTACTGTCAACAGGGTCAAGTGCACAGTCTA
s2_R_1330_TACATGCCTT	CAAGCAGAAGACGGCATACGAGATTACATGCCTTAGGGTCAAGTGCACAGTCTA
s2_R_1331_TGTCACATAG	CAAGCAGAAGACGGCATACGAGATTGTCACATAGAGGGTCAAGTGCACAGTCTA
s2_R_1332_GCAGAACTCC	CAAGCAGAAGACGGCATACGAGATGCAGAACTCCAGGGTCAAGTGCACAGTCTA
s2_R_1333_GATGTCGTTG	CAAGCAGAAGACGGCATACGAGATGATGTCGTTGAGGGTCAAGTGCACAGTCTA
s2_R_1334_TGCATCCTGA	CAAGCAGAAGACGGCATACGAGATTGCATCCTGAAGGGTCAAGTGCACAGTCTA
s2_R_1335_TGATTGGCAT	CAAGCAGAAGACGGCATACGAGATTGATTGGCATAGGGTCAAGTGCACAGTCTA
s2_R_1336_AGTGCAACTT	CAAGCAGAAGACGGCATACGAGATAGTGCAACTTAGGGTCAAGTGCACAGTCTA
s2_R_1337_AAGGTCGAAG	CAAGCAGAAGACGGCATACGAGATAAGGTCGAAGAGGGTCAAGTGCACAGTCTA
s2_R_1338_ATTACAGCGT	CAAGCAGAAGACGGCATACGAGATATTACAGCGTAGGGTCAAGTGCACAGTCTA
s2_R_1339_GAGTTAAGCT	CAAGCAGAAGACGGCATACGAGATGAGTTAAGCTAGGGTCAAGTGCACAGTCTA
s2_R_1340_GACTAGGCAC	CAAGCAGAAGACGGCATACGAGATGACTAGGCACAGGGTCAAGTGCACAGTCTA
s2_R_1341_ATGCACACTA	CAAGCAGAAGACGGCATACGAGATATGCACACTAAGGGTCAAGTGCACAGTCTA
s2_R_1342_CTCTCCAATA	CAAGCAGAAGACGGCATACGAGATCTCTCCAATAAGGGTCAAGTGCACAGTCTA
s2_R_1343_TTGCCTGTCT	CAAGCAGAAGACGGCATACGAGATTTGCCTGTCTAGGGTCAAGTGCACAGTCTA
s2_R_1344_GCGGAGATCT	CAAGCAGAAGACGGCATACGAGATGCGGAGATCTAGGGTCAAGTGCACAGTCTA
s2_R_1345_AATGCACGTA	CAAGCAGAAGACGGCATACGAGATAATGCACGTAAGGGTCAAGTGCACAGTCTA
s2_R_1346_AAGATGTCCT	CAAGCAGAAGACGGCATACGAGATAAGATGTCCTAGGGTCAAGTGCACAGTCTA
s2_R_1347_CAGAGTTAGT	CAAGCAGAAGACGGCATACGAGATCAGAGTTAGTAGGGTCAAGTGCACAGTCTA
s2_R_1348_CTAGCTGACG	CAAGCAGAAGACGGCATACGAGATCTAGCTGACGAGGGTCAAGTGCACAGTCTA
s2_R_1349_ACACCTTCTT	CAAGCAGAAGACGGCATACGAGATACACCTTCTTAGGGTCAAGTGCACAGTCTA
s2_R_1350_AAGCGAACCA	CAAGCAGAAGACGGCATACGAGATAAGCGAACCAAGGGTCAAGTGCACAGTCTA
s2_R_1351_GAATGCAACT	CAAGCAGAAGACGGCATACGAGATGAATGCAACTAGGGTCAAGTGCACAGTCTA
s2_R_1352_ACGAGCTACA	CAAGCAGAAGACGGCATACGAGATACGAGCTACAAGGGTCAAGTGCACAGTCTA
s2_R_1353_GAGGCATGTT	CAAGCAGAAGACGGCATACGAGATGAGGCATGTTAGGGTCAAGTGCACAGTCTA
s2_R_1354_TTATCGGCTC	CAAGCAGAAGACGGCATACGAGATTTATCGGCTCAGGGTCAAGTGCACAGTCTA
s2_R_1355_TTCGAACACT	CAAGCAGAAGACGGCATACGAGATTTCGAACACTAGGGTCAAGTGCACAGTCTA
s2_R_1356_AAGAGGCTGC	CAAGCAGAAGACGGCATACGAGATAAGAGGCTGCAGGGTCAAGTGCACAGTCTA
s2_R_1357_AGTTCGATAC	CAAGCAGAAGACGGCATACGAGATAGTTCGATACAGGGTCAAGTGCACAGTCTA
s2_R_1358_TCCTTAGCAA	CAAGCAGAAGACGGCATACGAGATTCCTTAGCAAAGGGTCAAGTGCACAGTCTA
s2_R_1359_GAACAAGCAT	CAAGCAGAAGACGGCATACGAGATGAACAAGCATAGGGTCAAGTGCACAGTCTA
s2_R_1360_GACTTAGCAT	CAAGCAGAAGACGGCATACGAGATGACTTAGCATAGGGTCAAGTGCACAGTCTA
s2_R_1361_GACTGATAGA	CAAGCAGAAGACGGCATACGAGATGACTGATAGAAGGGTCAAGTGCACAGTCTA
s2_R_1362_CCACTGAAGC	CAAGCAGAAGACGGCATACGAGATCCACTGAAGCAGGGTCAAGTGCACAGTCTA
s2_R_1363_CACGAGTCTC	CAAGCAGAAGACGGCATACGAGATCACGAGTCTCAGGGTCAAGTGCACAGTCTA
s2_R_1364_AAGAGTGCCA	CAAGCAGAAGACGGCATACGAGATAAGAGTGCCAAGGGTCAAGTGCACAGTCTA
s2_R_1365_TTATAGAGGC	CAAGCAGAAGACGGCATACGAGATTTATAGAGGCAGGGTCAAGTGCACAGTCTA
s2_R_1366_CTCCACTAAG	CAAGCAGAAGACGGCATACGAGATCTCCACTAAGAGGGTCAAGTGCACAGTCTA
s2_R_1367_CCGAAGTTCT	CAAGCAGAAGACGGCATACGAGATCCGAAGTTCTAGGGTCAAGTGCACAGTCTA
s2_R_1368_CGAAGATTGC	CAAGCAGAAGACGGCATACGAGATCGAAGATTGCAGGGTCAAGTGCACAGTCTA
s2_R_1369_GACTCCAAGG	CAAGCAGAAGACGGCATACGAGATGACTCCAAGGAGGGTCAAGTGCACAGTCTA
s2_R_1370_ATGGAGTGAA	CAAGCAGAAGACGGCATACGAGATATGGAGTGAAAGGGTCAAGTGCACAGTCTA
s2_R_1371_AGTGCAAGGC	CAAGCAGAAGACGGCATACGAGATAGTGCAAGGCAGGGTCAAGTGCACAGTCTA
s2_R_1372_GAGAAGGCAA	CAAGCAGAAGACGGCATACGAGATGAGAAGGCAAAGGGTCAAGTGCACAGTCTA
s2_R_1373_ATGGATAACC	CAAGCAGAAGACGGCATACGAGATATGGATAACCAGGGTCAAGTGCACAGTCTA
s2_R_1374_TGTCGTCGAC	CAAGCAGAAGACGGCATACGAGATTGTCGTCGACAGGGTCAAGTGCACAGTCTA
s2_R_1375_TACAGCGCAC	CAAGCAGAAGACGGCATACGAGATTACAGCGCACAGGGTCAAGTGCACAGTCTA
s2_R_1376_ACGGTTCCTC	CAAGCAGAAGACGGCATACGAGATACGGTTCCTCAGGGTCAAGTGCACAGTCTA
s2_R_1377_GTTGACGTGC	CAAGCAGAAGACGGCATACGAGATGTTGACGTGCAGGGTCAAGTGCACAGTCTA
s2_R_1378_ATAAGCAGCT	CAAGCAGAAGACGGCATACGAGATATAAGCAGCTAGGGTCAAGTGCACAGTCTA
s2_R_1379_ACAAGGCCTC	CAAGCAGAAGACGGCATACGAGATACAAGGCCTCAGGGTCAAGTGCACAGTCTA
s2_R_1380_ACATAGGACA	CAAGCAGAAGACGGCATACGAGATACATAGGACAAGGGTCAAGTGCACAGTCTA
s2_R_1381_TAGCCAGTAT	CAAGCAGAAGACGGCATACGAGATTAGCCAGTATAGGGTCAAGTGCACAGTCTA
s2_R_1382_TTAGCCTCCT	CAAGCAGAAGACGGCATACGAGATTTAGCCTCCTAGGGTCAAGTGCACAGTCTA
s2_R_1383_ACAATACGTG	CAAGCAGAAGACGGCATACGAGATACAATACGTGAGGGTCAAGTGCACAGTCTA
s2_R_1384_TCCAAGGTAC	CAAGCAGAAGACGGCATACGAGATTCCAAGGTACAGGGTCAAGTGCACAGTCTA
s2_R_1385_GTCTCTGCGA	CAAGCAGAAGACGGCATACGAGATGTCTCTGCGAAGGGTCAAGTGCACAGTCTA
s2_R_1386_GAAGGCATAA	CAAGCAGAAGACGGCATACGAGATGAAGGCATAAAGGGTCAAGTGCACAGTCTA
s2_R_1387_ATCGGTGCTT	CAAGCAGAAGACGGCATACGAGATATCGGTGCTTAGGGTCAAGTGCACAGTCTA
s2_R_1388_TCAGTACCTG	CAAGCAGAAGACGGCATACGAGATTCAGTACCTGAGGGTCAAGTGCACAGTCTA
s2_R_1389_ATTCGCAACC	CAAGCAGAAGACGGCATACGAGATATTCGCAACCAGGGTCAAGTGCACAGTCTA
s2_R_1390_ATCGAAGCTA	CAAGCAGAAGACGGCATACGAGATATCGAAGCTAAGGGTCAAGTGCACAGTCTA
s2_R_1391_GTAAGATGCC	CAAGCAGAAGACGGCATACGAGATGTAAGATGCCAGGGTCAAGTGCACAGTCTA
s2_R_1392_ATCGTATAGC	CAAGCAGAAGACGGCATACGAGATATCGTATAGCAGGGTCAAGTGCACAGTCTA
s2_R_1393_CTATGCACAC	CAAGCAGAAGACGGCATACGAGATCTATGCACACAGGGTCAAGTGCACAGTCTA
s2_R_1394_ACAGTACGAA	CAAGCAGAAGACGGCATACGAGATACAGTACGAAAGGGTCAAGTGCACAGTCTA
s2_R_1395_CAATTAGCAC	CAAGCAGAAGACGGCATACGAGATCAATTAGCACAGGGTCAAGTGCACAGTCTA
s2_R_1396_GTAGCAATCC	CAAGCAGAAGACGGCATACGAGATGTAGCAATCCAGGGTCAAGTGCACAGTCTA
s2_R_1397_TTGCGGAAGT	CAAGCAGAAGACGGCATACGAGATTTGCGGAAGTAGGGTCAAGTGCACAGTCTA
s2_R_1398_TTATGCAAGG	CAAGCAGAAGACGGCATACGAGATTTATGCAAGGAGGGTCAAGTGCACAGTCTA
s2_R_1399_AGAGCGTACT	CAAGCAGAAGACGGCATACGAGATAGAGCGTACTAGGGTCAAGTGCACAGTCTA
s2_R_1400_GCAATGTTCC	CAAGCAGAAGACGGCATACGAGATGCAATGTTCCAGGGTCAAGTGCACAGTCTA
s2_R_1401_ATCGACGGAC	CAAGCAGAAGACGGCATACGAGATATCGACGGACAGGGTCAAGTGCACAGTCTA
s2_R_1402_GCAATGGCAC	CAAGCAGAAGACGGCATACGAGATGCAATGGCACAGGGTCAAGTGCACAGTCTA
s2_R_1403_GCAATGTATG	CAAGCAGAAGACGGCATACGAGATGCAATGTATGAGGGTCAAGTGCACAGTCTA
s2_R_1404_GCATACGCAA	CAAGCAGAAGACGGCATACGAGATGCATACGCAAAGGGTCAAGTGCACAGTCTA
s2_R_1405_GCACCTATCT	CAAGCAGAAGACGGCATACGAGATGCACCTATCTAGGGTCAAGTGCACAGTCTA
s2_R_1406_GCAGGAGGAT	CAAGCAGAAGACGGCATACGAGATGCAGGAGGATAGGGTCAAGTGCACAGTCTA
s2_R_1407_TCTGACAGGA	CAAGCAGAAGACGGCATACGAGATTCTGACAGGAAGGGTCAAGTGCACAGTCTA
s2_R_1408_TTGTGACTCA	CAAGCAGAAGACGGCATACGAGATTTGTGACTCAAGGGTCAAGTGCACAGTCTA
s2_R_1409_AGTTCACGTT	CAAGCAGAAGACGGCATACGAGATAGTTCACGTTAGGGTCAAGTGCACAGTCTA
s2_R_1410_ACACGAGAGT	CAAGCAGAAGACGGCATACGAGATACACGAGAGTAGGGTCAAGTGCACAGTCTA
s2_R_1411_CGGTGCAGAA	CAAGCAGAAGACGGCATACGAGATCGGTGCAGAAAGGGTCAAGTGCACAGTCTA
s2_R_1412_CGAACGACAG	CAAGCAGAAGACGGCATACGAGATCGAACGACAGAGGGTCAAGTGCACAGTCTA
s2_R_1413_CGAGCGAATA	CAAGCAGAAGACGGCATACGAGATCGAGCGAATAAGGGTCAAGTGCACAGTCTA
s2_R_1414_CGCAATGCAT	CAAGCAGAAGACGGCATACGAGATCGCAATGCATAGGGTCAAGTGCACAGTCTA
s2_R_1415_AACTTGGCTT	CAAGCAGAAGACGGCATACGAGATAACTTGGCTTAGGGTCAAGTGCACAGTCTA
s2_R_1416_GCATCTTAGC	CAAGCAGAAGACGGCATACGAGATGCATCTTAGCAGGGTCAAGTGCACAGTCTA
s2_R_1417_AGCGAATCCG	CAAGCAGAAGACGGCATACGAGATAGCGAATCCGAGGGTCAAGTGCACAGTCTA
s2_R_1418_GATAATCCTG	CAAGCAGAAGACGGCATACGAGATGATAATCCTGAGGGTCAAGTGCACAGTCTA
s2_R_1419_TCAAGAGCAC	CAAGCAGAAGACGGCATACGAGATTCAAGAGCACAGGGTCAAGTGCACAGTCTA
s2_R_1420_AGGATGCATA	CAAGCAGAAGACGGCATACGAGATAGGATGCATAAGGGTCAAGTGCACAGTCTA
s2_R_1421_TGGTTCATCA	CAAGCAGAAGACGGCATACGAGATTGGTTCATCAAGGGTCAAGTGCACAGTCTA
s2_R_1422_GTCCGAATAT	CAAGCAGAAGACGGCATACGAGATGTCCGAATATAGGGTCAAGTGCACAGTCTA
s2_R_1423_GCATATGTAC	CAAGCAGAAGACGGCATACGAGATGCATATGTACAGGGTCAAGTGCACAGTCTA
s2_R_1424_CTCCGATTGA	CAAGCAGAAGACGGCATACGAGATCTCCGATTGAAGGGTCAAGTGCACAGTCTA
s2_R_1425_CCTATGGCAG	CAAGCAGAAGACGGCATACGAGATCCTATGGCAGAGGGTCAAGTGCACAGTCTA
s2_R_1426_CGATACGATT	CAAGCAGAAGACGGCATACGAGATCGATACGATTAGGGTCAAGTGCACAGTCTA
s2_R_1427_GCAACTAATC	CAAGCAGAAGACGGCATACGAGATGCAACTAATCAGGGTCAAGTGCACAGTCTA
s2_R_1428_GTTCCTGGTC	CAAGCAGAAGACGGCATACGAGATGTTCCTGGTCAGGGTCAAGTGCACAGTCTA
s2_R_1429_ACTAGGACGT	CAAGCAGAAGACGGCATACGAGATACTAGGACGTAGGGTCAAGTGCACAGTCTA
s2_R_1430_AGTGAACACC	CAAGCAGAAGACGGCATACGAGATAGTGAACACCAGGGTCAAGTGCACAGTCTA
s2_R_1431_CAACGAGAAT	CAAGCAGAAGACGGCATACGAGATCAACGAGAATAGGGTCAAGTGCACAGTCTA
s2_R_1432_CTCAACGGTC	CAAGCAGAAGACGGCATACGAGATCTCAACGGTCAGGGTCAAGTGCACAGTCTA
s2_R_1433_TAACATGAGC	CAAGCAGAAGACGGCATACGAGATTAACATGAGCAGGGTCAAGTGCACAGTCTA
s2_R_1434_TGCCATACAA	CAAGCAGAAGACGGCATACGAGATTGCCATACAAAGGGTCAAGTGCACAGTCTA
s2_R_1435_CACGAATGAT	CAAGCAGAAGACGGCATACGAGATCACGAATGATAGGGTCAAGTGCACAGTCTA
s2_R_1436_CACACAGATA	CAAGCAGAAGACGGCATACGAGATCACACAGATAAGGGTCAAGTGCACAGTCTA
s2_R_1437_CTGGCTGAAC	CAAGCAGAAGACGGCATACGAGATCTGGCTGAACAGGGTCAAGTGCACAGTCTA
s2_R_1438_ATCGTGGCAT	CAAGCAGAAGACGGCATACGAGATATCGTGGCATAGGGTCAAGTGCACAGTCTA
s2_R_1439_GCAGGACAAC	CAAGCAGAAGACGGCATACGAGATGCAGGACAACAGGGTCAAGTGCACAGTCTA
s2_R_1440_TATCCTCACT	CAAGCAGAAGACGGCATACGAGATTATCCTCACTAGGGTCAAGTGCACAGTCTA
s2_R_1441_ATAGCGAAGC	CAAGCAGAAGACGGCATACGAGATATAGCGAAGCAGGGTCAAGTGCACAGTCTA
s2_R_1442_GATGCAAGAG	CAAGCAGAAGACGGCATACGAGATGATGCAAGAGAGGGTCAAGTGCACAGTCTA
s2_R_1443_ATTAGGCTGA	CAAGCAGAAGACGGCATACGAGATATTAGGCTGAAGGGTCAAGTGCACAGTCTA
s2_R_1444_GCAAGGAATT	CAAGCAGAAGACGGCATACGAGATGCAAGGAATTAGGGTCAAGTGCACAGTCTA
s2_R_1445_GCACATCTTA	CAAGCAGAAGACGGCATACGAGATGCACATCTTAAGGGTCAAGTGCACAGTCTA
s2_R_1446_GATGGAGAGC	CAAGCAGAAGACGGCATACGAGATGATGGAGAGCAGGGTCAAGTGCACAGTCTA
s2_R_1447_ACTACTCACC	CAAGCAGAAGACGGCATACGAGATACTACTCACCAGGGTCAAGTGCACAGTCTA
s2_R_1448_CGTGCGTGAA	CAAGCAGAAGACGGCATACGAGATCGTGCGTGAAAGGGTCAAGTGCACAGTCTA
s2_R_1449_AGTAGCAGAC	CAAGCAGAAGACGGCATACGAGATAGTAGCAGACAGGGTCAAGTGCACAGTCTA
s2_R_1450_CAGTGAGCAA	CAAGCAGAAGACGGCATACGAGATCAGTGAGCAAAGGGTCAAGTGCACAGTCTA
s2_R_1451_CGACTAGCAG	CAAGCAGAAGACGGCATACGAGATCGACTAGCAGAGGGTCAAGTGCACAGTCTA
s2_R_1452_AAGGAAGCAT	CAAGCAGAAGACGGCATACGAGATAAGGAAGCATAGGGTCAAGTGCACAGTCTA
s2_R_1453_GCATTCAACC	CAAGCAGAAGACGGCATACGAGATGCATTCAACCAGGGTCAAGTGCACAGTCTA
s2_R_1454_CACTGTTAGC	CAAGCAGAAGACGGCATACGAGATCACTGTTAGCAGGGTCAAGTGCACAGTCTA
s2_R_1455_AACCATGCAA	CAAGCAGAAGACGGCATACGAGATAACCATGCAAAGGGTCAAGTGCACAGTCTA
s2_R_1456_TGCGGCTAAC	CAAGCAGAAGACGGCATACGAGATTGCGGCTAACAGGGTCAAGTGCACAGTCTA
s2_R_1457_TGTTGCAACG	CAAGCAGAAGACGGCATACGAGATTGTTGCAACGAGGGTCAAGTGCACAGTCTA
s2_R_1458_ATAGCGCATT	CAAGCAGAAGACGGCATACGAGATATAGCGCATTAGGGTCAAGTGCACAGTCTA
s2_R_1459_AACACGAGGC	CAAGCAGAAGACGGCATACGAGATAACACGAGGCAGGGTCAAGTGCACAGTCTA
s2_R_1460_CCTCACCATT	CAAGCAGAAGACGGCATACGAGATCCTCACCATTAGGGTCAAGTGCACAGTCTA
s2_R_1461_GCTGCATTGT	CAAGCAGAAGACGGCATACGAGATGCTGCATTGTAGGGTCAAGTGCACAGTCTA
s2_R_1462_AGTTCCAAGA	CAAGCAGAAGACGGCATACGAGATAGTTCCAAGAAGGGTCAAGTGCACAGTCTA
s2_R_1463_GGTCCTACTC	CAAGCAGAAGACGGCATACGAGATGGTCCTACTCAGGGTCAAGTGCACAGTCTA
s2_R_1464_CAAGTCTGAC	CAAGCAGAAGACGGCATACGAGATCAAGTCTGACAGGGTCAAGTGCACAGTCTA
s2_R_1465_CGGTACAGCT	CAAGCAGAAGACGGCATACGAGATCGGTACAGCTAGGGTCAAGTGCACAGTCTA
s2_R_1466_CGCGGAATTA	CAAGCAGAAGACGGCATACGAGATCGCGGAATTAAGGGTCAAGTGCACAGTCTA
s2_R_1467_GCAGAAGAGC	CAAGCAGAAGACGGCATACGAGATGCAGAAGAGCAGGGTCAAGTGCACAGTCTA
s2_R_1468_GCGGATGGTT	CAAGCAGAAGACGGCATACGAGATGCGGATGGTTAGGGTCAAGTGCACAGTCTA
s2_R_1469_CTCAAGACTC	CAAGCAGAAGACGGCATACGAGATCTCAAGACTCAGGGTCAAGTGCACAGTCTA
s2_R_1470_GAGATTAGGC	CAAGCAGAAGACGGCATACGAGATGAGATTAGGCAGGGTCAAGTGCACAGTCTA
s2_R_1471_GTTACCTACT	CAAGCAGAAGACGGCATACGAGATGTTACCTACTAGGGTCAAGTGCACAGTCTA
s2_R_1472_GCACATAGAA	CAAGCAGAAGACGGCATACGAGATGCACATAGAAAGGGTCAAGTGCACAGTCTA
s2_R_1473_TAAGCCTAGG	CAAGCAGAAGACGGCATACGAGATTAAGCCTAGGAGGGTCAAGTGCACAGTCTA
s2_R_1474_TAAGGAGCTC	CAAGCAGAAGACGGCATACGAGATTAAGGAGCTCAGGGTCAAGTGCACAGTCTA
s2_R_1475_ACGATACAGA	CAAGCAGAAGACGGCATACGAGATACGATACAGAAGGGTCAAGTGCACAGTCTA
s2_R_1476_GCGGCAATAC	CAAGCAGAAGACGGCATACGAGATGCGGCAATACAGGGTCAAGTGCACAGTCTA
s2_R_1477_GATGACACTT	CAAGCAGAAGACGGCATACGAGATGATGACACTTAGGGTCAAGTGCACAGTCTA
s2_R_1478_TCTAACTTGC	CAAGCAGAAGACGGCATACGAGATTCTAACTTGCAGGGTCAAGTGCACAGTCTA
s2_R_1479_TCACCATTGC	CAAGCAGAAGACGGCATACGAGATTCACCATTGCAGGGTCAAGTGCACAGTCTA
s2_R_1480_CACGAACCTA	CAAGCAGAAGACGGCATACGAGATCACGAACCTAAGGGTCAAGTGCACAGTCTA
s2_R_1481_AATCAAGAGC	CAAGCAGAAGACGGCATACGAGATAATCAAGAGCAGGGTCAAGTGCACAGTCTA
s2_R_1482_AACAGATAGC	CAAGCAGAAGACGGCATACGAGATAACAGATAGCAGGGTCAAGTGCACAGTCTA
s2_R_1483_AGTCAGCGAA	CAAGCAGAAGACGGCATACGAGATAGTCAGCGAAAGGGTCAAGTGCACAGTCTA
s2_R_1484_ATCCGTGAGT	CAAGCAGAAGACGGCATACGAGATATCCGTGAGTAGGGTCAAGTGCACAGTCTA
s2_R_1485_ATCTACGCAA	CAAGCAGAAGACGGCATACGAGATATCTACGCAAAGGGTCAAGTGCACAGTCTA
s2_R_1486_TTGGAAGAGT	CAAGCAGAAGACGGCATACGAGATTTGGAAGAGTAGGGTCAAGTGCACAGTCTA
s2_R_1487_CGCCATTAGC	CAAGCAGAAGACGGCATACGAGATCGCCATTAGCAGGGTCAAGTGCACAGTCTA
s2_R_1488_ATCTCTCCAA	CAAGCAGAAGACGGCATACGAGATATCTCTCCAAAGGGTCAAGTGCACAGTCTA
s2_R_1489_GCACACTTCC	CAAGCAGAAGACGGCATACGAGATGCACACTTCCAGGGTCAAGTGCACAGTCTA
s2_R_1490_GCAAGTTAGA	CAAGCAGAAGACGGCATACGAGATGCAAGTTAGAAGGGTCAAGTGCACAGTCTA
s2_R_1491_GCAACGATAA	CAAGCAGAAGACGGCATACGAGATGCAACGATAAAGGGTCAAGTGCACAGTCTA
s2_R_1492_GCACGAACAA	CAAGCAGAAGACGGCATACGAGATGCACGAACAAAGGGTCAAGTGCACAGTCTA
s2_R_1493_GCAACATTGA	CAAGCAGAAGACGGCATACGAGATGCAACATTGAAGGGTCAAGTGCACAGTCTA
s2_R_1494_GCAACGTCTC	CAAGCAGAAGACGGCATACGAGATGCAACGTCTCAGGGTCAAGTGCACAGTCTA
s2_R_1495_GCATGTAGAT	CAAGCAGAAGACGGCATACGAGATGCATGTAGATAGGGTCAAGTGCACAGTCTA
s2_R_1496_GCAAGTCCTA	CAAGCAGAAGACGGCATACGAGATGCAAGTCCTAAGGGTCAAGTGCACAGTCTA
s2_R_1497_GCATTGACAT	CAAGCAGAAGACGGCATACGAGATGCATTGACATAGGGTCAAGTGCACAGTCTA
s2_R_1498_AAGCCGGAAC	CAAGCAGAAGACGGCATACGAGATAAGCCGGAACAGGGTCAAGTGCACAGTCTA
s2_R_1499_TTGCCAATAC	CAAGCAGAAGACGGCATACGAGATTTGCCAATACAGGGTCAAGTGCACAGTCTA
s2_R_1500_CTCATCAAGG	CAAGCAGAAGACGGCATACGAGATCTCATCAAGGAGGGTCAAGTGCACAGTCTA
s2_R_1501_ACAGCGACTA	CAAGCAGAAGACGGCATACGAGATACAGCGACTAAGGGTCAAGTGCACAGTCTA
s2_R_1502_CCGGATTAGC	CAAGCAGAAGACGGCATACGAGATCCGGATTAGCAGGGTCAAGTGCACAGTCTA
s2_R_1503_ATTAGAGAGC	CAAGCAGAAGACGGCATACGAGATATTAGAGAGCAGGGTCAAGTGCACAGTCTA
s2_R_1504_CGATAGTCTA	CAAGCAGAAGACGGCATACGAGATCGATAGTCTAAGGGTCAAGTGCACAGTCTA
s2_R_1505_CATCTGTATC	CAAGCAGAAGACGGCATACGAGATCATCTGTATCAGGGTCAAGTGCACAGTCTA
s2_R_1506_ACGCAATATG	CAAGCAGAAGACGGCATACGAGATACGCAATATGAGGGTCAAGTGCACAGTCTA
s2_R_1507_CAACAATCAG	CAAGCAGAAGACGGCATACGAGATCAACAATCAGAGGGTCAAGTGCACAGTCTA
s2_R_1508_ATGAACAAGC	CAAGCAGAAGACGGCATACGAGATATGAACAAGCAGGGTCAAGTGCACAGTCTA
s2_R_1509_AGATGTACGA	CAAGCAGAAGACGGCATACGAGATAGATGTACGAAGGGTCAAGTGCACAGTCTA
s2_R_1510_ATTACAGGAC	CAAGCAGAAGACGGCATACGAGATATTACAGGACAGGGTCAAGTGCACAGTCTA
s2_R_1511_GCAGAGACTG	CAAGCAGAAGACGGCATACGAGATGCAGAGACTGAGGGTCAAGTGCACAGTCTA
s2_R_1512_GAGAGCATAG	CAAGCAGAAGACGGCATACGAGATGAGAGCATAGAGGGTCAAGTGCACAGTCTA
s2_R_1513_AATTGACTGC	CAAGCAGAAGACGGCATACGAGATAATTGACTGCAGGGTCAAGTGCACAGTCTA
s2_R_1514_AACACACAGG	CAAGCAGAAGACGGCATACGAGATAACACACAGGAGGGTCAAGTGCACAGTCTA
s2_R_1515_CACTCTAGGC	CAAGCAGAAGACGGCATACGAGATCACTCTAGGCAGGGTCAAGTGCACAGTCTA
s2_R_1516_GATTCAAGGC	CAAGCAGAAGACGGCATACGAGATGATTCAAGGCAGGGTCAAGTGCACAGTCTA
s2_R_1517_TAGTCCAGGC	CAAGCAGAAGACGGCATACGAGATTAGTCCAGGCAGGGTCAAGTGCACAGTCTA
s2_R_1518_ATGATGAGGC	CAAGCAGAAGACGGCATACGAGATATGATGAGGCAGGGTCAAGTGCACAGTCTA
s2_R_1519_TAAGTCCTCA	CAAGCAGAAGACGGCATACGAGATTAAGTCCTCAAGGGTCAAGTGCACAGTCTA
s2_R_1520_GATCCACTCA	CAAGCAGAAGACGGCATACGAGATGATCCACTCAAGGGTCAAGTGCACAGTCTA
s2_R_1521_ACCACGTCTT	CAAGCAGAAGACGGCATACGAGATACCACGTCTTAGGGTCAAGTGCACAGTCTA
s2_R_1522_CCTGAGTAAT	CAAGCAGAAGACGGCATACGAGATCCTGAGTAATAGGGTCAAGTGCACAGTCTA
s2_R_1523_CTTCCGTCCT	CAAGCAGAAGACGGCATACGAGATCTTCCGTCCTAGGGTCAAGTGCACAGTCTA
s2_R_1524_AAGCATTAGC	CAAGCAGAAGACGGCATACGAGATAAGCATTAGCAGGGTCAAGTGCACAGTCTA
s2_R_1525_TTCAGACTCT	CAAGCAGAAGACGGCATACGAGATTTCAGACTCTAGGGTCAAGTGCACAGTCTA
s2_R_1526_GACACGCAAC	CAAGCAGAAGACGGCATACGAGATGACACGCAACAGGGTCAAGTGCACAGTCTA
s2_R_1527_AACAACACAC	CAAGCAGAAGACGGCATACGAGATAACAACACACAGGGTCAAGTGCACAGTCTA
s2_R_1528_CCGTCAGAAG	CAAGCAGAAGACGGCATACGAGATCCGTCAGAAGAGGGTCAAGTGCACAGTCTA
s2_R_1529_CTATGCCTTA	CAAGCAGAAGACGGCATACGAGATCTATGCCTTAAGGGTCAAGTGCACAGTCTA
s2_R_1530_ATGACTTCCA	CAAGCAGAAGACGGCATACGAGATATGACTTCCAAGGGTCAAGTGCACAGTCTA
s2_R_1531_GCATACCTCA	CAAGCAGAAGACGGCATACGAGATGCATACCTCAAGGGTCAAGTGCACAGTCTA
s2_R_1532_TCAGCATGGA	CAAGCAGAAGACGGCATACGAGATTCAGCATGGAAGGGTCAAGTGCACAGTCTA
s2_R_1533_AGGACTTAGC	CAAGCAGAAGACGGCATACGAGATAGGACTTAGCAGGGTCAAGTGCACAGTCTA
s2_R_1534_ACTGAGAAGC	CAAGCAGAAGACGGCATACGAGATACTGAGAAGCAGGGTCAAGTGCACAGTCTA
s2_R_1535_GTAATAGAGC	CAAGCAGAAGACGGCATACGAGATGTAATAGAGCAGGGTCAAGTGCACAGTCTA
s2_R_1536_GAGAGGAAGC	CAAGCAGAAGACGGCATACGAGATGAGAGGAAGCAGGGTCAAGTGCACAGTCTA
s2_R_1537_TTACGTTAGC	CAAGCAGAAGACGGCATACGAGATTTACGTTAGCAGGGTCAAGTGCACAGTCTA
s2_R_1538_GCTGAACCAC	CAAGCAGAAGACGGCATACGAGATGCTGAACCACAGGGTCAAGTGCACAGTCTA
s2_R_1539_CTCTGGATAC	CAAGCAGAAGACGGCATACGAGATCTCTGGATACAGGGTCAAGTGCACAGTCTA
s2_R_1540_GTACAATAGC	CAAGCAGAAGACGGCATACGAGATGTACAATAGCAGGGTCAAGTGCACAGTCTA
s2_R_1541_GGAGAGAATC	CAAGCAGAAGACGGCATACGAGATGGAGAGAATCAGGGTCAAGTGCACAGTCTA
s2_R_1542_CACCATCTAG	CAAGCAGAAGACGGCATACGAGATCACCATCTAGAGGGTCAAGTGCACAGTCTA
s2_R_1543_GAAGCATCAC	CAAGCAGAAGACGGCATACGAGATGAAGCATCACAGGGTCAAGTGCACAGTCTA
s2_R_1544_TAGTAGGAAG	CAAGCAGAAGACGGCATACGAGATTAGTAGGAAGAGGGTCAAGTGCACAGTCTA
s2_R_1545_ACGGTGTACG	CAAGCAGAAGACGGCATACGAGATACGGTGTACGAGGGTCAAGTGCACAGTCTA
s2_R_1546_CTCTGAGTTC	CAAGCAGAAGACGGCATACGAGATCTCTGAGTTCAGGGTCAAGTGCACAGTCTA
s2_R_1547_GTCACATTAC	CAAGCAGAAGACGGCATACGAGATGTCACATTACAGGGTCAAGTGCACAGTCTA
s2_R_1548_ACGTAGCTTA	CAAGCAGAAGACGGCATACGAGATACGTAGCTTAAGGGTCAAGTGCACAGTCTA
s2_R_1549_TCACCATACT	CAAGCAGAAGACGGCATACGAGATTCACCATACTAGGGTCAAGTGCACAGTCTA
s2_R_1550_ACCTAAGATG	CAAGCAGAAGACGGCATACGAGATACCTAAGATGAGGGTCAAGTGCACAGTCTA
s2_R_1551_GACAAGAGGT	CAAGCAGAAGACGGCATACGAGATGACAAGAGGTAGGGTCAAGTGCACAGTCTA
s2_R_1552_CGCGGCATAT	CAAGCAGAAGACGGCATACGAGATCGCGGCATATAGGGTCAAGTGCACAGTCTA
s2_R_1553_CGACCTAGAC	CAAGCAGAAGACGGCATACGAGATCGACCTAGACAGGGTCAAGTGCACAGTCTA
s2_R_1554_AGAAGCTTGG	CAAGCAGAAGACGGCATACGAGATAGAAGCTTGGAGGGTCAAGTGCACAGTCTA
s2_R_1555_CGTGTTGCAC	CAAGCAGAAGACGGCATACGAGATCGTGTTGCACAGGGTCAAGTGCACAGTCTA
s2_R_1556_AGTCACATGC	CAAGCAGAAGACGGCATACGAGATAGTCACATGCAGGGTCAAGTGCACAGTCTA
s2_R_1557_TGAGAGCGAA	CAAGCAGAAGACGGCATACGAGATTGAGAGCGAAAGGGTCAAGTGCACAGTCTA
s2_R_1558_CGAAGGTTAG	CAAGCAGAAGACGGCATACGAGATCGAAGGTTAGAGGGTCAAGTGCACAGTCTA
s2_R_1559_AGATTGCACC	CAAGCAGAAGACGGCATACGAGATAGATTGCACCAGGGTCAAGTGCACAGTCTA
s2_R_1560_CAGAACACTT	CAAGCAGAAGACGGCATACGAGATCAGAACACTTAGGGTCAAGTGCACAGTCTA
s2_R_1561_TACAATCGAC	CAAGCAGAAGACGGCATACGAGATTACAATCGACAGGGTCAAGTGCACAGTCTA
s2_R_1562_TGCACAGAAC	CAAGCAGAAGACGGCATACGAGATTGCACAGAACAGGGTCAAGTGCACAGTCTA
s2_R_1563_TCGTCTATGC	CAAGCAGAAGACGGCATACGAGATTCGTCTATGCAGGGTCAAGTGCACAGTCTA
s2_R_1564_AGAGTTATGC	CAAGCAGAAGACGGCATACGAGATAGAGTTATGCAGGGTCAAGTGCACAGTCTA
s2_R_1565_ACACTAGGCT	CAAGCAGAAGACGGCATACGAGATACACTAGGCTAGGGTCAAGTGCACAGTCTA
s2_R_1566_AGACTCATAC	CAAGCAGAAGACGGCATACGAGATAGACTCATACAGGGTCAAGTGCACAGTCTA
s2_R_1567_CGACATCAGG	CAAGCAGAAGACGGCATACGAGATCGACATCAGGAGGGTCAAGTGCACAGTCTA
s2_R_1568_CACTTATTCC	CAAGCAGAAGACGGCATACGAGATCACTTATTCCAGGGTCAAGTGCACAGTCTA
s2_R_1569_TATGATGTGG	CAAGCAGAAGACGGCATACGAGATTATGATGTGGAGGGTCAAGTGCACAGTCTA
s2_R_1570_TACCTAGCCA	CAAGCAGAAGACGGCATACGAGATTACCTAGCCAAGGGTCAAGTGCACAGTCTA
s2_R_1571_TATGCCATGA	CAAGCAGAAGACGGCATACGAGATTATGCCATGAAGGGTCAAGTGCACAGTCTA
s2_R_1572_AGCGTAATCT	CAAGCAGAAGACGGCATACGAGATAGCGTAATCTAGGGTCAAGTGCACAGTCTA
s2_R_1573_ACTAGAGTCC	CAAGCAGAAGACGGCATACGAGATACTAGAGTCCAGGGTCAAGTGCACAGTCTA
s2_R_1574_TCTTGCGTTA	CAAGCAGAAGACGGCATACGAGATTCTTGCGTTAAGGGTCAAGTGCACAGTCTA
s2_R_1575_GACATTCTTC	CAAGCAGAAGACGGCATACGAGATGACATTCTTCAGGGTCAAGTGCACAGTCTA
s2_R_1576_CGAAGAGTAT	CAAGCAGAAGACGGCATACGAGATCGAAGAGTATAGGGTCAAGTGCACAGTCTA
s2_R_1577_TGGAGTCTTA	CAAGCAGAAGACGGCATACGAGATTGGAGTCTTAAGGGTCAAGTGCACAGTCTA
s2_R_1578_CCAGAAGACT	CAAGCAGAAGACGGCATACGAGATCCAGAAGACTAGGGTCAAGTGCACAGTCTA
s2_R_1579_CGTTAACCTC	CAAGCAGAAGACGGCATACGAGATCGTTAACCTCAGGGTCAAGTGCACAGTCTA
s2_R_1580_TAGCCACCAC	CAAGCAGAAGACGGCATACGAGATTAGCCACCACAGGGTCAAGTGCACAGTCTA
s2_R_1581_TGTCTAATCC	CAAGCAGAAGACGGCATACGAGATTGTCTAATCCAGGGTCAAGTGCACAGTCTA
s2_R_1582_CGACATGACT	CAAGCAGAAGACGGCATACGAGATCGACATGACTAGGGTCAAGTGCACAGTCTA
s2_R_1583_ACTAGCGAAT	CAAGCAGAAGACGGCATACGAGATACTAGCGAATAGGGTCAAGTGCACAGTCTA
s2_R_1584_AACGCCAGTC	CAAGCAGAAGACGGCATACGAGATAACGCCAGTCAGGGTCAAGTGCACAGTCTA
s2_R_1585_GAACCGTCAT	CAAGCAGAAGACGGCATACGAGATGAACCGTCATAGGGTCAAGTGCACAGTCTA
s2_R_1586_GTCCAATTAG	CAAGCAGAAGACGGCATACGAGATGTCCAATTAGAGGGTCAAGTGCACAGTCTA
s2_R_1587_ACGCAACAAT	CAAGCAGAAGACGGCATACGAGATACGCAACAATAGGGTCAAGTGCACAGTCTA
s2_R_1588_CTACGTTCTC	CAAGCAGAAGACGGCATACGAGATCTACGTTCTCAGGGTCAAGTGCACAGTCTA
s2_R_1589_TGTAAGTGCT	CAAGCAGAAGACGGCATACGAGATTGTAAGTGCTAGGGTCAAGTGCACAGTCTA
s2_R_1590_ACAGACGATT	CAAGCAGAAGACGGCATACGAGATACAGACGATTAGGGTCAAGTGCACAGTCTA
s2_R_1591_CAGTCTATTC	CAAGCAGAAGACGGCATACGAGATCAGTCTATTCAGGGTCAAGTGCACAGTCTA
s2_R_1592_AGCAGAGTAA	CAAGCAGAAGACGGCATACGAGATAGCAGAGTAAAGGGTCAAGTGCACAGTCTA
s2_R_1593_CTGAGTTCTT	CAAGCAGAAGACGGCATACGAGATCTGAGTTCTTAGGGTCAAGTGCACAGTCTA
s2_R_1594_ATCAGCACTC	CAAGCAGAAGACGGCATACGAGATATCAGCACTCAGGGTCAAGTGCACAGTCTA
s2_R_1595_CGAGTTGAAG	CAAGCAGAAGACGGCATACGAGATCGAGTTGAAGAGGGTCAAGTGCACAGTCTA
s2_R_1596_CCTGAACACA	CAAGCAGAAGACGGCATACGAGATCCTGAACACAAGGGTCAAGTGCACAGTCTA
s2_R_1597_AGACTAGAGC	CAAGCAGAAGACGGCATACGAGATAGACTAGAGCAGGGTCAAGTGCACAGTCTA
s2_R_1598_TGTCGACCGA	CAAGCAGAAGACGGCATACGAGATTGTCGACCGAAGGGTCAAGTGCACAGTCTA
s2_R_1599_ATTATCGCGA	CAAGCAGAAGACGGCATACGAGATATTATCGCGAAGGGTCAAGTGCACAGTCTA
s2_R_1600_CATGCTCTTC	CAAGCAGAAGACGGCATACGAGATCATGCTCTTCAGGGTCAAGTGCACAGTCTA
s2_R_1601_GTAAGACAAG	CAAGCAGAAGACGGCATACGAGATGTAAGACAAGAGGGTCAAGTGCACAGTCTA
s2_R_1602_TGAAGCAAGA	CAAGCAGAAGACGGCATACGAGATTGAAGCAAGAAGGGTCAAGTGCACAGTCTA
s2_R_1603_TCTAGACACA	CAAGCAGAAGACGGCATACGAGATTCTAGACACAAGGGTCAAGTGCACAGTCTA
s2_R_1604_ACAGTCACAT	CAAGCAGAAGACGGCATACGAGATACAGTCACATAGGGTCAAGTGCACAGTCTA
s2_R_1605_TGGATAGCTA	CAAGCAGAAGACGGCATACGAGATTGGATAGCTAAGGGTCAAGTGCACAGTCTA
s2_R_1606_TCGTAACCAC	CAAGCAGAAGACGGCATACGAGATTCGTAACCACAGGGTCAAGTGCACAGTCTA
s2_R_1607_ACACGAGTAC	CAAGCAGAAGACGGCATACGAGATACACGAGTACAGGGTCAAGTGCACAGTCTA
s2_R_1608_CGCACAAGGA	CAAGCAGAAGACGGCATACGAGATCGCACAAGGAAGGGTCAAGTGCACAGTCTA
s2_R_1609_CAAGCAAGTA	CAAGCAGAAGACGGCATACGAGATCAAGCAAGTAAGGGTCAAGTGCACAGTCTA
s2_R_1610_ATGTCAACTC	CAAGCAGAAGACGGCATACGAGATATGTCAACTCAGGGTCAAGTGCACAGTCTA
s2_R_1611_ATCGCCACAT	CAAGCAGAAGACGGCATACGAGATATCGCCACATAGGGTCAAGTGCACAGTCTA
s2_R_1612_GCTATGACTC	CAAGCAGAAGACGGCATACGAGATGCTATGACTCAGGGTCAAGTGCACAGTCTA
s2_R_1613_AGACAGTCAC	CAAGCAGAAGACGGCATACGAGATAGACAGTCACAGGGTCAAGTGCACAGTCTA
s2_R_1614_ACTTAGGAAG	CAAGCAGAAGACGGCATACGAGATACTTAGGAAGAGGGTCAAGTGCACAGTCTA
s2_R_1615_CGAGTAACCA	CAAGCAGAAGACGGCATACGAGATCGAGTAACCAAGGGTCAAGTGCACAGTCTA
s2_R_1616_ATCAGCAAGT	CAAGCAGAAGACGGCATACGAGATATCAGCAAGTAGGGTCAAGTGCACAGTCTA
s2_R_1617_TGATGAAGGA	CAAGCAGAAGACGGCATACGAGATTGATGAAGGAAGGGTCAAGTGCACAGTCTA
s2_R_1618_CAACGCTAGG	CAAGCAGAAGACGGCATACGAGATCAACGCTAGGAGGGTCAAGTGCACAGTCTA
s2_R_1619_TGAAGACCAA	CAAGCAGAAGACGGCATACGAGATTGAAGACCAAAGGGTCAAGTGCACAGTCTA
s2_R_1620_AGGACAATGC	CAAGCAGAAGACGGCATACGAGATAGGACAATGCAGGGTCAAGTGCACAGTCTA
s2_R_1621_TTACACGAGG	CAAGCAGAAGACGGCATACGAGATTTACACGAGGAGGGTCAAGTGCACAGTCTA
s2_R_1622_ACGGTAGCGT	CAAGCAGAAGACGGCATACGAGATACGGTAGCGTAGGGTCAAGTGCACAGTCTA
s2_R_1623_CCAGTTCACA	CAAGCAGAAGACGGCATACGAGATCCAGTTCACAAGGGTCAAGTGCACAGTCTA
s2_R_1624_CTTGAGAGTT	CAAGCAGAAGACGGCATACGAGATCTTGAGAGTTAGGGTCAAGTGCACAGTCTA
s2_R_1625_GTACTAGCAA	CAAGCAGAAGACGGCATACGAGATGTACTAGCAAAGGGTCAAGTGCACAGTCTA
s2_R_1626_TGGCACGTCT	CAAGCAGAAGACGGCATACGAGATTGGCACGTCTAGGGTCAAGTGCACAGTCTA
s2_R_1627_GTTATGCCAG	CAAGCAGAAGACGGCATACGAGATGTTATGCCAGAGGGTCAAGTGCACAGTCTA
s2_R_1628_ACCTCATGAC	CAAGCAGAAGACGGCATACGAGATACCTCATGACAGGGTCAAGTGCACAGTCTA
s2_R_1629_ACAGATGAAG	CAAGCAGAAGACGGCATACGAGATACAGATGAAGAGGGTCAAGTGCACAGTCTA
s2_R_1630_CCAACCTATT	CAAGCAGAAGACGGCATACGAGATCCAACCTATTAGGGTCAAGTGCACAGTCTA
s2_R_1631_AGGAGCAACC	CAAGCAGAAGACGGCATACGAGATAGGAGCAACCAGGGTCAAGTGCACAGTCTA
s2_R_1632_CCACTTCTAC	CAAGCAGAAGACGGCATACGAGATCCACTTCTACAGGGTCAAGTGCACAGTCTA
s2_R_1633_TTACTACGTG	CAAGCAGAAGACGGCATACGAGATTTACTACGTGAGGGTCAAGTGCACAGTCTA
s2_R_1634_CTCTCACACT	CAAGCAGAAGACGGCATACGAGATCTCTCACACTAGGGTCAAGTGCACAGTCTA
s2_R_1635_ACCTCCGACT	CAAGCAGAAGACGGCATACGAGATACCTCCGACTAGGGTCAAGTGCACAGTCTA
s2_R_1636_TGCCTACTTA	CAAGCAGAAGACGGCATACGAGATTGCCTACTTAAGGGTCAAGTGCACAGTCTA
s2_R_1637_ATCGACTAGG	CAAGCAGAAGACGGCATACGAGATATCGACTAGGAGGGTCAAGTGCACAGTCTA
s2_R_1638_ATGCGTTGCT	CAAGCAGAAGACGGCATACGAGATATGCGTTGCTAGGGTCAAGTGCACAGTCTA
s2_R_1639_TTCAGCGTAT	CAAGCAGAAGACGGCATACGAGATTTCAGCGTATAGGGTCAAGTGCACAGTCTA
s2_R_1640_TTCTCCTACT	CAAGCAGAAGACGGCATACGAGATTTCTCCTACTAGGGTCAAGTGCACAGTCTA
s2_R_1641_TCCATACTCA	CAAGCAGAAGACGGCATACGAGATTCCATACTCAAGGGTCAAGTGCACAGTCTA
s2_R_1642_TCTGGCAGTC	CAAGCAGAAGACGGCATACGAGATTCTGGCAGTCAGGGTCAAGTGCACAGTCTA
s2_R_1643_ACATGAACTC	CAAGCAGAAGACGGCATACGAGATACATGAACTCAGGGTCAAGTGCACAGTCTA
s2_R_1644_CACTACACTC	CAAGCAGAAGACGGCATACGAGATCACTACACTCAGGGTCAAGTGCACAGTCTA
s2_R_1645_TCAGGATTCC	CAAGCAGAAGACGGCATACGAGATTCAGGATTCCAGGGTCAAGTGCACAGTCTA
s2_R_1646_ACTGCTCCTT	CAAGCAGAAGACGGCATACGAGATACTGCTCCTTAGGGTCAAGTGCACAGTCTA
s2_R_1647_GACTTACGCC	CAAGCAGAAGACGGCATACGAGATGACTTACGCCAGGGTCAAGTGCACAGTCTA
s2_R_1648_TAAGGCTCTG	CAAGCAGAAGACGGCATACGAGATTAAGGCTCTGAGGGTCAAGTGCACAGTCTA
s2_R_1649_ACATGCTAAC	CAAGCAGAAGACGGCATACGAGATACATGCTAACAGGGTCAAGTGCACAGTCTA
s2_R_1650_ACGAACGACT	CAAGCAGAAGACGGCATACGAGATACGAACGACTAGGGTCAAGTGCACAGTCTA
s2_R_1651_ATCCGTTAAG	CAAGCAGAAGACGGCATACGAGATATCCGTTAAGAGGGTCAAGTGCACAGTCTA
s2_R_1652_ACAGAAGGCC	CAAGCAGAAGACGGCATACGAGATACAGAAGGCCAGGGTCAAGTGCACAGTCTA
s2_R_1653_AGAAGACGAG	CAAGCAGAAGACGGCATACGAGATAGAAGACGAGAGGGTCAAGTGCACAGTCTA
s2_R_1654_CAACCGTGAA	CAAGCAGAAGACGGCATACGAGATCAACCGTGAAAGGGTCAAGTGCACAGTCTA
s2_R_1655_CAAGAAGGTT	CAAGCAGAAGACGGCATACGAGATCAAGAAGGTTAGGGTCAAGTGCACAGTCTA
s2_R_1656_CCATCCACCT	CAAGCAGAAGACGGCATACGAGATCCATCCACCTAGGGTCAAGTGCACAGTCTA
s2_R_1657_ATCTGTCACT	CAAGCAGAAGACGGCATACGAGATATCTGTCACTAGGGTCAAGTGCACAGTCTA
s2_R_1658_CCTGCCTACT	CAAGCAGAAGACGGCATACGAGATCCTGCCTACTAGGGTCAAGTGCACAGTCTA
s2_R_1659_CATATCTGAG	CAAGCAGAAGACGGCATACGAGATCATATCTGAGAGGGTCAAGTGCACAGTCTA
s2_R_1660_GACAGGCTCT	CAAGCAGAAGACGGCATACGAGATGACAGGCTCTAGGGTCAAGTGCACAGTCTA
s2_R_1661_GGATACTCTC	CAAGCAGAAGACGGCATACGAGATGGATACTCTCAGGGTCAAGTGCACAGTCTA
s2_R_1662_TACCTAATGG	CAAGCAGAAGACGGCATACGAGATTACCTAATGGAGGGTCAAGTGCACAGTCTA
s2_R_1663_CATGCGACCT	CAAGCAGAAGACGGCATACGAGATCATGCGACCTAGGGTCAAGTGCACAGTCTA
s2_R_1664_TAGAAGAGAC	CAAGCAGAAGACGGCATACGAGATTAGAAGAGACAGGGTCAAGTGCACAGTCTA
s2_R_1665_TGATAGCCAC	CAAGCAGAAGACGGCATACGAGATTGATAGCCACAGGGTCAAGTGCACAGTCTA
s2_R_1666_ATACAGATCC	CAAGCAGAAGACGGCATACGAGATATACAGATCCAGGGTCAAGTGCACAGTCTA
s2_R_1667_CCATGTGACT	CAAGCAGAAGACGGCATACGAGATCCATGTGACTAGGGTCAAGTGCACAGTCTA
s2_R_1668_ACGTAACTCC	CAAGCAGAAGACGGCATACGAGATACGTAACTCCAGGGTCAAGTGCACAGTCTA
s2_R_1669_CTCCTTGCCT	CAAGCAGAAGACGGCATACGAGATCTCCTTGCCTAGGGTCAAGTGCACAGTCTA
s2_R_1670_TAATCGATCC	CAAGCAGAAGACGGCATACGAGATTAATCGATCCAGGGTCAAGTGCACAGTCTA
s2_R_1671_TTCACGCAAT	CAAGCAGAAGACGGCATACGAGATTTCACGCAATAGGGTCAAGTGCACAGTCTA
s2_R_1672_TGCAATTCAC	CAAGCAGAAGACGGCATACGAGATTGCAATTCACAGGGTCAAGTGCACAGTCTA
s2_R_1673_TCTTGCATAG	CAAGCAGAAGACGGCATACGAGATTCTTGCATAGAGGGTCAAGTGCACAGTCTA
s2_R_1674_TGTTGCGAAT	CAAGCAGAAGACGGCATACGAGATTGTTGCGAATAGGGTCAAGTGCACAGTCTA
s2_R_1675_TAGGCGATAT	CAAGCAGAAGACGGCATACGAGATTAGGCGATATAGGGTCAAGTGCACAGTCTA
s2_R_1676_AACCTTCCTC	CAAGCAGAAGACGGCATACGAGATAACCTTCCTCAGGGTCAAGTGCACAGTCTA
s2_R_1677_ATTGGTTCCA	CAAGCAGAAGACGGCATACGAGATATTGGTTCCAAGGGTCAAGTGCACAGTCTA
s2_R_1678_CTCAGAATGC	CAAGCAGAAGACGGCATACGAGATCTCAGAATGCAGGGTCAAGTGCACAGTCTA
s2_R_1679_GCTCCTCTAC	CAAGCAGAAGACGGCATACGAGATGCTCCTCTACAGGGTCAAGTGCACAGTCTA
s2_R_1680_GTTCAAGTCT	CAAGCAGAAGACGGCATACGAGATGTTCAAGTCTAGGGTCAAGTGCACAGTCTA
s2_R_1681_GTAATCGACT	CAAGCAGAAGACGGCATACGAGATGTAATCGACTAGGGTCAAGTGCACAGTCTA
s2_R_1682_GCGTTAATGC	CAAGCAGAAGACGGCATACGAGATGCGTTAATGCAGGGTCAAGTGCACAGTCTA
s2_R_1683_CCTCGTCAGA	CAAGCAGAAGACGGCATACGAGATCCTCGTCAGAAGGGTCAAGTGCACAGTCTA
s2_R_1684_ATAGTCCAGA	CAAGCAGAAGACGGCATACGAGATATAGTCCAGAAGGGTCAAGTGCACAGTCTA
s2_R_1685_ACTCACCAGA	CAAGCAGAAGACGGCATACGAGATACTCACCAGAAGGGTCAAGTGCACAGTCTA
s2_R_1686_CCAACAGTAA	CAAGCAGAAGACGGCATACGAGATCCAACAGTAAAGGGTCAAGTGCACAGTCTA
s2_R_1687_TCAACGTTCA	CAAGCAGAAGACGGCATACGAGATTCAACGTTCAAGGGTCAAGTGCACAGTCTA
s2_R_1688_CAATCCACGA	CAAGCAGAAGACGGCATACGAGATCAATCCACGAAGGGTCAAGTGCACAGTCTA
s2_R_1689_GAGGCTCAAC	CAAGCAGAAGACGGCATACGAGATGAGGCTCAACAGGGTCAAGTGCACAGTCTA
s2_R_1690_ATTCCTGCTT	CAAGCAGAAGACGGCATACGAGATATTCCTGCTTAGGGTCAAGTGCACAGTCTA
s2_R_1691_ACACTATCAC	CAAGCAGAAGACGGCATACGAGATACACTATCACAGGGTCAAGTGCACAGTCTA
s2_R_1692_ACTGCTCAGG	CAAGCAGAAGACGGCATACGAGATACTGCTCAGGAGGGTCAAGTGCACAGTCTA
s2_R_1693_TACCACCTTC	CAAGCAGAAGACGGCATACGAGATTACCACCTTCAGGGTCAAGTGCACAGTCTA
s2_R_1694_CTCACTCTTG	CAAGCAGAAGACGGCATACGAGATCTCACTCTTGAGGGTCAAGTGCACAGTCTA
s2_R_1695_TGACAACTGC	CAAGCAGAAGACGGCATACGAGATTGACAACTGCAGGGTCAAGTGCACAGTCTA
s2_R_1696_TAAGACGAGA	CAAGCAGAAGACGGCATACGAGATTAAGACGAGAAGGGTCAAGTGCACAGTCTA
s2_R_1697_CTCACCGACT	CAAGCAGAAGACGGCATACGAGATCTCACCGACTAGGGTCAAGTGCACAGTCTA
s2_R_1698_GCACTAGTCA	CAAGCAGAAGACGGCATACGAGATGCACTAGTCAAGGGTCAAGTGCACAGTCTA
s2_R_1699_TATTCCTGAG	CAAGCAGAAGACGGCATACGAGATTATTCCTGAGAGGGTCAAGTGCACAGTCTA
s2_R_1700_CCACCATCAA	CAAGCAGAAGACGGCATACGAGATCCACCATCAAAGGGTCAAGTGCACAGTCTA
s2_R_1701_CCAAGCCAGA	CAAGCAGAAGACGGCATACGAGATCCAAGCCAGAAGGGTCAAGTGCACAGTCTA
s2_R_1702_TATCTGAACC	CAAGCAGAAGACGGCATACGAGATTATCTGAACCAGGGTCAAGTGCACAGTCTA
s2_R_1703_TTCCATCGTT	CAAGCAGAAGACGGCATACGAGATTTCCATCGTTAGGGTCAAGTGCACAGTCTA
s2_R_1704_TGAATCTGAC	CAAGCAGAAGACGGCATACGAGATTGAATCTGACAGGGTCAAGTGCACAGTCTA
s2_R_1705_GCTTAACTAG	CAAGCAGAAGACGGCATACGAGATGCTTAACTAGAGGGTCAAGTGCACAGTCTA
s2_R_1706_GAGCTTCGTT	CAAGCAGAAGACGGCATACGAGATGAGCTTCGTTAGGGTCAAGTGCACAGTCTA
s2_R_1707_CACTCGCTAT	CAAGCAGAAGACGGCATACGAGATCACTCGCTATAGGGTCAAGTGCACAGTCTA
s2_R_1708_GGAAGTGCTC	CAAGCAGAAGACGGCATACGAGATGGAAGTGCTCAGGGTCAAGTGCACAGTCTA
s2_R_1709_TGGCTACCTG	CAAGCAGAAGACGGCATACGAGATTGGCTACCTGAGGGTCAAGTGCACAGTCTA
s2_R_1710_TACACCGTCA	CAAGCAGAAGACGGCATACGAGATTACACCGTCAAGGGTCAAGTGCACAGTCTA
s2_R_1711_AGAGATACCT	CAAGCAGAAGACGGCATACGAGATAGAGATACCTAGGGTCAAGTGCACAGTCTA
s2_R_1712_CCTAATTCAC	CAAGCAGAAGACGGCATACGAGATCCTAATTCACAGGGTCAAGTGCACAGTCTA
s2_R_1713_GAGAACTTGA	CAAGCAGAAGACGGCATACGAGATGAGAACTTGAAGGGTCAAGTGCACAGTCTA
s2_R_1714_CTCCTTCAGA	CAAGCAGAAGACGGCATACGAGATCTCCTTCAGAAGGGTCAAGTGCACAGTCTA
s2_R_1715_ATCTTCAGAC	CAAGCAGAAGACGGCATACGAGATATCTTCAGACAGGGTCAAGTGCACAGTCTA
s2_R_1716_CACTACAAGA	CAAGCAGAAGACGGCATACGAGATCACTACAAGAAGGGTCAAGTGCACAGTCTA
s2_R_1717_TAGGCCAATT	CAAGCAGAAGACGGCATACGAGATTAGGCCAATTAGGGTCAAGTGCACAGTCTA
s2_R_1718_CGTTACCGAT	CAAGCAGAAGACGGCATACGAGATCGTTACCGATAGGGTCAAGTGCACAGTCTA
s2_R_1719_ATGAGAGCTC	CAAGCAGAAGACGGCATACGAGATATGAGAGCTCAGGGTCAAGTGCACAGTCTA
s2_R_1720_CTGCACATAC	CAAGCAGAAGACGGCATACGAGATCTGCACATACAGGGTCAAGTGCACAGTCTA
s2_R_1721_TGCACACATG	CAAGCAGAAGACGGCATACGAGATTGCACACATGAGGGTCAAGTGCACAGTCTA
s2_R_1722_TACTTACCGA	CAAGCAGAAGACGGCATACGAGATTACTTACCGAAGGGTCAAGTGCACAGTCTA
s2_R_1723_GATACAGGAT	CAAGCAGAAGACGGCATACGAGATGATACAGGATAGGGTCAAGTGCACAGTCTA
s2_R_1724_CGTGAACAAT	CAAGCAGAAGACGGCATACGAGATCGTGAACAATAGGGTCAAGTGCACAGTCTA
s2_R_1725_CTTCCAATTG	CAAGCAGAAGACGGCATACGAGATCTTCCAATTGAGGGTCAAGTGCACAGTCTA
s2_R_1726_CTTGCTGTAG	CAAGCAGAAGACGGCATACGAGATCTTGCTGTAGAGGGTCAAGTGCACAGTCTA
s2_R_1727_GTCTGGAAGA	CAAGCAGAAGACGGCATACGAGATGTCTGGAAGAAGGGTCAAGTGCACAGTCTA
s2_R_1728_ATCTACCTAC	CAAGCAGAAGACGGCATACGAGATATCTACCTACAGGGTCAAGTGCACAGTCTA
s2_R_1729_ATCACGGTTC	CAAGCAGAAGACGGCATACGAGATATCACGGTTCAGGGTCAAGTGCACAGTCTA
s2_R_1730_ATCGAGTTCC	CAAGCAGAAGACGGCATACGAGATATCGAGTTCCAGGGTCAAGTGCACAGTCTA
s2_R_1731_TAGGTGTGGC	CAAGCAGAAGACGGCATACGAGATTAGGTGTGGCAGGGTCAAGTGCACAGTCTA
s2_R_1732_TCTCGACATG	CAAGCAGAAGACGGCATACGAGATTCTCGACATGAGGGTCAAGTGCACAGTCTA
s2_R_1733_TCATTACGAG	CAAGCAGAAGACGGCATACGAGATTCATTACGAGAGGGTCAAGTGCACAGTCTA
s2_R_1734_CGCAACAGAC	CAAGCAGAAGACGGCATACGAGATCGCAACAGACAGGGTCAAGTGCACAGTCTA
s2_R_1735_TATACCTAGC	CAAGCAGAAGACGGCATACGAGATTATACCTAGCAGGGTCAAGTGCACAGTCTA
s2_R_1736_TGACTCCAAC	CAAGCAGAAGACGGCATACGAGATTGACTCCAACAGGGTCAAGTGCACAGTCTA
s2_R_1737_GTTCCGCTAA	CAAGCAGAAGACGGCATACGAGATGTTCCGCTAAAGGGTCAAGTGCACAGTCTA
s2_R_1738_CAGGAAGTTA	CAAGCAGAAGACGGCATACGAGATCAGGAAGTTAAGGGTCAAGTGCACAGTCTA
s2_R_1739_GACTCGACTC	CAAGCAGAAGACGGCATACGAGATGACTCGACTCAGGGTCAAGTGCACAGTCTA
s2_R_1740_GACCAGTTAA	CAAGCAGAAGACGGCATACGAGATGACCAGTTAAAGGGTCAAGTGCACAGTCTA
s2_R_1741_GACCATCCAT	CAAGCAGAAGACGGCATACGAGATGACCATCCATAGGGTCAAGTGCACAGTCTA
s2_R_1742_TATCGCTTCC	CAAGCAGAAGACGGCATACGAGATTATCGCTTCCAGGGTCAAGTGCACAGTCTA
s2_R_1743_ACGCTGAACC	CAAGCAGAAGACGGCATACGAGATACGCTGAACCAGGGTCAAGTGCACAGTCTA
s2_R_1744_CCATTACCAA	CAAGCAGAAGACGGCATACGAGATCCATTACCAAAGGGTCAAGTGCACAGTCTA
s2_R_1745_TCAGACTATG	CAAGCAGAAGACGGCATACGAGATTCAGACTATGAGGGTCAAGTGCACAGTCTA
s2_R_1746_TGTTACGATG	CAAGCAGAAGACGGCATACGAGATTGTTACGATGAGGGTCAAGTGCACAGTCTA
s2_R_1747_CTCCTAATTC	CAAGCAGAAGACGGCATACGAGATCTCCTAATTCAGGGTCAAGTGCACAGTCTA
s2_R_1748_GCTACCGGAA	CAAGCAGAAGACGGCATACGAGATGCTACCGGAAAGGGTCAAGTGCACAGTCTA
s2_R_1749_TGCGACCTTG	CAAGCAGAAGACGGCATACGAGATTGCGACCTTGAGGGTCAAGTGCACAGTCTA
s2_R_1750_GACGCATTCA	CAAGCAGAAGACGGCATACGAGATGACGCATTCAAGGGTCAAGTGCACAGTCTA
s2_R_1751_AAGCAACTAC	CAAGCAGAAGACGGCATACGAGATAAGCAACTACAGGGTCAAGTGCACAGTCTA
s2_R_1752_CCACCTAGTA	CAAGCAGAAGACGGCATACGAGATCCACCTAGTAAGGGTCAAGTGCACAGTCTA
s2_R_1753_CGACTTCTTG	CAAGCAGAAGACGGCATACGAGATCGACTTCTTGAGGGTCAAGTGCACAGTCTA
s2_R_1754_TTCTTCGTCT	CAAGCAGAAGACGGCATACGAGATTTCTTCGTCTAGGGTCAAGTGCACAGTCTA
s2_R_1755_GACCTACTAA	CAAGCAGAAGACGGCATACGAGATGACCTACTAAAGGGTCAAGTGCACAGTCTA
s2_R_1756_GTCATCATCC	CAAGCAGAAGACGGCATACGAGATGTCATCATCCAGGGTCAAGTGCACAGTCTA
s2_R_1757_AAGTACTCTC	CAAGCAGAAGACGGCATACGAGATAAGTACTCTCAGGGTCAAGTGCACAGTCTA
s2_R_1758_GGAATACGAC	CAAGCAGAAGACGGCATACGAGATGGAATACGACAGGGTCAAGTGCACAGTCTA
s2_R_1759_TCTTCCACAT	CAAGCAGAAGACGGCATACGAGATTCTTCCACATAGGGTCAAGTGCACAGTCTA
s2_R_1760_CACTGAACAT	CAAGCAGAAGACGGCATACGAGATCACTGAACATAGGGTCAAGTGCACAGTCTA
s2_R_1761_CCACACTGAA	CAAGCAGAAGACGGCATACGAGATCCACACTGAAAGGGTCAAGTGCACAGTCTA
s2_R_1762_TTCAAGGCTA	CAAGCAGAAGACGGCATACGAGATTTCAAGGCTAAGGGTCAAGTGCACAGTCTA
s2_R_1763_TTAGGACATG	CAAGCAGAAGACGGCATACGAGATTTAGGACATGAGGGTCAAGTGCACAGTCTA
s2_R_1764_TACCTGACTA	CAAGCAGAAGACGGCATACGAGATTACCTGACTAAGGGTCAAGTGCACAGTCTA
s2_R_1765_CTGTTCCTGG	CAAGCAGAAGACGGCATACGAGATCTGTTCCTGGAGGGTCAAGTGCACAGTCTA
s2_R_1766_GCAGAGTACC	CAAGCAGAAGACGGCATACGAGATGCAGAGTACCAGGGTCAAGTGCACAGTCTA
s2_R_1767_TAACATGCCA	CAAGCAGAAGACGGCATACGAGATTAACATGCCAAGGGTCAAGTGCACAGTCTA
s2_R_1768_CCAAGTCAAC	CAAGCAGAAGACGGCATACGAGATCCAAGTCAACAGGGTCAAGTGCACAGTCTA
s2_R_1769_TACAGGTTGT	CAAGCAGAAGACGGCATACGAGATTACAGGTTGTAGGGTCAAGTGCACAGTCTA
s2_R_1770_CGAATAAGAG	CAAGCAGAAGACGGCATACGAGATCGAATAAGAGAGGGTCAAGTGCACAGTCTA
s2_R_1771_TCGTATTCCT	CAAGCAGAAGACGGCATACGAGATTCGTATTCCTAGGGTCAAGTGCACAGTCTA
s2_R_1772_CGTTATCTCA	CAAGCAGAAGACGGCATACGAGATCGTTATCTCAAGGGTCAAGTGCACAGTCTA
s2_R_1773_CGAACTGAAT	CAAGCAGAAGACGGCATACGAGATCGAACTGAATAGGGTCAAGTGCACAGTCTA
s2_R_1774_CACGTAGTTG	CAAGCAGAAGACGGCATACGAGATCACGTAGTTGAGGGTCAAGTGCACAGTCTA
s2_R_1775_CCACACCAAC	CAAGCAGAAGACGGCATACGAGATCCACACCAACAGGGTCAAGTGCACAGTCTA
s2_R_1776_AACAGACGAC	CAAGCAGAAGACGGCATACGAGATAACAGACGACAGGGTCAAGTGCACAGTCTA
s2_R_1777_GAAGAGGTAG	CAAGCAGAAGACGGCATACGAGATGAAGAGGTAGAGGGTCAAGTGCACAGTCTA
s2_R_1778_GACTTATCCA	CAAGCAGAAGACGGCATACGAGATGACTTATCCAAGGGTCAAGTGCACAGTCTA
s2_R_1779_CACCTATGAG	CAAGCAGAAGACGGCATACGAGATCACCTATGAGAGGGTCAAGTGCACAGTCTA
s2_R_1780_ACGAGGCATT	CAAGCAGAAGACGGCATACGAGATACGAGGCATTAGGGTCAAGTGCACAGTCTA
s2_R_1781_CCGATGATGA	CAAGCAGAAGACGGCATACGAGATCCGATGATGAAGGGTCAAGTGCACAGTCTA
s2_R_1782_CTAACACCTT	CAAGCAGAAGACGGCATACGAGATCTAACACCTTAGGGTCAAGTGCACAGTCTA
s2_R_1783_TTAGGAACGT	CAAGCAGAAGACGGCATACGAGATTTAGGAACGTAGGGTCAAGTGCACAGTCTA
s2_R_1784_GTACTACAGT	CAAGCAGAAGACGGCATACGAGATGTACTACAGTAGGGTCAAGTGCACAGTCTA
s2_R_1785_GAAGGTTCTT	CAAGCAGAAGACGGCATACGAGATGAAGGTTCTTAGGGTCAAGTGCACAGTCTA
s2_R_1786_CCTAGATGAG	CAAGCAGAAGACGGCATACGAGATCCTAGATGAGAGGGTCAAGTGCACAGTCTA
s2_R_1787_GCATCGACCA	CAAGCAGAAGACGGCATACGAGATGCATCGACCAAGGGTCAAGTGCACAGTCTA
s2_R_1788_TTCCAGCAAC	CAAGCAGAAGACGGCATACGAGATTTCCAGCAACAGGGTCAAGTGCACAGTCTA
s2_R_1789_GAACATGCTC	CAAGCAGAAGACGGCATACGAGATGAACATGCTCAGGGTCAAGTGCACAGTCTA
s2_R_1790_TGCCATCCTC	CAAGCAGAAGACGGCATACGAGATTGCCATCCTCAGGGTCAAGTGCACAGTCTA
s2_R_1791_CAGTCATAGC	CAAGCAGAAGACGGCATACGAGATCAGTCATAGCAGGGTCAAGTGCACAGTCTA
s2_R_1792_TCAACTCGTA	CAAGCAGAAGACGGCATACGAGATTCAACTCGTAAGGGTCAAGTGCACAGTCTA
s2_R_1793_ACGGTCTGAC	CAAGCAGAAGACGGCATACGAGATACGGTCTGACAGGGTCAAGTGCACAGTCTA
s2_R_1794_TAGGACGAAC	CAAGCAGAAGACGGCATACGAGATTAGGACGAACAGGGTCAAGTGCACAGTCTA
s2_R_1795_ACCGGTGACT	CAAGCAGAAGACGGCATACGAGATACCGGTGACTAGGGTCAAGTGCACAGTCTA
s2_R_1796_CCTGGATTAA	CAAGCAGAAGACGGCATACGAGATCCTGGATTAAAGGGTCAAGTGCACAGTCTA
s2_R_1797_CGAGACCACT	CAAGCAGAAGACGGCATACGAGATCGAGACCACTAGGGTCAAGTGCACAGTCTA
s2_R_1798_AGCCAGGACA	CAAGCAGAAGACGGCATACGAGATAGCCAGGACAAGGGTCAAGTGCACAGTCTA
s2_R_1799_TACTCTCCTC	CAAGCAGAAGACGGCATACGAGATTACTCTCCTCAGGGTCAAGTGCACAGTCTA
s2_R_1800_CATCCACAGG	CAAGCAGAAGACGGCATACGAGATCATCCACAGGAGGGTCAAGTGCACAGTCTA
s2_R_1801_TAACTCCTTG	CAAGCAGAAGACGGCATACGAGATTAACTCCTTGAGGGTCAAGTGCACAGTCTA
s2_R_1802_ATTCGCCAGG	CAAGCAGAAGACGGCATACGAGATATTCGCCAGGAGGGTCAAGTGCACAGTCTA
s2_R_1803_TCCAGGTATT	CAAGCAGAAGACGGCATACGAGATTCCAGGTATTAGGGTCAAGTGCACAGTCTA
s2_R_1804_TAGGTACTAG	CAAGCAGAAGACGGCATACGAGATTAGGTACTAGAGGGTCAAGTGCACAGTCTA
s2_R_1805_CACGACTAAC	CAAGCAGAAGACGGCATACGAGATCACGACTAACAGGGTCAAGTGCACAGTCTA
s2_R_1806_ATCGTTATGG	CAAGCAGAAGACGGCATACGAGATATCGTTATGGAGGGTCAAGTGCACAGTCTA
s2_R_1807_TCACATGGCC	CAAGCAGAAGACGGCATACGAGATTCACATGGCCAGGGTCAAGTGCACAGTCTA
s2_R_1808_CGAGTTAGGA	CAAGCAGAAGACGGCATACGAGATCGAGTTAGGAAGGGTCAAGTGCACAGTCTA
s2_R_1809_GACGACAATC	CAAGCAGAAGACGGCATACGAGATGACGACAATCAGGGTCAAGTGCACAGTCTA
s2_R_1810_TGGCTCAACC	CAAGCAGAAGACGGCATACGAGATTGGCTCAACCAGGGTCAAGTGCACAGTCTA
s2_R_1811_TCACACGATC	CAAGCAGAAGACGGCATACGAGATTCACACGATCAGGGTCAAGTGCACAGTCTA
s2_R_1812_GCCTAATAAC	CAAGCAGAAGACGGCATACGAGATGCCTAATAACAGGGTCAAGTGCACAGTCTA
s2_R_1813_GTACAGAAGG	CAAGCAGAAGACGGCATACGAGATGTACAGAAGGAGGGTCAAGTGCACAGTCTA
s2_R_1814_CTAACCTCTA	CAAGCAGAAGACGGCATACGAGATCTAACCTCTAAGGGTCAAGTGCACAGTCTA
s2_R_1815_GAATGATGAC	CAAGCAGAAGACGGCATACGAGATGAATGATGACAGGGTCAAGTGCACAGTCTA
s2_R_1816_TCGTGCCACT	CAAGCAGAAGACGGCATACGAGATTCGTGCCACTAGGGTCAAGTGCACAGTCTA
s2_R_1817_CTCAATCATC	CAAGCAGAAGACGGCATACGAGATCTCAATCATCAGGGTCAAGTGCACAGTCTA
s2_R_1818_GACTCTATTG	CAAGCAGAAGACGGCATACGAGATGACTCTATTGAGGGTCAAGTGCACAGTCTA
s2_R_1819_AACACTGCTT	CAAGCAGAAGACGGCATACGAGATAACACTGCTTAGGGTCAAGTGCACAGTCTA
s2_R_1820_GAATAGCGAT	CAAGCAGAAGACGGCATACGAGATGAATAGCGATAGGGTCAAGTGCACAGTCTA
s2_R_1821_TAGCGAGCGT	CAAGCAGAAGACGGCATACGAGATTAGCGAGCGTAGGGTCAAGTGCACAGTCTA
s2_R_1822_CAATGTCCTC	CAAGCAGAAGACGGCATACGAGATCAATGTCCTCAGGGTCAAGTGCACAGTCTA
s2_R_1823_TGAACCTATG	CAAGCAGAAGACGGCATACGAGATTGAACCTATGAGGGTCAAGTGCACAGTCTA
s2_R_1824_CTAGTTCCAA	CAAGCAGAAGACGGCATACGAGATCTAGTTCCAAAGGGTCAAGTGCACAGTCTA
s2_R_1825_GAACCTCCTA	CAAGCAGAAGACGGCATACGAGATGAACCTCCTAAGGGTCAAGTGCACAGTCTA
s2_R_1826_TTCAGTAAGG	CAAGCAGAAGACGGCATACGAGATTTCAGTAAGGAGGGTCAAGTGCACAGTCTA
s2_R_1827_TAAGGCCTAT	CAAGCAGAAGACGGCATACGAGATTAAGGCCTATAGGGTCAAGTGCACAGTCTA
s2_R_1828_TAGACAGAGT	CAAGCAGAAGACGGCATACGAGATTAGACAGAGTAGGGTCAAGTGCACAGTCTA
s2_R_1829_GAGTGACGAG	CAAGCAGAAGACGGCATACGAGATGAGTGACGAGAGGGTCAAGTGCACAGTCTA
s2_R_1830_TCGATGATTG	CAAGCAGAAGACGGCATACGAGATTCGATGATTGAGGGTCAAGTGCACAGTCTA
s2_R_1831_GACTTAGTTC	CAAGCAGAAGACGGCATACGAGATGACTTAGTTCAGGGTCAAGTGCACAGTCTA
s2_R_1832_CTCAAGCGAG	CAAGCAGAAGACGGCATACGAGATCTCAAGCGAGAGGGTCAAGTGCACAGTCTA
s2_R_1833_CTCCTGAACA	CAAGCAGAAGACGGCATACGAGATCTCCTGAACAAGGGTCAAGTGCACAGTCTA
s2_R_1834_TCGACACGAA	CAAGCAGAAGACGGCATACGAGATTCGACACGAAAGGGTCAAGTGCACAGTCTA
s2_R_1835_TGGATTCCGA	CAAGCAGAAGACGGCATACGAGATTGGATTCCGAAGGGTCAAGTGCACAGTCTA
s2_R_1836_GTTCAAGAGG	CAAGCAGAAGACGGCATACGAGATGTTCAAGAGGAGGGTCAAGTGCACAGTCTA
s2_R_1837_GGCAAGTTAC	CAAGCAGAAGACGGCATACGAGATGGCAAGTTACAGGGTCAAGTGCACAGTCTA
s2_R_1838_TACAACAGGA	CAAGCAGAAGACGGCATACGAGATTACAACAGGAAGGGTCAAGTGCACAGTCTA
s2_R_1839_CTAAGAGACC	CAAGCAGAAGACGGCATACGAGATCTAAGAGACCAGGGTCAAGTGCACAGTCTA
s2_R_1840_TACCAGTAAG	CAAGCAGAAGACGGCATACGAGATTACCAGTAAGAGGGTCAAGTGCACAGTCTA
s2_R_1841_TAAGTCAGAG	CAAGCAGAAGACGGCATACGAGATTAAGTCAGAGAGGGTCAAGTGCACAGTCTA
s2_R_1842_GTCCACCTTA	CAAGCAGAAGACGGCATACGAGATGTCCACCTTAAGGGTCAAGTGCACAGTCTA
s2_R_1843_TACTGTCTCA	CAAGCAGAAGACGGCATACGAGATTACTGTCTCAAGGGTCAAGTGCACAGTCTA
s2_R_1844_ATTGTGCTCG	CAAGCAGAAGACGGCATACGAGATATTGTGCTCGAGGGTCAAGTGCACAGTCTA
s2_R_1845_TCTAATGTCC	CAAGCAGAAGACGGCATACGAGATTCTAATGTCCAGGGTCAAGTGCACAGTCTA
s2_R_1846_AACCAACGCC	CAAGCAGAAGACGGCATACGAGATAACCAACGCCAGGGTCAAGTGCACAGTCTA
s2_R_1847_TCCGAAGCTG	CAAGCAGAAGACGGCATACGAGATTCCGAAGCTGAGGGTCAAGTGCACAGTCTA
s2_R_1848_AGGCTAACTC	CAAGCAGAAGACGGCATACGAGATAGGCTAACTCAGGGTCAAGTGCACAGTCTA
s2_R_1849_GTCACCAGGA	CAAGCAGAAGACGGCATACGAGATGTCACCAGGAAGGGTCAAGTGCACAGTCTA
s2_R_1850_TAATGCTCAC	CAAGCAGAAGACGGCATACGAGATTAATGCTCACAGGGTCAAGTGCACAGTCTA
s2_R_1851_TCGACAGTTA	CAAGCAGAAGACGGCATACGAGATTCGACAGTTAAGGGTCAAGTGCACAGTCTA
s2_R_1852_GCAGCCTTAC	CAAGCAGAAGACGGCATACGAGATGCAGCCTTACAGGGTCAAGTGCACAGTCTA
s2_R_1853_TGAGTCCTAG	CAAGCAGAAGACGGCATACGAGATTGAGTCCTAGAGGGTCAAGTGCACAGTCTA
s2_R_1854_TCTAAGACCT	CAAGCAGAAGACGGCATACGAGATTCTAAGACCTAGGGTCAAGTGCACAGTCTA
s2_R_1855_TCTGGAACAC	CAAGCAGAAGACGGCATACGAGATTCTGGAACACAGGGTCAAGTGCACAGTCTA
s2_R_1856_TTGTCTGCAG	CAAGCAGAAGACGGCATACGAGATTTGTCTGCAGAGGGTCAAGTGCACAGTCTA
s2_R_1857_AGCCTGAGAC	CAAGCAGAAGACGGCATACGAGATAGCCTGAGACAGGGTCAAGTGCACAGTCTA
s2_R_1858_GAGCAAGTCA	CAAGCAGAAGACGGCATACGAGATGAGCAAGTCAAGGGTCAAGTGCACAGTCTA
s2_R_1859_CGACTTGCTC	CAAGCAGAAGACGGCATACGAGATCGACTTGCTCAGGGTCAAGTGCACAGTCTA
s2_R_1860_TAAGAAGCCT	CAAGCAGAAGACGGCATACGAGATTAAGAAGCCTAGGGTCAAGTGCACAGTCTA
s2_R_1861_CATGGAAGGA	CAAGCAGAAGACGGCATACGAGATCATGGAAGGAAGGGTCAAGTGCACAGTCTA
s2_R_1862_TGCTATTGAG	CAAGCAGAAGACGGCATACGAGATTGCTATTGAGAGGGTCAAGTGCACAGTCTA
s2_R_1863_GAGGAAGGAC	CAAGCAGAAGACGGCATACGAGATGAGGAAGGACAGGGTCAAGTGCACAGTCTA
s2_R_1864_TGAGAGTAAC	CAAGCAGAAGACGGCATACGAGATTGAGAGTAACAGGGTCAAGTGCACAGTCTA
s2_R_1865_AAGAGAGAAC	CAAGCAGAAGACGGCATACGAGATAAGAGAGAACAGGGTCAAGTGCACAGTCTA
s2_R_1866_GTACACCTAG	CAAGCAGAAGACGGCATACGAGATGTACACCTAGAGGGTCAAGTGCACAGTCTA
s2_R_1867_GTCTAACAGA	CAAGCAGAAGACGGCATACGAGATGTCTAACAGAAGGGTCAAGTGCACAGTCTA
s2_R_1868_GAACTCTCTC	CAAGCAGAAGACGGCATACGAGATGAACTCTCTCAGGGTCAAGTGCACAGTCTA
s2_R_1869_ACCGATCAAC	CAAGCAGAAGACGGCATACGAGATACCGATCAACAGGGTCAAGTGCACAGTCTA
s2_R_1870_TACATCCACA	CAAGCAGAAGACGGCATACGAGATTACATCCACAAGGGTCAAGTGCACAGTCTA
s2_R_1871_GAAGTTCACT	CAAGCAGAAGACGGCATACGAGATGAAGTTCACTAGGGTCAAGTGCACAGTCTA
s2_R_1872_TCATACATGG	CAAGCAGAAGACGGCATACGAGATTCATACATGGAGGGTCAAGTGCACAGTCTA
s2_R_1873_TAAGAGTTCC	CAAGCAGAAGACGGCATACGAGATTAAGAGTTCCAGGGTCAAGTGCACAGTCTA
s2_R_1874_TGGATCCTAT	CAAGCAGAAGACGGCATACGAGATTGGATCCTATAGGGTCAAGTGCACAGTCTA
s2_R_1875_TAACAGTCCT	CAAGCAGAAGACGGCATACGAGATTAACAGTCCTAGGGTCAAGTGCACAGTCTA
s2_R_1876_CTACTCCAAG	CAAGCAGAAGACGGCATACGAGATCTACTCCAAGAGGGTCAAGTGCACAGTCTA
s2_R_1877_TTGCTACATC	CAAGCAGAAGACGGCATACGAGATTTGCTACATCAGGGTCAAGTGCACAGTCTA
s2_R_1878_TCCTACCAAC	CAAGCAGAAGACGGCATACGAGATTCCTACCAACAGGGTCAAGTGCACAGTCTA
s2_R_1879_TAGCGTCCTA	CAAGCAGAAGACGGCATACGAGATTAGCGTCCTAAGGGTCAAGTGCACAGTCTA
s2_R_1880_TCACGAGCCA	CAAGCAGAAGACGGCATACGAGATTCACGAGCCAAGGGTCAAGTGCACAGTCTA
s2_R_1881_GAGAGTCTGA	CAAGCAGAAGACGGCATACGAGATGAGAGTCTGAAGGGTCAAGTGCACAGTCTA
s2_R_1882_TCCTCGTTAG	CAAGCAGAAGACGGCATACGAGATTCCTCGTTAGAGGGTCAAGTGCACAGTCTA
s2_R_1883_GAAGACTAGC	CAAGCAGAAGACGGCATACGAGATGAAGACTAGCAGGGTCAAGTGCACAGTCTA
s2_R_1884_TCCTCTCCAT	CAAGCAGAAGACGGCATACGAGATTCCTCTCCATAGGGTCAAGTGCACAGTCTA
s2_R_1885_GAAGTGAAGT	CAAGCAGAAGACGGCATACGAGATGAAGTGAAGTAGGGTCAAGTGCACAGTCTA
s2_R_1886_GAACGCTTAC	CAAGCAGAAGACGGCATACGAGATGAACGCTTACAGGGTCAAGTGCACAGTCTA
s2_R_1887_ACCACGCTAC	CAAGCAGAAGACGGCATACGAGATACCACGCTACAGGGTCAAGTGCACAGTCTA
s2_R_1888_CTAACTCGCC	CAAGCAGAAGACGGCATACGAGATCTAACTCGCCAGGGTCAAGTGCACAGTCTA
s2_R_1889_TAGACCTGAA	CAAGCAGAAGACGGCATACGAGATTAGACCTGAAAGGGTCAAGTGCACAGTCTA
s2_R_1890_TACGCAATGT	CAAGCAGAAGACGGCATACGAGATTACGCAATGTAGGGTCAAGTGCACAGTCTA
s2_R_1891_AGATCTGCTC	CAAGCAGAAGACGGCATACGAGATAGATCTGCTCAGGGTCAAGTGCACAGTCTA
s2_R_1892_TTCGTTATCC	CAAGCAGAAGACGGCATACGAGATTTCGTTATCCAGGGTCAAGTGCACAGTCTA
s2_R_1893_ACTTACGCTA	CAAGCAGAAGACGGCATACGAGATACTTACGCTAAGGGTCAAGTGCACAGTCTA
s2_R_1894_TACGAACGAG	CAAGCAGAAGACGGCATACGAGATTACGAACGAGAGGGTCAAGTGCACAGTCTA
s2_R_1895_GACACATTGG	CAAGCAGAAGACGGCATACGAGATGACACATTGGAGGGTCAAGTGCACAGTCTA
s2_R_1896_GAATTCCTCC	CAAGCAGAAGACGGCATACGAGATGAATTCCTCCAGGGTCAAGTGCACAGTCTA
s2_R_1897_CAACGAACTC	CAAGCAGAAGACGGCATACGAGATCAACGAACTCAGGGTCAAGTGCACAGTCTA
s2_R_1898_TCTACATGCT	CAAGCAGAAGACGGCATACGAGATTCTACATGCTAGGGTCAAGTGCACAGTCTA
s2_R_1899_CTGTTATTGC	CAAGCAGAAGACGGCATACGAGATCTGTTATTGCAGGGTCAAGTGCACAGTCTA
s2_R_1900_CATATCCTCC	CAAGCAGAAGACGGCATACGAGATCATATCCTCCAGGGTCAAGTGCACAGTCTA
s2_R_1901_CTTACTACTC	CAAGCAGAAGACGGCATACGAGATCTTACTACTCAGGGTCAAGTGCACAGTCTA
s2_R_1902_CTCCGACTAC	CAAGCAGAAGACGGCATACGAGATCTCCGACTACAGGGTCAAGTGCACAGTCTA
s2_R_1903_CACCTCGATT	CAAGCAGAAGACGGCATACGAGATCACCTCGATTAGGGTCAAGTGCACAGTCTA
s2_R_1904_TCACAGGACT	CAAGCAGAAGACGGCATACGAGATTCACAGGACTAGGGTCAAGTGCACAGTCTA
s2_R_1905_GTCCTTCTCT	CAAGCAGAAGACGGCATACGAGATGTCCTTCTCTAGGGTCAAGTGCACAGTCTA
s2_R_1906_CGAGACGCTA	CAAGCAGAAGACGGCATACGAGATCGAGACGCTAAGGGTCAAGTGCACAGTCTA
s2_R_1907_TACTCAGATG	CAAGCAGAAGACGGCATACGAGATTACTCAGATGAGGGTCAAGTGCACAGTCTA
s2_R_1908_CGGTGTTATT	CAAGCAGAAGACGGCATACGAGATCGGTGTTATTAGGGTCAAGTGCACAGTCTA
s2_R_1909_TCTGGCCTTG	CAAGCAGAAGACGGCATACGAGATTCTGGCCTTGAGGGTCAAGTGCACAGTCTA
s2_R_1910_TCTGACGCAC	CAAGCAGAAGACGGCATACGAGATTCTGACGCACAGGGTCAAGTGCACAGTCTA
s2_R_1911_GAGTTACAGG	CAAGCAGAAGACGGCATACGAGATGAGTTACAGGAGGGTCAAGTGCACAGTCTA
s2_R_1912_GACACCTTAA	CAAGCAGAAGACGGCATACGAGATGACACCTTAAAGGGTCAAGTGCACAGTCTA
s2_R_1913_CGTACTAATG	CAAGCAGAAGACGGCATACGAGATCGTACTAATGAGGGTCAAGTGCACAGTCTA
s2_R_1914_AAGAGGACAG	CAAGCAGAAGACGGCATACGAGATAAGAGGACAGAGGGTCAAGTGCACAGTCTA
s2_R_1915_TCAGAACCGA	CAAGCAGAAGACGGCATACGAGATTCAGAACCGAAGGGTCAAGTGCACAGTCTA
s2_R_1916_GATTGCTTGA	CAAGCAGAAGACGGCATACGAGATGATTGCTTGAAGGGTCAAGTGCACAGTCTA
s2_R_1917_TCTCTCTGAC	CAAGCAGAAGACGGCATACGAGATTCTCTCTGACAGGGTCAAGTGCACAGTCTA
s2_R_1918_TCTATGATGC	CAAGCAGAAGACGGCATACGAGATTCTATGATGCAGGGTCAAGTGCACAGTCTA
s2_R_1919_TATATGCGGC	CAAGCAGAAGACGGCATACGAGATTATATGCGGCAGGGTCAAGTGCACAGTCTA
s2_R_1920_GTTCTAGTGA	CAAGCAGAAGACGGCATACGAGATGTTCTAGTGAAGGGTCAAGTGCACAGTCTA
s2_R_1921_ACTGATGGTC	CAAGCAGAAGACGGCATACGAGATACTGATGGTCAGGGTCAAGTGCACAGTCTA
s2_R_1922_TATAGACCTG	CAAGCAGAAGACGGCATACGAGATTATAGACCTGAGGGTCAAGTGCACAGTCTA
s2_R_1923_TACGCTACGA	CAAGCAGAAGACGGCATACGAGATTACGCTACGAAGGGTCAAGTGCACAGTCTA
s2_R_1924_TTGTACGCAT	CAAGCAGAAGACGGCATACGAGATTTGTACGCATAGGGTCAAGTGCACAGTCTA
s2_R_1925_AACCTAGCTG	CAAGCAGAAGACGGCATACGAGATAACCTAGCTGAGGGTCAAGTGCACAGTCTA
s2_R_1926_TACTGCGAGG	CAAGCAGAAGACGGCATACGAGATTACTGCGAGGAGGGTCAAGTGCACAGTCTA
s2_R_1927_TGCGATTATG	CAAGCAGAAGACGGCATACGAGATTGCGATTATGAGGGTCAAGTGCACAGTCTA
s2_R_1928_TCCGTCAAGC	CAAGCAGAAGACGGCATACGAGATTCCGTCAAGCAGGGTCAAGTGCACAGTCTA
s2_R_1929_GAGGACTGAT	CAAGCAGAAGACGGCATACGAGATGAGGACTGATAGGGTCAAGTGCACAGTCTA
s2_R_1930_AGAACAACTC	CAAGCAGAAGACGGCATACGAGATAGAACAACTCAGGGTCAAGTGCACAGTCTA
s2_R_1931_GATAACGAGG	CAAGCAGAAGACGGCATACGAGATGATAACGAGGAGGGTCAAGTGCACAGTCTA
s2_R_1932_TATCCTCTGG	CAAGCAGAAGACGGCATACGAGATTATCCTCTGGAGGGTCAAGTGCACAGTCTA
s2_R_1933_TTCAACTTCC	CAAGCAGAAGACGGCATACGAGATTTCAACTTCCAGGGTCAAGTGCACAGTCTA
s2_R_1934_GCAGTTACTC	CAAGCAGAAGACGGCATACGAGATGCAGTTACTCAGGGTCAAGTGCACAGTCTA
s2_R_1935_TACACCGAAT	CAAGCAGAAGACGGCATACGAGATTACACCGAATAGGGTCAAGTGCACAGTCTA
s2_R_1936_TCCTAGTTGA	CAAGCAGAAGACGGCATACGAGATTCCTAGTTGAAGGGTCAAGTGCACAGTCTA
s2_R_1937_GCAGGATCTC	CAAGCAGAAGACGGCATACGAGATGCAGGATCTCAGGGTCAAGTGCACAGTCTA
s2_R_1938_ACACTCGAAC	CAAGCAGAAGACGGCATACGAGATACACTCGAACAGGGTCAAGTGCACAGTCTA
s2_R_1939_TTAGAACGAC	CAAGCAGAAGACGGCATACGAGATTTAGAACGACAGGGTCAAGTGCACAGTCTA
s2_R_1940_CCATAGCCTC	CAAGCAGAAGACGGCATACGAGATCCATAGCCTCAGGGTCAAGTGCACAGTCTA
s2_R_1941_TGACTTAGAG	CAAGCAGAAGACGGCATACGAGATTGACTTAGAGAGGGTCAAGTGCACAGTCTA
s2_R_1942_TGCGTAACAT	CAAGCAGAAGACGGCATACGAGATTGCGTAACATAGGGTCAAGTGCACAGTCTA
s2_R_1943_CCTTAAGGTC	CAAGCAGAAGACGGCATACGAGATCCTTAAGGTCAGGGTCAAGTGCACAGTCTA
s2_R_1944_TACCACACCT	CAAGCAGAAGACGGCATACGAGATTACCACACCTAGGGTCAAGTGCACAGTCTA
s2_R_1945_TTATCCAGGA	CAAGCAGAAGACGGCATACGAGATTTATCCAGGAAGGGTCAAGTGCACAGTCTA
s2_R_1946_GCTAAGTTGT	CAAGCAGAAGACGGCATACGAGATGCTAAGTTGTAGGGTCAAGTGCACAGTCTA
s2_R_1947_TAGCGAACTG	CAAGCAGAAGACGGCATACGAGATTAGCGAACTGAGGGTCAAGTGCACAGTCTA
s2_R_1948_TCTAACACTG	CAAGCAGAAGACGGCATACGAGATTCTAACACTGAGGGTCAAGTGCACAGTCTA
s2_R_1949_GTCCATTGAA	CAAGCAGAAGACGGCATACGAGATGTCCATTGAAAGGGTCAAGTGCACAGTCTA
s2_R_1950_TTGCTAACGA	CAAGCAGAAGACGGCATACGAGATTTGCTAACGAAGGGTCAAGTGCACAGTCTA
s2_R_1951_TGATTCCAGG	CAAGCAGAAGACGGCATACGAGATTGATTCCAGGAGGGTCAAGTGCACAGTCTA
s2_R_1952_ATTCTCCGGA	CAAGCAGAAGACGGCATACGAGATATTCTCCGGAAGGGTCAAGTGCACAGTCTA
s2_R_1953_TAACACCGAC	CAAGCAGAAGACGGCATACGAGATTAACACCGACAGGGTCAAGTGCACAGTCTA
s2_R_1954_CACAGCTTAC	CAAGCAGAAGACGGCATACGAGATCACAGCTTACAGGGTCAAGTGCACAGTCTA
s2_R_1955_TCTCCACCTC	CAAGCAGAAGACGGCATACGAGATTCTCCACCTCAGGGTCAAGTGCACAGTCTA
s2_R_1956_TGTCTTCAGA	CAAGCAGAAGACGGCATACGAGATTGTCTTCAGAAGGGTCAAGTGCACAGTCTA
s2_R_1957_CTTACCAGAC	CAAGCAGAAGACGGCATACGAGATCTTACCAGACAGGGTCAAGTGCACAGTCTA
s2_R_1958_TGGAACAAGT	CAAGCAGAAGACGGCATACGAGATTGGAACAAGTAGGGTCAAGTGCACAGTCTA
s2_R_1959_TGCTAACACC	CAAGCAGAAGACGGCATACGAGATTGCTAACACCAGGGTCAAGTGCACAGTCTA
s2_R_1960_GCGTGAAGGA	CAAGCAGAAGACGGCATACGAGATGCGTGAAGGAAGGGTCAAGTGCACAGTCTA
s2_R_1961_ATTACGCCAC	CAAGCAGAAGACGGCATACGAGATATTACGCCACAGGGTCAAGTGCACAGTCTA
s2_R_1962_GAATACTCCT	CAAGCAGAAGACGGCATACGAGATGAATACTCCTAGGGTCAAGTGCACAGTCTA
s2_R_1963_TCCACCATAG	CAAGCAGAAGACGGCATACGAGATTCCACCATAGAGGGTCAAGTGCACAGTCTA
s2_R_1964_GTGGATATAC	CAAGCAGAAGACGGCATACGAGATGTGGATATACAGGGTCAAGTGCACAGTCTA
s2_R_1965_GAGCATTACT	CAAGCAGAAGACGGCATACGAGATGAGCATTACTAGGGTCAAGTGCACAGTCTA
s2_R_1966_GGATTCTGCC	CAAGCAGAAGACGGCATACGAGATGGATTCTGCCAGGGTCAAGTGCACAGTCTA
s2_R_1967_TTAGCTGGAC	CAAGCAGAAGACGGCATACGAGATTTAGCTGGACAGGGTCAAGTGCACAGTCTA
s2_R_1968_TCTAGGTCAC	CAAGCAGAAGACGGCATACGAGATTCTAGGTCACAGGGTCAAGTGCACAGTCTA
s2_R_1969_GTACTACTCC	CAAGCAGAAGACGGCATACGAGATGTACTACTCCAGGGTCAAGTGCACAGTCTA
s2_R_1970_GACGGTATTC	CAAGCAGAAGACGGCATACGAGATGACGGTATTCAGGGTCAAGTGCACAGTCTA
s2_R_1971_TTGCTTGCTC	CAAGCAGAAGACGGCATACGAGATTTGCTTGCTCAGGGTCAAGTGCACAGTCTA
s2_R_1972_TCATAGGATG	CAAGCAGAAGACGGCATACGAGATTCATAGGATGAGGGTCAAGTGCACAGTCTA
s2_R_1973_TGCTAAGTTC	CAAGCAGAAGACGGCATACGAGATTGCTAAGTTCAGGGTCAAGTGCACAGTCTA
s2_R_1974_GACCTCAACT	CAAGCAGAAGACGGCATACGAGATGACCTCAACTAGGGTCAAGTGCACAGTCTA
s2_R_1975_TCACAGAGGT	CAAGCAGAAGACGGCATACGAGATTCACAGAGGTAGGGTCAAGTGCACAGTCTA
s2_R_1976_CGACAAGAAC	CAAGCAGAAGACGGCATACGAGATCGACAAGAACAGGGTCAAGTGCACAGTCTA
s2_R_1977_TATACAGCTC	CAAGCAGAAGACGGCATACGAGATTATACAGCTCAGGGTCAAGTGCACAGTCTA
s2_R_1978_TCTTACTGCC	CAAGCAGAAGACGGCATACGAGATTCTTACTGCCAGGGTCAAGTGCACAGTCTA
s2_R_1979_GATACCAACC	CAAGCAGAAGACGGCATACGAGATGATACCAACCAGGGTCAAGTGCACAGTCTA
s2_R_1980_GAGACTACTC	CAAGCAGAAGACGGCATACGAGATGAGACTACTCAGGGTCAAGTGCACAGTCTA
s2_R_1981_TCCTGACTGC	CAAGCAGAAGACGGCATACGAGATTCCTGACTGCAGGGTCAAGTGCACAGTCTA
s2_R_1982_AACCGGTCTC	CAAGCAGAAGACGGCATACGAGATAACCGGTCTCAGGGTCAAGTGCACAGTCTA
s2_R_1983_GAACCACTAC	CAAGCAGAAGACGGCATACGAGATGAACCACTACAGGGTCAAGTGCACAGTCTA
s2_R_1984_TCCGATAGCC	CAAGCAGAAGACGGCATACGAGATTCCGATAGCCAGGGTCAAGTGCACAGTCTA
s2_R_1985_TTCAGGTAAC	CAAGCAGAAGACGGCATACGAGATTTCAGGTAACAGGGTCAAGTGCACAGTCTA
s2_R_1986_ATAAGCTGAC	CAAGCAGAAGACGGCATACGAGATATAAGCTGACAGGGTCAAGTGCACAGTCTA
s2_R_1987_GGTTGCGGTT	CAAGCAGAAGACGGCATACGAGATGGTTGCGGTTAGGGTCAAGTGCACAGTCTA
s2_R_1988_ATAGTTGGCC	CAAGCAGAAGACGGCATACGAGATATAGTTGGCCAGGGTCAAGTGCACAGTCTA
s2_R_1989_CACTATGAAC	CAAGCAGAAGACGGCATACGAGATCACTATGAACAGGGTCAAGTGCACAGTCTA
s2_R_1990_TAGGATCCTC	CAAGCAGAAGACGGCATACGAGATTAGGATCCTCAGGGTCAAGTGCACAGTCTA
s2_R_1991_AAGAACGCTA	CAAGCAGAAGACGGCATACGAGATAAGAACGCTAAGGGTCAAGTGCACAGTCTA
s2_R_1992_TGAGCGACCA	CAAGCAGAAGACGGCATACGAGATTGAGCGACCAAGGGTCAAGTGCACAGTCTA
s2_R_1993_CGATGCCAAC	CAAGCAGAAGACGGCATACGAGATCGATGCCAACAGGGTCAAGTGCACAGTCTA
s2_R_1994_GAGACCTAAC	CAAGCAGAAGACGGCATACGAGATGAGACCTAACAGGGTCAAGTGCACAGTCTA
s2_R_1995_GTGTCTTCGG	CAAGCAGAAGACGGCATACGAGATGTGTCTTCGGAGGGTCAAGTGCACAGTCTA
s2_R_1996_GTAACGAACA	CAAGCAGAAGACGGCATACGAGATGTAACGAACAAGGGTCAAGTGCACAGTCTA
s2_R_1997_ATACGTAGGC	CAAGCAGAAGACGGCATACGAGATATACGTAGGCAGGGTCAAGTGCACAGTCTA
s2_R_1998_TTCACGTGCT	CAAGCAGAAGACGGCATACGAGATTTCACGTGCTAGGGTCAAGTGCACAGTCTA
s2_R_1999_TGGTACTGAA	CAAGCAGAAGACGGCATACGAGATTGGTACTGAAAGGGTCAAGTGCACAGTCTA
s2_R_2000_CTCTAACAAC	CAAGCAGAAGACGGCATACGAGATCTCTAACAACAGGGTCAAGTGCACAGTCTA
s2_R_2001_TCTGTGTGCC	CAAGCAGAAGACGGCATACGAGATTCTGTGTGCCAGGGTCAAGTGCACAGTCTA
s2_R_2002_GGTGTCACAA	CAAGCAGAAGACGGCATACGAGATGGTGTCACAAAGGGTCAAGTGCACAGTCTA
s2_R_2003_TAGCACATTG	CAAGCAGAAGACGGCATACGAGATTAGCACATTGAGGGTCAAGTGCACAGTCTA
s2_R_2004_GTACCGTACG	CAAGCAGAAGACGGCATACGAGATGTACCGTACGAGGGTCAAGTGCACAGTCTA
s2_R_2005_TGGACTGATT	CAAGCAGAAGACGGCATACGAGATTGGACTGATTAGGGTCAAGTGCACAGTCTA
s2_R_2006_GCGCCGAATA	CAAGCAGAAGACGGCATACGAGATGCGCCGAATAAGGGTCAAGTGCACAGTCTA
s2_R_2007_TAGTCACGCC	CAAGCAGAAGACGGCATACGAGATTAGTCACGCCAGGGTCAAGTGCACAGTCTA
s2_R_2008_GCAGGATACA	CAAGCAGAAGACGGCATACGAGATGCAGGATACAAGGGTCAAGTGCACAGTCTA
s2_R_2009_ATTCAGGCAG	CAAGCAGAAGACGGCATACGAGATATTCAGGCAGAGGGTCAAGTGCACAGTCTA
s2_R_2010_GCCATCGTAT	CAAGCAGAAGACGGCATACGAGATGCCATCGTATAGGGTCAAGTGCACAGTCTA
s2_R_2011_TGTACCATGG	CAAGCAGAAGACGGCATACGAGATTGTACCATGGAGGGTCAAGTGCACAGTCTA
s2_R_2012_CTCTCAGTGA	CAAGCAGAAGACGGCATACGAGATCTCTCAGTGAAGGGTCAAGTGCACAGTCTA
s2_R_2013_TCTATAGCTG	CAAGCAGAAGACGGCATACGAGATTCTATAGCTGAGGGTCAAGTGCACAGTCTA
s2_R_2014_CAACACGGTC	CAAGCAGAAGACGGCATACGAGATCAACACGGTCAGGGTCAAGTGCACAGTCTA
s2_R_2015_GTTAACCGAC	CAAGCAGAAGACGGCATACGAGATGTTAACCGACAGGGTCAAGTGCACAGTCTA
s2_R_2016_TATCATTGCC	CAAGCAGAAGACGGCATACGAGATTATCATTGCCAGGGTCAAGTGCACAGTCTA
s2_R_2017_TCCAACATTC	CAAGCAGAAGACGGCATACGAGATTCCAACATTCAGGGTCAAGTGCACAGTCTA
s2_R_2018_GACCAACCTC	CAAGCAGAAGACGGCATACGAGATGACCAACCTCAGGGTCAAGTGCACAGTCTA
s2_R_2019_ACTGCGCAAC	CAAGCAGAAGACGGCATACGAGATACTGCGCAACAGGGTCAAGTGCACAGTCTA
s2_R_2020_GCCATAAGAC	CAAGCAGAAGACGGCATACGAGATGCCATAAGACAGGGTCAAGTGCACAGTCTA
s2_R_2021_GAGCAACACC	CAAGCAGAAGACGGCATACGAGATGAGCAACACCAGGGTCAAGTGCACAGTCTA
s2_R_2022_CAACCTTAAC	CAAGCAGAAGACGGCATACGAGATCAACCTTAACAGGGTCAAGTGCACAGTCTA
s2_R_2023_TATAAGCACC	CAAGCAGAAGACGGCATACGAGATTATAAGCACCAGGGTCAAGTGCACAGTCTA
